GEOID,STATEFP,STATE,COUNTYFP,COUNTY,TOT_HOUS22,TOT_CHI22,TOT_MAR22,TOT_MAL22,TOT_FEM22,TOT_BPOV22,CHI_BPOV22,MAR_BPOV22,MAL_BPOV22,FEM_BPOV22,TOT_APOV22,CHI_APOV22,MAR_APOV22,MAL_APOV22,FEM_APOV22,TOT_CVAP22,BPV_CVAP22,APV_CVAP22
361059501001,36, New York,105, Sullivan County,142,64,46,0,18,9,9,9,0,0,133,55,37,0,18,599,45,554
361059501002,36, New York,105, Sullivan County,216,56,48,8,0,16,16,16,0,0,200,40,32,8,0,703,32,671
361059501003,36, New York,105, Sullivan County,244,112,71,22,19,25,8,0,0,8,219,104,71,22,11,750,90,660
361059501004,36, New York,105, Sullivan County,250,95,40,0,55,41,0,0,0,0,209,95,40,0,55,625,82,543
361059502011,36, New York,105, Sullivan County,109,59,44,15,0,0,0,0,0,0,109,59,44,15,0,347,32,315
361059502012,36, New York,105, Sullivan County,235,66,66,0,0,29,0,0,0,0,206,66,66,0,0,803,203,600
361059502013,36, New York,105, Sullivan County,133,79,53,0,26,0,0,0,0,0,133,79,53,0,26,327,26,301
361059502021,36, New York,105, Sullivan County,241,104,37,0,67,7,0,0,0,0,234,104,37,0,67,700,41,659
361059502022,36, New York,105, Sullivan County,91,48,48,0,0,11,11,11,0,0,80,37,37,0,0,486,35,451
361059503001,36, New York,105, Sullivan County,179,76,33,8,35,35,35,0,0,35,144,41,33,8,0,513,27,486
361059503002,36, New York,105, Sullivan County,154,20,18,0,2,0,0,0,0,0,154,20,18,0,2,509,19,490
361059504001,36, New York,105, Sullivan County,263,124,23,39,62,29,0,0,0,0,234,124,23,39,62,971,129,842
361059504002,36, New York,105, Sullivan County,287,32,4,28,0,0,0,0,0,0,287,32,4,28,0,683,57,626
361059504003,36, New York,105, Sullivan County,210,92,77,0,15,14,6,0,0,6,196,86,77,0,9,701,103,598
361059505001,36, New York,105, Sullivan County,164,143,92,0,51,51,51,0,0,51,113,92,92,0,0,223,32,191
361059505002,36, New York,105, Sullivan County,222,77,60,0,17,52,0,0,0,0,170,77,60,0,17,1106,202,904
361059505003,36, New York,105, Sullivan County,193,81,18,40,23,23,23,0,0,23,170,58,18,40,0,365,23,342
361059505004,36, New York,105, Sullivan County,159,113,103,10,0,26,26,26,0,0,133,87,77,10,0,640,135,505
361059506001,36, New York,105, Sullivan County,175,86,86,0,0,0,0,0,0,0,175,86,86,0,0,656,15,641
361059506002,36, New York,105, Sullivan County,77,23,23,0,0,0,0,0,0,0,77,23,23,0,0,304,19,285
361059506003,36, New York,105, Sullivan County,100,59,40,8,11,11,11,0,0,11,89,48,40,8,0,355,64,291
361059507011,36, New York,105, Sullivan County,134,108,68,0,40,11,11,11,0,0,123,97,57,0,40,414,16,398
361059507012,36, New York,105, Sullivan County,199,179,136,0,43,13,13,0,0,13,186,166,136,0,30,557,119,438
361059507013,36, New York,105, Sullivan County,169,119,80,28,11,0,0,0,0,0,169,119,80,28,11,599,49,550
361059507014,36, New York,105, Sullivan County,65,54,0,0,54,0,0,0,0,0,65,54,0,0,54,146,38,108
361059507021,36, New York,105, Sullivan County,206,128,24,0,104,24,24,0,0,24,182,104,24,0,80,573,143,430
361059507022,36, New York,105, Sullivan County,156,103,93,0,10,42,42,32,0,10,114,61,61,0,0,470,97,373
361059508011,36, New York,105, Sullivan County,80,44,13,0,31,0,0,0,0,0,80,44,13,0,31,210,46,164
361059508012,36, New York,105, Sullivan County,166,136,46,36,54,71,71,0,36,35,95,65,46,0,19,509,298,211
361059508013,36, New York,105, Sullivan County,293,227,91,0,136,0,0,0,0,0,293,227,91,0,136,558,22,536
361059508021,36, New York,105, Sullivan County,282,119,111,0,8,0,0,0,0,0,282,119,111,0,8,976,23,953
361059508022,36, New York,105, Sullivan County,176,105,10,32,63,0,0,0,0,0,176,105,10,32,63,548,99,449
361059509001,36, New York,105, Sullivan County,312,172,103,0,69,34,0,0,0,0,278,172,103,0,69,858,74,784
361059509002,36, New York,105, Sullivan County,182,82,82,0,0,57,57,57,0,0,125,25,25,0,0,706,188,518
361059509003,36, New York,105, Sullivan County,213,192,138,0,54,58,58,58,0,0,155,134,80,0,54,541,219,322
361059510001,36, New York,105, Sullivan County,258,154,115,37,2,5,5,3,0,2,253,149,112,37,0,558,116,442
361059510002,36, New York,105, Sullivan County,140,120,52,35,33,11,4,4,0,0,129,116,48,35,33,668,62,606
361059510003,36, New York,105, Sullivan County,175,13,13,0,0,0,0,0,0,0,175,13,13,0,0,763,20,743
361059511001,36, New York,105, Sullivan County,210,129,67,24,38,0,0,0,0,0,210,129,67,24,38,625,16,609
361059511002,36, New York,105, Sullivan County,55,49,37,12,0,10,10,8,2,0,45,39,29,10,0,261,86,175
361059511003,36, New York,105, Sullivan County,107,76,64,6,6,0,0,0,0,0,107,76,64,6,6,228,2,226
361059512011,36, New York,105, Sullivan County,336,134,134,0,0,23,0,0,0,0,313,134,134,0,0,1224,110,1114
361059512012,36, New York,105, Sullivan County,234,136,99,0,37,22,22,0,0,22,212,114,99,0,15,753,43,710
361059512013,36, New York,105, Sullivan County,241,125,67,20,38,18,13,0,0,13,223,112,67,20,25,703,60,643
361059512014,36, New York,105, Sullivan County,274,175,151,0,24,0,0,0,0,0,274,175,151,0,24,847,89,758
361059512021,36, New York,105, Sullivan County,292,127,52,75,0,5,0,0,0,0,287,127,52,75,0,774,15,759
361059512022,36, New York,105, Sullivan County,309,235,235,0,0,129,129,129,0,0,180,106,106,0,0,824,305,519
361059512023,36, New York,105, Sullivan County,268,161,95,25,41,41,41,0,0,41,227,120,95,25,0,990,162,828
361059513011,36, New York,105, Sullivan County,206,61,36,25,0,0,0,0,0,0,206,61,36,25,0,596,32,564
361059513012,36, New York,105, Sullivan County,339,156,78,78,0,2,2,2,0,0,337,154,76,78,0,995,21,974
361059513021,36, New York,105, Sullivan County,296,110,79,31,0,22,0,0,0,0,274,110,79,31,0,947,113,834
361059513022,36, New York,105, Sullivan County,61,5,5,0,0,15,0,0,0,0,46,5,5,0,0,249,83,166
361059513023,36, New York,105, Sullivan County,183,54,42,0,12,12,0,0,0,0,171,54,42,0,12,492,71,421
361059515001,36, New York,105, Sullivan County,153,60,27,25,8,0,0,0,0,0,153,60,27,25,8,806,95,711
361059515002,36, New York,105, Sullivan County,215,98,64,34,0,26,0,0,0,0,189,98,64,34,0,872,190,682
361059515003,36, New York,105, Sullivan County,167,108,102,6,0,91,91,85,6,0,76,17,17,0,0,438,200,238
361059516001,36, New York,105, Sullivan County,280,154,16,43,95,37,37,0,0,37,243,117,16,43,58,581,45,536
361059516002,36, New York,105, Sullivan County,253,61,27,34,0,0,0,0,0,0,253,61,27,34,0,832,9,823
361059516003,36, New York,105, Sullivan County,305,270,110,0,160,158,158,42,0,116,147,112,68,0,44,684,225,459
361059516004,36, New York,105, Sullivan County,279,160,62,55,43,0,0,0,0,0,279,160,62,55,43,774,58,716
361059517011,36, New York,105, Sullivan County,178,27,13,0,14,11,0,0,0,0,167,27,13,0,14,627,24,603
361059517012,36, New York,105, Sullivan County,367,155,155,0,0,0,0,0,0,0,367,155,155,0,0,1154,41,1113
361059517013,36, New York,105, Sullivan County,264,109,76,0,33,14,14,0,0,14,250,95,76,0,19,795,14,781
361059517021,36, New York,105, Sullivan County,288,40,19,19,2,12,10,2,8,0,276,30,17,11,2,777,34,743
361059518011,36, New York,105, Sullivan County,188,42,42,0,0,0,0,0,0,0,188,42,42,0,0,450,52,398
361059518012,36, New York,105, Sullivan County,224,131,0,0,131,143,131,0,0,131,81,0,0,0,0,917,164,753
361059518013,36, New York,105, Sullivan County,131,35,0,0,35,35,35,0,0,35,96,0,0,0,0,506,35,471
361059518014,36, New York,105, Sullivan County,117,21,21,0,0,0,0,0,0,0,117,21,21,0,0,346,20,326
361059518021,36, New York,105, Sullivan County,93,53,16,0,37,30,30,16,0,14,63,23,0,0,23,374,68,306
361059518022,36, New York,105, Sullivan County,101,35,35,0,0,0,0,0,0,0,101,35,35,0,0,421,18,403
361059518023,36, New York,105, Sullivan County,141,97,0,0,97,97,97,0,0,97,44,0,0,0,0,327,168,159
361059518024,36, New York,105, Sullivan County,11,0,0,0,0,0,0,0,0,0,11,0,0,0,0,335,146,189
361059518025,36, New York,105, Sullivan County,236,146,92,0,54,0,0,0,0,0,236,146,92,0,54,594,16,578
361059519001,36, New York,105, Sullivan County,185,78,11,22,45,50,50,0,22,28,135,28,11,0,17,571,123,448
361059519002,36, New York,105, Sullivan County,204,102,22,17,63,14,14,0,0,14,190,88,22,17,49,882,114,768
361059520001,36, New York,105, Sullivan County,154,60,36,24,0,17,0,0,0,0,137,60,36,24,0,514,51,463
361059520002,36, New York,105, Sullivan County,257,55,55,0,0,0,0,0,0,0,257,55,55,0,0,765,7,758
361059520003,36, New York,105, Sullivan County,131,42,0,0,42,42,42,0,0,42,89,0,0,0,0,323,53,270
361059521001,36, New York,105, Sullivan County,210,81,48,0,33,15,15,15,0,0,195,66,33,0,33,752,165,587
361059521002,36, New York,105, Sullivan County,344,101,95,6,0,15,0,0,0,0,329,101,95,6,0,1113,118,995
361059522001,36, New York,105, Sullivan County,211,43,35,4,4,2,0,0,0,0,209,43,35,4,4,703,38,665
361059522002,36, New York,105, Sullivan County,159,68,38,23,7,4,0,0,0,0,155,68,38,23,7,467,58,409
361059523001,36, New York,105, Sullivan County,229,60,60,0,0,16,13,13,0,0,213,47,47,0,0,748,104,644
361059523002,36, New York,105, Sullivan County,191,93,23,0,70,4,0,0,0,0,187,93,23,0,70,506,37,469
361059524001,36, New York,105, Sullivan County,354,57,53,0,4,0,0,0,0,0,354,57,53,0,4,1104,149,955
361059524002,36, New York,105, Sullivan County,264,71,57,6,8,0,0,0,0,0,264,71,57,6,8,841,14,827
361059525001,36, New York,105, Sullivan County,119,74,42,32,0,0,0,0,0,0,119,74,42,32,0,430,24,406
361059525002,36, New York,105, Sullivan County,138,19,8,11,0,0,0,0,0,0,138,19,8,11,0,453,4,449
361059525003,36, New York,105, Sullivan County,240,139,116,0,23,28,21,10,0,11,212,118,106,0,12,761,126,635
360999501001,36, New York,099, Seneca County,262,112,74,13,25,17,12,8,4,0,245,100,66,9,25,829,61,768
360999501002,36, New York,099, Seneca County,308,119,87,20,12,33,17,7,5,5,275,102,80,15,7,821,103,718
360999502001,36, New York,099, Seneca County,128,69,23,3,43,3,3,3,0,0,125,66,20,3,43,610,172,438
360999502002,36, New York,099, Seneca County,454,165,141,23,1,26,11,0,10,1,428,154,141,13,0,1365,192,1173
360999503001,36, New York,099, Seneca County,627,257,145,46,66,56,56,9,46,1,571,201,136,0,65,2023,149,1874
360999503002,36, New York,099, Seneca County,124,27,13,0,14,0,0,0,0,0,124,27,13,0,14,489,172,317
360999503003,36, New York,099, Seneca County,198,81,81,0,0,49,49,49,0,0,149,32,32,0,0,577,101,476
360999504001,36, New York,099, Seneca County,108,28,0,0,28,28,28,0,0,28,80,0,0,0,0,500,141,359
360999504002,36, New York,099, Seneca County,151,47,47,0,0,16,0,0,0,0,135,47,47,0,0,551,129,422
360999504003,36, New York,099, Seneca County,341,156,135,0,21,21,21,0,0,21,320,135,135,0,0,1271,57,1214
360999505001,36, New York,099, Seneca County,218,68,25,28,15,0,0,0,0,0,218,68,25,28,15,715,66,649
360999505002,36, New York,099, Seneca County,82,48,7,3,38,31,31,0,0,31,51,17,7,3,7,369,90,279
360999505003,36, New York,099, Seneca County,564,255,137,34,84,22,22,12,10,0,542,233,125,24,84,1585,200,1385
360999506001,36, New York,099, Seneca County,465,222,190,23,9,0,0,0,0,0,465,222,190,23,9,1337,86,1251
360999506002,36, New York,099, Seneca County,493,148,107,30,11,12,0,0,0,0,481,148,107,30,11,1700,206,1494
360999507001,36, New York,099, Seneca County,282,60,50,0,10,9,0,0,0,0,273,60,50,0,10,849,79,770
360999507002,36, New York,099, Seneca County,223,147,137,10,0,34,34,34,0,0,189,113,103,10,0,588,117,471
360999507003,36, New York,099, Seneca County,223,73,34,0,39,0,0,0,0,0,223,73,34,0,39,536,0,536
360999507004,36, New York,099, Seneca County,275,136,64,28,44,35,27,0,0,27,240,109,64,28,17,703,73,630
360999508011,36, New York,099, Seneca County,0,0,0,0,0,0,0,0,0,0,0,0,0,0,0,0,0,0
360999508021,36, New York,099, Seneca County,166,87,49,31,7,43,40,15,18,7,123,47,34,13,0,435,100,335
360999508022,36, New York,099, Seneca County,195,83,64,8,11,10,9,9,0,0,185,74,55,8,11,635,95,540
360999508023,36, New York,099, Seneca County,247,118,99,8,11,2,2,0,0,2,245,116,99,8,9,620,37,583
360999508024,36, New York,099, Seneca County,327,149,72,42,35,39,31,15,0,16,288,118,57,42,19,930,94,836
360999509001,36, New York,099, Seneca County,152,66,57,7,2,8,8,8,0,0,144,58,49,7,2,517,42,475
360999509002,36, New York,099, Seneca County,202,128,74,29,25,35,28,19,0,9,167,100,55,29,16,694,160,534
360999509003,36, New York,099, Seneca County,174,22,10,8,4,2,2,0,0,2,172,20,10,8,2,625,31,594
360999509004,36, New York,099, Seneca County,139,44,23,7,14,8,8,0,0,8,131,36,23,7,6,429,50,379
360999509005,36, New York,099, Seneca County,233,116,96,16,4,5,3,1,2,0,228,113,95,14,4,961,98,863
360999510001,36, New York,099, Seneca County,183,71,47,20,4,27,10,7,3,0,156,61,40,17,4,572,88,484
360999510002,36, New York,099, Seneca County,215,53,41,0,12,11,6,0,0,6,204,47,41,0,6,489,44,445
360999510003,36, New York,099, Seneca County,180,71,64,0,7,0,0,0,0,0,180,71,64,0,7,462,2,460
360790101001,36, New York,079, Putnam County,413,47,23,18,6,7,0,0,0,0,406,47,23,18,6,1070,35,1035
360790101002,36, New York,079, Putnam County,408,184,135,10,39,17,0,0,0,0,391,184,135,10,39,1016,55,961
360790101003,36, New York,079, Putnam County,269,101,95,0,6,7,0,0,0,0,262,101,95,0,6,758,59,699
360790102011,36, New York,079, Putnam County,143,74,74,0,0,0,0,0,0,0,143,74,74,0,0,493,0,493
360790102012,36, New York,079, Putnam County,629,364,249,40,75,0,0,0,0,0,629,364,249,40,75,1609,82,1527
360790102013,36, New York,079, Putnam County,465,250,215,0,35,0,0,0,0,0,465,250,215,0,35,962,15,947
360790102021,36, New York,079, Putnam County,197,27,17,0,10,0,0,0,0,0,197,27,17,0,10,618,38,580
360790102022,36, New York,079, Putnam County,60,0,0,0,0,0,0,0,0,0,60,0,0,0,0,936,767,169
360790102023,36, New York,079, Putnam County,362,232,140,0,92,67,62,7,0,55,295,170,133,0,37,966,94,872
360790103001,36, New York,079, Putnam County,439,222,146,23,53,21,21,0,0,21,418,201,146,23,32,1205,79,1126
360790103002,36, New York,079, Putnam County,173,92,61,0,31,8,8,8,0,0,165,84,53,0,31,377,0,377
360790103003,36, New York,079, Putnam County,220,101,64,0,37,0,0,0,0,0,220,101,64,0,37,694,29,665
360790103004,36, New York,079, Putnam County,415,123,123,0,0,18,0,0,0,0,397,123,123,0,0,1235,75,1160
360790104001,36, New York,079, Putnam County,229,140,125,0,15,47,29,29,0,0,182,111,96,0,15,793,116,677
360790104002,36, New York,079, Putnam County,142,66,41,25,0,0,0,0,0,0,142,66,41,25,0,428,3,425
360790104003,36, New York,079, Putnam County,443,219,203,7,9,45,32,32,0,0,398,187,171,7,9,1175,115,1060
360790105001,36, New York,079, Putnam County,329,169,142,27,0,14,0,0,0,0,315,169,142,27,0,939,65,874
360790105002,36, New York,079, Putnam County,403,108,108,0,0,15,0,0,0,0,388,108,108,0,0,1093,108,985
360790105003,36, New York,079, Putnam County,627,255,223,0,32,0,0,0,0,0,627,255,223,0,32,1672,35,1637
360790106001,36, New York,079, Putnam County,130,50,42,0,8,5,0,0,0,0,125,50,42,0,8,473,78,395
360790106002,36, New York,079, Putnam County,412,136,117,0,19,17,9,0,0,9,395,127,117,0,10,1039,42,997
360790106003,36, New York,079, Putnam County,541,302,202,36,64,27,27,0,27,0,514,275,202,9,64,1348,59,1289
360790107001,36, New York,079, Putnam County,167,80,47,0,33,5,5,0,0,5,162,75,47,0,28,510,30,480
360790107002,36, New York,079, Putnam County,223,119,48,34,37,26,26,8,0,18,197,93,40,34,19,673,97,576
360790107003,36, New York,079, Putnam County,279,119,87,5,27,5,5,0,5,0,274,114,87,0,27,754,15,739
360790108001,36, New York,079, Putnam County,238,68,63,0,5,6,0,0,0,0,232,68,63,0,5,1012,303,709
360790108002,36, New York,079, Putnam County,289,119,112,0,7,0,0,0,0,0,289,119,112,0,7,677,28,649
360790108003,36, New York,079, Putnam County,384,177,171,0,6,0,0,0,0,0,384,177,171,0,6,1141,19,1122
360790109011,36, New York,079, Putnam County,394,258,124,25,109,123,109,0,0,109,271,149,124,25,0,1083,306,777
360790109012,36, New York,079, Putnam County,203,50,0,12,38,0,0,0,0,0,203,50,0,12,38,675,18,657
360790109013,36, New York,079, Putnam County,361,167,143,0,24,9,0,0,0,0,352,167,143,0,24,1164,38,1126
360790109021,36, New York,079, Putnam County,272,118,75,6,37,47,0,0,0,0,225,118,75,6,37,744,112,632
360790109022,36, New York,079, Putnam County,473,318,243,0,75,17,0,0,0,0,456,318,243,0,75,1051,35,1016
360790109023,36, New York,079, Putnam County,349,147,109,0,38,0,0,0,0,0,349,147,109,0,38,1230,13,1217
360790110001,36, New York,079, Putnam County,188,20,20,0,0,10,0,0,0,0,178,20,20,0,0,668,43,625
360790110002,36, New York,079, Putnam County,326,97,97,0,0,0,0,0,0,0,326,97,97,0,0,878,19,859
360790110003,36, New York,079, Putnam County,292,184,184,0,0,0,0,0,0,0,292,184,184,0,0,806,30,776
360790110004,36, New York,079, Putnam County,347,106,46,0,60,0,0,0,0,0,347,106,46,0,60,975,8,967
360790111001,36, New York,079, Putnam County,648,174,156,0,18,26,12,0,0,12,622,162,156,0,6,1737,37,1700
360790111002,36, New York,079, Putnam County,380,95,79,0,16,0,0,0,0,0,380,95,79,0,16,1060,23,1037
360790111003,36, New York,079, Putnam County,459,180,137,0,43,0,0,0,0,0,459,180,137,0,43,1180,0,1180
360790112011,36, New York,079, Putnam County,449,213,121,15,77,0,0,0,0,0,449,213,121,15,77,1280,5,1275
360790112012,36, New York,079, Putnam County,283,120,120,0,0,0,0,0,0,0,283,120,120,0,0,748,17,731
360790112021,36, New York,079, Putnam County,428,230,185,10,35,44,35,0,0,35,384,195,185,10,0,1373,59,1314
360790112022,36, New York,079, Putnam County,563,229,229,0,0,29,0,0,0,0,534,229,229,0,0,1338,82,1256
360790113001,36, New York,079, Putnam County,269,144,95,49,0,0,0,0,0,0,269,144,95,49,0,792,8,784
360790113002,36, New York,079, Putnam County,680,283,254,0,29,13,13,0,0,13,667,270,254,0,16,1825,48,1777
360790113003,36, New York,079, Putnam County,318,155,67,0,88,6,0,0,0,0,312,155,67,0,88,702,11,691
360790114001,36, New York,079, Putnam County,512,208,183,1,24,6,0,0,0,0,506,208,183,1,24,1516,52,1464
360790114002,36, New York,079, Putnam County,353,159,143,0,16,0,0,0,0,0,353,159,143,0,16,1264,13,1251
360790114003,36, New York,079, Putnam County,251,55,41,0,14,0,0,0,0,0,251,55,41,0,14,501,9,492
360790114004,36, New York,079, Putnam County,273,85,68,0,17,7,7,0,0,7,266,78,68,0,10,1021,15,1006
360790115011,36, New York,079, Putnam County,686,290,252,38,0,0,0,0,0,0,686,290,252,38,0,1846,26,1820
360790115012,36, New York,079, Putnam County,339,64,64,0,0,0,0,0,0,0,339,64,64,0,0,1356,188,1168
360790115021,36, New York,079, Putnam County,425,154,124,0,30,30,30,0,0,30,395,124,124,0,0,1126,42,1084
360790115022,36, New York,079, Putnam County,321,91,91,0,0,15,0,0,0,0,306,91,91,0,0,854,26,828
360790116001,36, New York,079, Putnam County,265,119,62,0,57,51,51,0,0,51,214,68,62,0,6,793,60,733
360790116002,36, New York,079, Putnam County,372,89,68,0,21,0,0,0,0,0,372,89,68,0,21,1195,15,1180
360790116003,36, New York,079, Putnam County,594,205,176,0,29,0,0,0,0,0,594,205,176,0,29,1683,27,1656
360790116004,36, New York,079, Putnam County,246,146,119,0,27,0,0,0,0,0,246,146,119,0,27,694,21,673
360790117001,36, New York,079, Putnam County,369,175,157,8,10,0,0,0,0,0,369,175,157,8,10,1035,15,1020
360790117002,36, New York,079, Putnam County,318,162,155,7,0,0,0,0,0,0,318,162,155,7,0,815,0,815
360790117003,36, New York,079, Putnam County,671,148,132,8,8,8,8,0,0,8,663,140,132,8,0,2002,100,1902
360790118011,36, New York,079, Putnam County,310,222,183,0,39,8,8,0,0,8,302,214,183,0,31,783,145,638
360790118012,36, New York,079, Putnam County,181,79,59,0,20,45,45,25,0,20,136,34,34,0,0,653,84,569
360790118013,36, New York,079, Putnam County,367,195,114,39,42,12,0,0,0,0,355,195,114,39,42,836,33,803
360790118021,36, New York,079, Putnam County,337,255,243,0,12,80,80,80,0,0,257,175,163,0,12,720,0,720
360790118022,36, New York,079, Putnam County,514,217,191,0,26,15,15,15,0,0,499,202,176,0,26,1010,53,957
360790118023,36, New York,079, Putnam County,205,86,61,25,0,0,0,0,0,0,205,86,61,25,0,461,15,446
360790118024,36, New York,079, Putnam County,326,66,55,0,11,18,18,7,0,11,308,48,48,0,0,926,129,797
360790119001,36, New York,079, Putnam County,332,129,88,18,23,0,0,0,0,0,332,129,88,18,23,804,17,787
360790119002,36, New York,079, Putnam County,219,90,72,0,18,0,0,0,0,0,219,90,72,0,18,620,8,612
360790119003,36, New York,079, Putnam County,512,297,152,12,133,36,36,36,0,0,476,261,116,12,133,1288,49,1239
360790119004,36, New York,079, Putnam County,315,60,60,0,0,0,0,0,0,0,315,60,60,0,0,797,19,778
360750201011,36, New York,075, Oswego County,150,83,67,3,13,3,0,0,0,0,147,83,67,3,13,512,35,477
360750201012,36, New York,075, Oswego County,174,92,57,22,13,27,23,15,4,4,147,69,42,18,9,497,137,360
360750201013,36, New York,075, Oswego County,154,64,41,4,19,17,15,11,0,4,137,49,30,4,15,542,88,454
360750201021,36, New York,075, Oswego County,271,169,126,7,36,49,36,3,0,33,222,133,123,7,3,740,128,612
360750201022,36, New York,075, Oswego County,119,44,37,4,3,1,1,0,0,1,118,43,37,4,2,333,24,309
360750202011,36, New York,075, Oswego County,565,299,192,60,47,100,76,0,37,39,465,223,192,23,8,1414,277,1137
360750202012,36, New York,075, Oswego County,178,43,11,32,0,0,0,0,0,0,178,43,11,32,0,600,102,498
360750202021,36, New York,075, Oswego County,322,180,115,37,28,48,42,27,3,12,274,138,88,34,16,1036,200,836
360750203011,36, New York,075, Oswego County,323,151,91,0,60,40,34,0,0,34,283,117,91,0,26,1109,131,978
360750203012,36, New York,075, Oswego County,183,45,27,0,18,29,18,0,0,18,154,27,27,0,0,624,81,543
360750203031,36, New York,075, Oswego County,537,194,132,18,44,36,21,6,11,4,501,173,126,7,40,1530,126,1404
360750203041,36, New York,075, Oswego County,417,284,145,73,66,97,77,77,0,0,320,207,68,73,66,1179,274,905
360750204001,36, New York,075, Oswego County,359,195,99,85,11,32,3,3,0,0,327,192,96,85,11,1160,202,958
360750204002,36, New York,075, Oswego County,279,41,0,41,0,0,0,0,0,0,279,41,0,41,0,812,13,799
360750204003,36, New York,075, Oswego County,612,228,113,25,90,120,93,25,2,66,492,135,88,23,24,1967,261,1706
360750204004,36, New York,075, Oswego County,128,75,38,16,21,21,21,0,0,21,107,54,38,16,0,272,21,251
360750205011,36, New York,075, Oswego County,162,80,49,0,31,28,13,3,0,10,134,67,46,0,21,532,95,437
360750205012,36, New York,075, Oswego County,288,175,90,50,35,25,17,3,4,10,263,158,87,46,25,781,90,691
360750205021,36, New York,075, Oswego County,279,125,63,13,49,30,30,3,6,21,249,95,60,7,28,743,139,604
360750205022,36, New York,075, Oswego County,435,181,137,12,32,10,5,0,1,4,425,176,137,11,28,1367,111,1256
360750205031,36, New York,075, Oswego County,275,125,101,0,24,25,15,0,0,15,250,110,101,0,9,877,127,750
360750206001,36, New York,075, Oswego County,233,129,79,10,40,27,27,13,1,13,206,102,66,9,27,622,58,564
360750206002,36, New York,075, Oswego County,1080,393,267,0,126,41,34,1,0,33,1039,359,266,0,93,3114,278,2836
360750207031,36, New York,075, Oswego County,304,97,97,0,0,0,0,0,0,0,304,97,97,0,0,1024,178,846
360750207032,36, New York,075, Oswego County,293,108,53,28,27,9,9,0,0,9,284,99,53,28,18,1131,54,1077
360750207033,36, New York,075, Oswego County,413,178,145,0,33,16,16,0,0,16,397,162,145,0,17,1150,31,1119
360750207034,36, New York,075, Oswego County,399,139,40,10,89,109,69,0,0,69,290,70,40,10,20,914,163,751
360750207041,36, New York,075, Oswego County,138,54,48,6,0,6,0,0,0,0,132,54,48,6,0,428,32,396
360750207042,36, New York,075, Oswego County,465,178,107,60,11,11,11,0,0,11,454,167,107,60,0,1199,46,1153
360750207051,36, New York,075, Oswego County,271,154,79,23,52,67,67,27,0,40,204,87,52,23,12,684,112,572
360750207052,36, New York,075, Oswego County,326,123,75,6,42,47,42,0,0,42,279,81,75,6,0,913,145,768
360750207061,36, New York,075, Oswego County,363,153,116,13,24,45,45,25,6,14,318,108,91,7,10,1154,169,985
360750207062,36, New York,075, Oswego County,235,136,66,35,35,45,24,4,0,20,190,112,62,35,15,591,84,507
360750207071,36, New York,075, Oswego County,541,188,110,34,44,38,25,0,0,25,503,163,110,34,19,1572,153,1419
360750208001,36, New York,075, Oswego County,416,162,138,8,16,57,42,27,8,7,359,120,111,0,9,1300,211,1089
360750208002,36, New York,075, Oswego County,334,143,76,33,34,67,67,23,10,34,267,76,53,23,0,1066,229,837
360750209011,36, New York,075, Oswego County,261,159,102,4,53,44,44,17,0,27,217,115,85,4,26,921,74,847
360750209012,36, New York,075, Oswego County,272,182,74,9,99,87,87,4,0,83,185,95,70,9,16,891,208,683
360750209031,36, New York,075, Oswego County,243,177,114,0,63,123,123,86,0,37,120,54,28,0,26,612,189,423
360750209032,36, New York,075, Oswego County,168,75,63,0,12,0,0,0,0,0,168,75,63,0,12,574,26,548
360750209033,36, New York,075, Oswego County,265,66,26,0,40,40,40,0,0,40,225,26,26,0,0,854,76,778
360750209041,36, New York,075, Oswego County,227,59,50,0,9,0,0,0,0,0,227,59,50,0,9,591,0,591
360750209042,36, New York,075, Oswego County,333,181,137,0,44,17,9,9,0,0,316,172,128,0,44,898,49,849
360750209051,36, New York,075, Oswego County,329,125,109,0,16,4,4,0,0,4,325,121,109,0,12,858,4,854
360750210011,36, New York,075, Oswego County,301,66,50,16,0,0,0,0,0,0,301,66,50,16,0,820,17,803
360750210012,36, New York,075, Oswego County,405,214,81,45,88,62,62,0,18,44,343,152,81,27,44,1088,191,897
360750210021,36, New York,075, Oswego County,566,232,66,10,156,37,37,0,0,37,529,195,66,10,119,1832,207,1625
360750210031,36, New York,075, Oswego County,300,99,68,0,31,30,8,8,0,0,270,91,60,0,31,887,157,730
360750211011,36, New York,075, Oswego County,199,168,87,7,74,48,48,0,0,48,151,120,87,7,26,496,112,384
360750211012,36, New York,075, Oswego County,180,103,61,7,35,62,35,0,0,35,118,68,61,7,0,660,202,458
360750211013,36, New York,075, Oswego County,228,140,30,13,97,107,45,0,13,32,121,95,30,0,65,808,315,493
360750211014,36, New York,075, Oswego County,241,114,114,0,0,9,0,0,0,0,232,114,114,0,0,800,138,662
360750211021,36, New York,075, Oswego County,507,282,36,40,206,177,155,7,15,133,330,127,29,25,73,1278,458,820
360750211022,36, New York,075, Oswego County,95,49,27,2,20,39,39,17,2,20,56,10,10,0,0,323,52,271
360750211031,36, New York,075, Oswego County,370,229,103,49,77,25,25,0,16,9,345,204,103,33,68,1038,88,950
360750211032,36, New York,075, Oswego County,453,202,107,63,32,37,37,5,0,32,416,165,102,63,0,1065,66,999
360750211041,36, New York,075, Oswego County,241,92,34,53,5,38,10,10,0,0,203,82,24,53,5,613,126,487
360750211042,36, New York,075, Oswego County,199,124,23,47,54,0,0,0,0,0,199,124,23,47,54,566,10,556
360750211043,36, New York,075, Oswego County,247,203,8,44,151,61,61,0,0,61,186,142,8,44,90,790,195,595
360750212011,36, New York,075, Oswego County,337,176,50,85,41,60,46,0,5,41,277,130,50,80,0,812,170,642
360750212021,36, New York,075, Oswego County,291,138,21,48,69,83,69,0,0,69,208,69,21,48,0,893,228,665
360750212022,36, New York,075, Oswego County,365,127,60,14,53,14,14,14,0,0,351,113,46,14,53,1249,58,1191
360750212031,36, New York,075, Oswego County,588,297,229,31,37,31,31,0,31,0,557,266,229,0,37,1463,108,1355
360750212032,36, New York,075, Oswego County,328,11,11,0,0,0,0,0,0,0,328,11,11,0,0,791,22,769
360750213001,36, New York,075, Oswego County,386,161,62,41,58,33,33,21,0,12,353,128,41,41,46,1179,142,1037
360750213002,36, New York,075, Oswego County,280,111,82,26,3,25,3,3,0,0,255,108,79,26,3,853,123,730
360750213003,36, New York,075, Oswego County,571,192,132,40,20,78,66,57,0,9,493,126,75,40,11,1524,226,1298
360750214011,36, New York,075, Oswego County,490,160,114,9,37,44,44,44,0,0,446,116,70,9,37,1406,126,1280
360750214012,36, New York,075, Oswego County,616,257,204,24,29,39,24,0,24,0,577,233,204,0,29,1804,94,1710
360750214013,36, New York,075, Oswego County,93,28,28,0,0,28,28,28,0,0,65,0,0,0,0,284,84,200
360750214014,36, New York,075, Oswego County,118,100,0,0,100,0,0,0,0,0,118,100,0,0,100,199,37,162
360750214021,36, New York,075, Oswego County,511,202,141,18,43,20,13,0,2,11,491,189,141,16,32,1393,99,1294
360750215011,36, New York,075, Oswego County,496,254,159,31,64,36,32,7,11,14,460,222,152,20,50,1259,101,1158
360750215012,36, New York,075, Oswego County,380,165,97,4,64,24,24,2,4,18,356,141,95,0,46,962,84,878
360750215031,36, New York,075, Oswego County,356,171,98,11,62,11,11,0,11,0,345,160,98,0,62,799,11,788
360750215032,36, New York,075, Oswego County,376,133,133,0,0,9,9,9,0,0,367,124,124,0,0,1048,35,1013
360750215041,36, New York,075, Oswego County,207,84,23,0,61,0,0,0,0,0,207,84,23,0,61,721,142,579
360750215042,36, New York,075, Oswego County,376,134,86,13,35,15,15,0,0,15,361,119,86,13,20,1186,84,1102
360750215051,36, New York,075, Oswego County,492,303,226,8,69,34,27,19,8,0,458,276,207,0,69,1536,214,1322
360750216011,36, New York,075, Oswego County,70,36,9,0,27,0,0,0,0,0,70,36,9,0,27,433,57,376
360750216012,36, New York,075, Oswego County,280,128,36,0,92,92,92,0,0,92,188,36,36,0,0,881,236,645
360750216013,36, New York,075, Oswego County,172,38,19,8,11,0,0,0,0,0,172,38,19,8,11,794,123,671
360750216021,36, New York,075, Oswego County,266,145,83,7,55,43,39,0,0,39,223,106,83,7,16,1368,444,924
360750216022,36, New York,075, Oswego County,182,98,48,0,50,67,50,0,0,50,115,48,48,0,0,802,358,444
360750216031,36, New York,075, Oswego County,250,124,51,60,13,33,33,23,10,0,217,91,28,50,13,580,113,467
360750216032,36, New York,075, Oswego County,408,167,56,8,103,18,18,0,0,18,390,149,56,8,85,1111,97,1014
360750216033,36, New York,075, Oswego County,307,89,89,0,0,0,0,0,0,0,307,89,89,0,0,972,64,908
360750216041,36, New York,075, Oswego County,331,136,70,10,56,64,64,30,10,24,267,72,40,0,32,1091,187,904
360750216042,36, New York,075, Oswego County,281,242,176,66,0,66,66,0,66,0,215,176,176,0,0,833,182,651
360750216043,36, New York,075, Oswego County,411,305,94,0,211,51,51,0,0,51,360,254,94,0,160,1283,222,1061
360750216051,36, New York,075, Oswego County,344,223,122,0,101,129,129,57,0,72,215,94,65,0,29,1033,318,715
360750216052,36, New York,075, Oswego County,131,34,15,0,19,19,19,0,0,19,112,15,15,0,0,332,49,283
360750216053,36, New York,075, Oswego County,61,19,10,0,9,9,9,0,0,9,52,10,10,0,0,316,39,277
360750216054,36, New York,075, Oswego County,200,140,86,0,54,68,54,0,0,54,132,86,86,0,0,662,223,439
360759900000,36, New York,075, Oswego County,0,0,0,0,0,0,0,0,0,0,0,0,0,0,0,0,0,0
360775901011,36, New York,077, Otsego County,196,67,38,0,29,18,8,0,0,8,178,59,38,0,21,598,84,514
360775901012,36, New York,077, Otsego County,180,62,62,0,0,25,25,25,0,0,155,37,37,0,0,522,105,417
360775901013,36, New York,077, Otsego County,217,75,55,2,18,11,11,0,0,11,206,64,55,2,7,637,34,603
360775901021,36, New York,077, Otsego County,211,58,48,5,5,25,6,6,0,0,186,52,42,5,5,689,88,601
360775901022,36, New York,077, Otsego County,329,41,41,0,0,0,0,0,0,0,329,41,41,0,0,900,11,889
360775902011,36, New York,077, Otsego County,202,86,60,0,26,12,12,12,0,0,190,74,48,0,26,527,32,495
360775902012,36, New York,077, Otsego County,424,128,104,0,24,25,23,7,0,16,399,105,97,0,8,1320,124,1196
360775902021,36, New York,077, Otsego County,199,39,39,0,0,9,0,0,0,0,190,39,39,0,0,499,23,476
360775902022,36, New York,077, Otsego County,79,6,3,3,0,0,0,0,0,0,79,6,3,3,0,320,26,294
360775902023,36, New York,077, Otsego County,354,80,59,5,16,22,5,0,5,0,332,75,59,0,16,1273,113,1160
360775902024,36, New York,077, Otsego County,273,123,76,0,47,0,0,0,0,0,273,123,76,0,47,686,0,686
360775903011,36, New York,077, Otsego County,176,57,52,0,5,42,17,17,0,0,134,40,35,0,5,535,108,427
360775903012,36, New York,077, Otsego County,173,86,18,13,55,42,39,2,13,24,131,47,16,0,31,626,126,500
360775903013,36, New York,077, Otsego County,118,46,27,3,16,0,0,0,0,0,118,46,27,3,16,357,26,331
360775903021,36, New York,077, Otsego County,214,109,79,6,24,16,9,6,0,3,198,100,73,6,21,781,54,727
360775903022,36, New York,077, Otsego County,307,101,78,8,15,12,0,0,0,0,295,101,78,8,15,879,55,824
360775904011,36, New York,077, Otsego County,167,63,50,2,11,31,19,8,0,11,136,44,42,2,0,535,86,449
360775904012,36, New York,077, Otsego County,272,168,122,22,24,35,25,14,0,11,237,143,108,22,13,964,195,769
360775904021,36, New York,077, Otsego County,309,89,70,5,14,12,9,0,0,9,297,80,70,5,5,896,81,815
360775904022,36, New York,077, Otsego County,261,102,66,9,27,36,27,14,3,10,225,75,52,6,17,831,160,671
360775904023,36, New York,077, Otsego County,353,99,90,3,6,15,11,11,0,0,338,88,79,3,6,1158,118,1040
360775905001,36, New York,077, Otsego County,219,88,14,12,62,0,0,0,0,0,219,88,14,12,62,723,76,647
360775905002,36, New York,077, Otsego County,171,51,31,10,10,15,4,4,0,0,156,47,27,10,10,648,83,565
360775905003,36, New York,077, Otsego County,309,113,113,0,0,0,0,0,0,0,309,113,113,0,0,887,31,856
360775906001,36, New York,077, Otsego County,276,88,54,7,27,17,15,1,2,12,259,73,53,5,15,913,121,792
360775906002,36, New York,077, Otsego County,182,60,47,6,7,20,3,0,2,1,162,57,47,4,6,623,81,542
360775907011,36, New York,077, Otsego County,285,84,50,19,15,25,17,0,7,10,260,67,50,12,5,900,84,816
360775907012,36, New York,077, Otsego County,152,63,30,9,24,8,8,3,0,5,144,55,27,9,19,444,34,410
360775907021,36, New York,077, Otsego County,142,28,13,9,6,0,0,0,0,0,142,28,13,9,6,514,27,487
360775907022,36, New York,077, Otsego County,232,107,95,0,12,6,0,0,0,0,226,107,95,0,12,761,21,740
360775907023,36, New York,077, Otsego County,98,30,30,0,0,0,0,0,0,0,98,30,30,0,0,365,28,337
360775908001,36, New York,077, Otsego County,223,125,95,0,30,18,18,0,0,18,205,107,95,0,12,582,32,550
360775908002,36, New York,077, Otsego County,255,85,56,20,9,0,0,0,0,0,255,85,56,20,9,968,97,871
360775908003,36, New York,077, Otsego County,191,111,22,81,8,22,22,22,0,0,169,89,0,81,8,529,152,377
360775908004,36, New York,077, Otsego County,333,115,47,0,68,23,0,0,0,0,310,115,47,0,68,763,143,620
360775908005,36, New York,077, Otsego County,275,18,18,0,0,0,0,0,0,0,275,18,18,0,0,1089,118,971
360775909001,36, New York,077, Otsego County,160,69,69,0,0,0,0,0,0,0,160,69,69,0,0,718,9,709
360775909002,36, New York,077, Otsego County,244,142,63,22,57,0,0,0,0,0,244,142,63,22,57,604,8,596
360775909003,36, New York,077, Otsego County,131,45,45,0,0,35,35,35,0,0,96,10,10,0,0,614,264,350
360775910001,36, New York,077, Otsego County,233,55,46,0,9,9,9,0,0,9,224,46,46,0,0,870,56,814
360775910002,36, New York,077, Otsego County,332,155,53,0,102,102,102,0,0,102,230,53,53,0,0,1175,301,874
360775910003,36, New York,077, Otsego County,84,13,0,0,13,13,13,0,0,13,71,0,0,0,0,563,80,483
360775911001,36, New York,077, Otsego County,392,204,52,21,131,100,90,0,0,90,292,114,52,21,41,1414,247,1167
360775911002,36, New York,077, Otsego County,384,148,80,18,50,0,0,0,0,0,384,148,80,18,50,1443,632,811
360775914011,36, New York,077, Otsego County,338,120,102,0,18,34,0,0,0,0,304,120,102,0,18,1198,230,968
360775914012,36, New York,077, Otsego County,139,13,13,0,0,6,0,0,0,0,133,13,13,0,0,393,11,382
360775914013,36, New York,077, Otsego County,248,93,44,24,25,17,17,2,15,0,231,76,42,9,25,729,40,689
360775914021,36, New York,077, Otsego County,242,146,102,14,30,40,30,14,0,16,202,116,88,14,14,783,123,660
360775914022,36, New York,077, Otsego County,321,35,31,0,4,0,0,0,0,0,321,35,31,0,4,976,26,950
360775915001,36, New York,077, Otsego County,216,55,28,9,18,6,6,2,4,0,210,49,26,5,18,712,31,681
360775915002,36, New York,077, Otsego County,309,135,111,4,20,31,20,0,0,20,278,115,111,4,0,862,90,772
360775915003,36, New York,077, Otsego County,258,99,77,22,0,5,5,0,5,0,253,94,77,17,0,727,8,719
360775915004,36, New York,077, Otsego County,163,68,58,0,10,23,19,9,0,10,140,49,49,0,0,545,106,439
360775916011,36, New York,077, Otsego County,250,110,87,12,11,27,13,13,0,0,223,97,74,12,11,815,90,725
360775916012,36, New York,077, Otsego County,167,42,15,12,15,20,16,7,3,6,147,26,8,9,9,574,104,470
360775916021,36, New York,077, Otsego County,197,72,43,29,0,4,0,0,0,0,193,72,43,29,0,705,31,674
360775916022,36, New York,077, Otsego County,329,132,95,23,14,28,4,4,0,0,301,128,91,23,14,1324,206,1118
360775917001,36, New York,077, Otsego County,26,18,18,0,0,0,0,0,0,0,26,18,18,0,0,148,51,97
360775917002,36, New York,077, Otsego County,247,99,68,13,18,11,5,0,0,5,236,94,68,13,13,724,48,676
360894901001,36, New York,089, St. Lawrence County,101,50,33,0,17,0,0,0,0,0,101,50,33,0,17,510,200,310
360894901002,36, New York,089, St. Lawrence County,385,147,49,49,49,0,0,0,0,0,385,147,49,49,49,937,149,788
360894901003,36, New York,089, St. Lawrence County,163,71,44,16,11,35,35,24,0,11,128,36,20,16,0,583,105,478
360894901004,36, New York,089, St. Lawrence County,221,72,18,0,54,13,13,4,0,9,208,59,14,0,45,562,53,509
360894902001,36, New York,089, St. Lawrence County,46,26,11,0,15,38,26,11,0,15,8,0,0,0,0,239,71,168
360894902002,36, New York,089, St. Lawrence County,180,71,40,21,10,10,10,0,0,10,170,61,40,21,0,609,124,485
360894902003,36, New York,089, St. Lawrence County,265,50,34,0,16,31,0,0,0,0,234,50,34,0,16,793,62,731
360894902004,36, New York,089, St. Lawrence County,117,50,34,0,16,11,11,0,0,11,106,39,34,0,5,464,65,399
360894902005,36, New York,089, St. Lawrence County,233,128,52,13,63,25,17,0,0,17,208,111,52,13,46,889,178,711
360894903001,36, New York,089, St. Lawrence County,71,0,0,0,0,0,0,0,0,0,71,0,0,0,0,538,83,455
360894903002,36, New York,089, St. Lawrence County,240,165,69,68,28,68,68,0,68,0,172,97,69,0,28,650,87,563
360894903003,36, New York,089, St. Lawrence County,158,119,68,0,51,112,86,35,0,51,46,33,33,0,0,558,123,435
360894903004,36, New York,089, St. Lawrence County,86,61,0,0,61,0,0,0,0,0,86,61,0,0,61,587,344,243
360894903005,36, New York,089, St. Lawrence County,305,55,6,0,49,79,49,0,0,49,226,6,6,0,0,689,128,561
360894903006,36, New York,089, St. Lawrence County,147,42,42,0,0,0,0,0,0,0,147,42,42,0,0,1223,162,1061
360894904001,36, New York,089, St. Lawrence County,308,160,95,22,43,55,48,5,0,43,253,112,90,22,0,794,173,621
360894904002,36, New York,089, St. Lawrence County,360,177,166,0,11,7,0,0,0,0,353,177,166,0,11,890,43,847
360894904003,36, New York,089, St. Lawrence County,174,76,73,0,3,7,0,0,0,0,167,76,73,0,3,560,42,518
360894905001,36, New York,089, St. Lawrence County,289,119,78,27,14,39,34,3,21,10,250,85,75,6,4,790,123,667
360894905002,36, New York,089, St. Lawrence County,394,199,121,40,38,59,50,23,12,15,335,149,98,28,23,1081,189,892
360894905003,36, New York,089, St. Lawrence County,346,132,88,0,44,9,9,0,0,9,337,123,88,0,35,1044,83,961
360894906001,36, New York,089, St. Lawrence County,244,69,69,0,0,9,0,0,0,0,235,69,69,0,0,759,31,728
360894906002,36, New York,089, St. Lawrence County,453,276,194,36,46,110,74,39,0,35,343,202,155,36,11,1300,397,903
360894906003,36, New York,089, St. Lawrence County,397,166,97,0,69,58,46,21,0,25,339,120,76,0,44,844,114,730
360894906004,36, New York,089, St. Lawrence County,152,63,12,0,51,0,0,0,0,0,152,63,12,0,51,466,34,432
360894907001,36, New York,089, St. Lawrence County,335,225,171,17,37,42,42,5,0,37,293,183,166,17,0,770,69,701
360894907002,36, New York,089, St. Lawrence County,699,264,178,22,64,73,23,16,0,7,626,241,162,22,57,2152,320,1832
360894907003,36, New York,089, St. Lawrence County,205,107,83,24,0,0,0,0,0,0,205,107,83,24,0,453,21,432
360894907004,36, New York,089, St. Lawrence County,506,160,151,9,0,22,9,0,9,0,484,151,151,0,0,1510,83,1427
360894908001,36, New York,089, St. Lawrence County,195,103,40,9,54,29,22,22,0,0,166,81,18,9,54,592,162,430
360894908002,36, New York,089, St. Lawrence County,211,104,104,0,0,26,0,0,0,0,185,104,104,0,0,948,296,652
360894908003,36, New York,089, St. Lawrence County,236,150,150,0,0,10,0,0,0,0,226,150,150,0,0,1167,399,768
360894909001,36, New York,089, St. Lawrence County,128,44,38,0,6,0,0,0,0,0,128,44,38,0,6,641,47,594
360894909002,36, New York,089, St. Lawrence County,44,27,20,0,7,0,0,0,0,0,44,27,20,0,7,282,13,269
360894909003,36, New York,089, St. Lawrence County,159,89,80,0,9,0,0,0,0,0,159,89,80,0,9,583,118,465
360894909004,36, New York,089, St. Lawrence County,220,163,148,11,4,4,4,0,0,4,216,159,148,11,0,585,63,522
360894909005,36, New York,089, St. Lawrence County,128,23,23,0,0,25,9,9,0,0,103,14,14,0,0,425,102,323
360894910001,36, New York,089, St. Lawrence County,314,132,81,8,43,16,8,8,0,0,298,124,73,8,43,997,129,868
360894910002,36, New York,089, St. Lawrence County,488,219,139,8,72,60,57,0,7,50,428,162,139,1,22,1345,193,1152
360894910003,36, New York,089, St. Lawrence County,267,54,48,0,6,19,19,19,0,0,248,35,29,0,6,788,83,705
360894910004,36, New York,089, St. Lawrence County,135,59,23,11,25,12,0,0,0,0,123,59,23,11,25,408,83,325
360894911001,36, New York,089, St. Lawrence County,0,0,0,0,0,0,0,0,0,0,0,0,0,0,0,0,0,0
360894912001,36, New York,089, St. Lawrence County,0,0,0,0,0,0,0,0,0,0,0,0,0,0,0,0,0,0
360894913001,36, New York,089, St. Lawrence County,602,261,223,38,0,56,35,35,0,0,546,226,188,38,0,1653,190,1463
360894913002,36, New York,089, St. Lawrence County,96,84,45,0,39,0,0,0,0,0,96,84,45,0,39,340,0,340
360894913003,36, New York,089, St. Lawrence County,302,139,85,0,54,0,0,0,0,0,302,139,85,0,54,1028,28,1000
360894914001,36, New York,089, St. Lawrence County,235,84,15,0,69,25,25,0,0,25,210,59,15,0,44,743,129,614
360894914002,36, New York,089, St. Lawrence County,263,153,138,14,1,14,14,0,14,0,249,139,138,0,1,700,28,672
360894914003,36, New York,089, St. Lawrence County,360,176,31,35,110,53,53,0,35,18,307,123,31,0,92,986,92,894
360894914004,36, New York,089, St. Lawrence County,0,0,0,0,0,0,0,0,0,0,0,0,0,0,0,52,52,0
360894915001,36, New York,089, St. Lawrence County,142,29,0,13,16,21,0,0,0,0,121,29,0,13,16,608,228,380
360894915002,36, New York,089, St. Lawrence County,240,178,54,0,124,123,105,0,0,105,117,73,54,0,19,502,188,314
360894915003,36, New York,089, St. Lawrence County,265,122,37,76,9,10,0,0,0,0,255,122,37,76,9,536,60,476
360894915004,36, New York,089, St. Lawrence County,199,82,32,31,19,17,17,0,17,0,182,65,32,14,19,608,35,573
360894915005,36, New York,089, St. Lawrence County,151,62,25,14,23,54,29,17,0,12,97,33,8,14,11,406,109,297
360894916001,36, New York,089, St. Lawrence County,123,61,12,20,29,11,11,0,11,0,112,50,12,9,29,326,29,297
360894916002,36, New York,089, St. Lawrence County,204,111,33,21,57,20,20,5,0,15,184,91,28,21,42,567,35,532
360894916003,36, New York,089, St. Lawrence County,173,88,50,13,25,14,7,0,7,0,159,81,50,6,25,530,58,472
360894917001,36, New York,089, St. Lawrence County,201,36,19,0,17,0,0,0,0,0,201,36,19,0,17,616,19,597
360894917002,36, New York,089, St. Lawrence County,172,86,85,1,0,7,7,7,0,0,165,79,78,1,0,464,37,427
360894917003,36, New York,089, St. Lawrence County,279,108,69,0,39,61,22,0,0,22,218,86,69,0,17,826,126,700
360894917004,36, New York,089, St. Lawrence County,341,147,126,3,18,24,24,18,0,6,317,123,108,3,12,1135,123,1012
360894918001,36, New York,089, St. Lawrence County,387,186,147,4,35,40,25,24,0,1,347,161,123,4,34,1137,145,992
360894918002,36, New York,089, St. Lawrence County,408,236,172,7,57,96,62,50,0,12,312,174,122,7,45,1180,268,912
360894918003,36, New York,089, St. Lawrence County,249,116,67,19,30,7,4,0,0,4,242,112,67,19,26,793,88,705
360894919001,36, New York,089, St. Lawrence County,0,0,0,0,0,0,0,0,0,0,0,0,0,0,0,0,0,0
360894920001,36, New York,089, St. Lawrence County,174,93,54,0,39,39,39,0,0,39,135,54,54,0,0,569,127,442
360894920002,36, New York,089, St. Lawrence County,288,91,91,0,0,0,0,0,0,0,288,91,91,0,0,674,0,674
360894920003,36, New York,089, St. Lawrence County,79,36,0,0,36,0,0,0,0,0,79,36,0,0,36,279,47,232
360894920004,36, New York,089, St. Lawrence County,353,204,204,0,0,53,53,53,0,0,300,151,151,0,0,1187,188,999
360894920005,36, New York,089, St. Lawrence County,352,247,102,0,145,0,0,0,0,0,352,247,102,0,145,891,35,856
360894921001,36, New York,089, St. Lawrence County,296,157,103,8,46,9,9,9,0,0,287,148,94,8,46,1175,335,840
360894921002,36, New York,089, St. Lawrence County,154,20,20,0,0,24,0,0,0,0,130,20,20,0,0,725,99,626
360894921003,36, New York,089, St. Lawrence County,442,174,73,8,93,58,58,0,1,57,384,116,73,7,36,1114,105,1009
360894923011,36, New York,089, St. Lawrence County,370,120,96,4,20,47,20,3,0,17,323,100,93,4,3,1027,143,884
360894923012,36, New York,089, St. Lawrence County,202,119,84,26,9,37,37,10,21,6,165,82,74,5,3,528,61,467
360894923013,36, New York,089, St. Lawrence County,334,98,68,5,25,35,35,5,5,25,299,63,63,0,0,855,52,803
360894923021,36, New York,089, St. Lawrence County,367,117,93,7,17,22,17,0,0,17,345,100,93,7,0,888,62,826
360894923022,36, New York,089, St. Lawrence County,445,188,145,6,37,11,11,11,0,0,434,177,134,6,37,1143,122,1021
360894924011,36, New York,089, St. Lawrence County,203,75,42,9,24,17,12,5,4,3,186,63,37,5,21,625,53,572
360894924012,36, New York,089, St. Lawrence County,302,140,59,43,38,29,22,13,2,7,273,118,46,41,31,1050,98,952
360894925011,36, New York,089, St. Lawrence County,260,105,89,3,13,32,23,13,0,10,228,82,76,3,3,712,100,612
360894925012,36, New York,089, St. Lawrence County,89,20,17,0,3,11,10,10,0,0,78,10,7,0,3,303,54,249
360894925013,36, New York,089, St. Lawrence County,222,67,26,19,22,27,18,6,0,12,195,49,20,19,10,645,93,552
360894926001,36, New York,089, St. Lawrence County,365,155,87,6,62,43,39,10,0,29,322,116,77,6,33,1064,101,963
360894926002,36, New York,089, St. Lawrence County,369,202,92,56,54,35,31,4,14,13,334,171,88,42,41,1054,141,913
360894926003,36, New York,089, St. Lawrence County,402,192,136,0,56,87,74,24,0,50,315,118,112,0,6,1124,191,933
360894926004,36, New York,089, St. Lawrence County,365,178,125,26,27,20,7,0,7,0,345,171,125,19,27,1062,87,975
360894927001,36, New York,089, St. Lawrence County,236,72,72,0,0,29,29,29,0,0,207,43,43,0,0,701,63,638
360894927002,36, New York,089, St. Lawrence County,159,76,76,0,0,20,20,20,0,0,139,56,56,0,0,497,60,437
360894927003,36, New York,089, St. Lawrence County,308,146,146,0,0,76,0,0,0,0,232,146,146,0,0,900,265,635
360894927004,36, New York,089, St. Lawrence County,49,29,29,0,0,0,0,0,0,0,49,29,29,0,0,385,93,292
360894927005,36, New York,089, St. Lawrence County,79,0,0,0,0,24,0,0,0,0,55,0,0,0,0,442,77,365
360894927006,36, New York,089, St. Lawrence County,121,48,48,0,0,42,0,0,0,0,79,48,48,0,0,471,123,348
360894927007,36, New York,089, St. Lawrence County,303,43,43,0,0,0,0,0,0,0,303,43,43,0,0,804,57,747
360894927008,36, New York,089, St. Lawrence County,286,37,21,16,0,64,0,0,0,0,222,37,21,16,0,628,163,465
360894928001,36, New York,089, St. Lawrence County,213,91,40,34,17,40,33,11,11,11,173,58,29,23,6,635,123,512
360894928002,36, New York,089, St. Lawrence County,209,130,93,0,37,63,55,22,0,33,146,75,71,0,4,914,360,554
360894928003,36, New York,089, St. Lawrence County,169,50,43,0,7,11,2,0,0,2,158,48,43,0,5,572,87,485
360894928004,36, New York,089, St. Lawrence County,139,64,24,15,25,38,28,1,14,13,101,36,23,1,12,439,96,343
360894929001,36, New York,089, St. Lawrence County,194,122,73,39,10,37,31,20,3,8,157,91,53,36,2,550,130,420
360894929002,36, New York,089, St. Lawrence County,191,104,55,16,33,25,22,7,0,15,166,82,48,16,18,495,96,399
360894929003,36, New York,089, St. Lawrence County,178,62,49,5,8,31,29,27,0,2,147,33,22,5,6,636,101,535
360894930001,36, New York,089, St. Lawrence County,104,28,13,13,2,12,8,6,0,2,92,20,7,13,0,243,15,228
360894930002,36, New York,089, St. Lawrence County,161,62,44,0,18,14,11,0,0,11,147,51,44,0,7,402,28,374
360894930003,36, New York,089, St. Lawrence County,55,5,5,0,0,5,5,5,0,0,50,0,0,0,0,155,16,139
361170201031,36, New York,117, Wayne County,807,217,194,4,19,16,6,0,0,6,791,211,194,4,13,2112,70,2042
361170201041,36, New York,117, Wayne County,810,325,250,15,60,41,41,9,0,32,769,284,241,15,28,2030,142,1888
361170201051,36, New York,117, Wayne County,876,378,197,0,181,60,48,0,0,48,816,330,197,0,133,2257,104,2153
361170201061,36, New York,117, Wayne County,529,290,196,0,94,9,0,0,0,0,520,290,196,0,94,1678,89,1589
361170202011,36, New York,117, Wayne County,178,44,18,0,26,16,0,0,0,0,162,44,18,0,26,599,75,524
361170202012,36, New York,117, Wayne County,529,181,127,21,33,33,7,0,7,0,496,174,127,14,33,1456,113,1343
361170202013,36, New York,117, Wayne County,560,239,198,16,25,15,7,7,0,0,545,232,191,16,25,1449,114,1335
361170202021,36, New York,117, Wayne County,345,182,172,0,10,11,11,11,0,0,334,171,161,0,10,902,73,829
361170202022,36, New York,117, Wayne County,478,312,140,0,172,10,10,0,0,10,468,302,140,0,162,1051,66,985
361170202023,36, New York,117, Wayne County,663,420,348,14,58,0,0,0,0,0,663,420,348,14,58,1661,20,1641
361170203021,36, New York,117, Wayne County,811,405,371,34,0,21,17,0,17,0,790,388,371,17,0,2053,53,2000
361170203022,36, New York,117, Wayne County,297,62,62,0,0,0,0,0,0,0,297,62,62,0,0,803,0,803
361170203023,36, New York,117, Wayne County,402,173,148,9,16,15,0,0,0,0,387,173,148,9,16,1323,123,1200
361170203031,36, New York,117, Wayne County,520,95,68,9,18,9,0,0,0,0,511,95,68,9,18,1284,41,1243
361170203032,36, New York,117, Wayne County,143,13,13,0,0,0,0,0,0,0,143,13,13,0,0,447,22,425
361170203033,36, New York,117, Wayne County,469,281,184,31,66,87,79,38,0,41,382,202,146,31,25,1189,207,982
361170204011,36, New York,117, Wayne County,237,49,36,6,7,7,0,0,0,0,230,49,36,6,7,625,30,595
361170204012,36, New York,117, Wayne County,554,198,166,18,14,13,0,0,0,0,541,198,166,18,14,1540,77,1463
361170204021,36, New York,117, Wayne County,572,288,105,62,121,66,66,0,41,25,506,222,105,21,96,1614,159,1455
361170204022,36, New York,117, Wayne County,518,236,148,46,42,36,30,0,0,30,482,206,148,46,12,1435,74,1361
361170205001,36, New York,117, Wayne County,377,123,66,14,43,9,9,0,9,0,368,114,66,5,43,1159,61,1098
361170205002,36, New York,117, Wayne County,246,116,83,25,8,0,0,0,0,0,246,116,83,25,8,752,63,689
361170205003,36, New York,117, Wayne County,528,180,160,9,11,40,33,22,0,11,488,147,138,9,0,1742,171,1571
361170206011,36, New York,117, Wayne County,509,156,114,18,24,6,0,0,0,0,503,156,114,18,24,1501,118,1383
361170206021,36, New York,117, Wayne County,634,233,202,0,31,21,11,0,0,11,613,222,202,0,20,1752,145,1607
361170207001,36, New York,117, Wayne County,209,50,24,26,0,26,26,0,26,0,183,24,24,0,0,783,216,567
361170207002,36, New York,117, Wayne County,492,227,211,10,6,31,31,31,0,0,461,196,180,10,6,1558,143,1415
361170207003,36, New York,117, Wayne County,227,57,12,0,45,0,0,0,0,0,227,57,12,0,45,612,14,598
361170208001,36, New York,117, Wayne County,480,63,29,11,23,0,0,0,0,0,480,63,29,11,23,1095,7,1088
361170208002,36, New York,117, Wayne County,305,90,66,0,24,65,65,65,0,0,240,25,1,0,24,859,234,625
361170208003,36, New York,117, Wayne County,298,114,57,15,42,8,8,0,0,8,290,106,57,15,34,944,29,915
361170209001,36, New York,117, Wayne County,211,145,111,0,34,0,0,0,0,0,211,145,111,0,34,696,0,696
361170209002,36, New York,117, Wayne County,217,42,23,0,19,0,0,0,0,0,217,42,23,0,19,1044,340,704
361170209003,36, New York,117, Wayne County,79,42,19,23,0,0,0,0,0,0,79,42,19,23,0,407,167,240
361170209004,36, New York,117, Wayne County,530,202,60,57,85,36,22,0,5,17,494,180,60,52,68,1617,213,1404
361170210001,36, New York,117, Wayne County,194,39,13,20,6,0,0,0,0,0,194,39,13,20,6,886,112,774
361170210002,36, New York,117, Wayne County,628,216,216,0,0,97,69,69,0,0,531,147,147,0,0,1613,201,1412
361170210003,36, New York,117, Wayne County,359,94,89,0,5,5,5,0,0,5,354,89,89,0,0,877,5,872
361170210004,36, New York,117, Wayne County,424,245,227,0,18,0,0,0,0,0,424,245,227,0,18,1345,131,1214
361170211001,36, New York,117, Wayne County,266,189,135,0,54,12,12,12,0,0,254,177,123,0,54,752,24,728
361170211002,36, New York,117, Wayne County,366,159,106,0,53,9,9,0,0,9,357,150,106,0,44,1054,49,1005
361170211003,36, New York,117, Wayne County,331,148,80,9,59,63,17,0,0,17,268,131,80,9,42,1131,259,872
361170211004,36, New York,117, Wayne County,238,93,66,0,27,0,0,0,0,0,238,93,66,0,27,818,60,758
361170212001,36, New York,117, Wayne County,264,159,104,39,16,24,24,8,0,16,240,135,96,39,0,679,92,587
361170212002,36, New York,117, Wayne County,459,217,67,14,136,44,44,0,0,44,415,173,67,14,92,1549,149,1400
361170212003,36, New York,117, Wayne County,129,43,10,33,0,10,10,10,0,0,119,33,0,33,0,446,57,389
361170212004,36, New York,117, Wayne County,224,149,23,21,105,77,77,0,0,77,147,72,23,21,28,1088,271,817
361170214001,36, New York,117, Wayne County,346,153,43,22,88,64,53,0,0,53,282,100,43,22,35,1135,201,934
361170214002,36, New York,117, Wayne County,141,73,38,0,35,61,61,26,0,35,80,12,12,0,0,340,86,254
361170214003,36, New York,117, Wayne County,342,103,84,10,9,60,10,0,10,0,282,93,84,0,9,1077,256,821
361170215011,36, New York,117, Wayne County,344,202,136,3,63,79,74,22,0,52,265,128,114,3,11,858,188,670
361170215012,36, New York,117, Wayne County,258,95,70,3,22,28,22,0,0,22,230,73,70,3,0,862,226,636
361170215021,36, New York,117, Wayne County,413,122,88,20,14,33,21,21,0,0,380,101,67,20,14,1111,166,945
361170215022,36, New York,117, Wayne County,485,234,131,34,69,70,44,17,6,21,415,190,114,28,48,1203,225,978
361170215023,36, New York,117, Wayne County,215,113,57,13,43,13,11,0,0,11,202,102,57,13,32,720,62,658
361170216001,36, New York,117, Wayne County,277,98,44,20,34,33,17,0,4,13,244,81,44,16,21,892,142,750
361170216002,36, New York,117, Wayne County,434,190,128,56,6,11,0,0,0,0,423,190,128,56,6,1314,103,1211
361170216003,36, New York,117, Wayne County,262,122,87,34,1,9,1,0,0,1,253,121,87,34,0,790,83,707
361170217001,36, New York,117, Wayne County,469,213,183,0,30,60,30,0,0,30,409,183,183,0,0,1249,120,1129
361170217002,36, New York,117, Wayne County,341,119,102,0,17,7,7,0,0,7,334,112,102,0,10,986,60,926
361170217003,36, New York,117, Wayne County,180,107,82,3,22,25,21,7,0,14,155,86,75,3,8,504,74,430
361170218001,36, New York,117, Wayne County,146,68,35,21,12,0,0,0,0,0,146,68,35,21,12,492,33,459
361170218002,36, New York,117, Wayne County,328,127,64,27,36,23,15,0,0,15,305,112,64,27,21,1057,185,872
361179901000,36, New York,117, Wayne County,0,0,0,0,0,0,0,0,0,0,0,0,0,0,0,0,0,0
360110401011,36, New York,011, Cayuga County,240,104,73,14,17,12,2,0,0,2,228,102,73,14,15,734,101,633
360110401012,36, New York,011, Cayuga County,164,91,91,0,0,7,4,4,0,0,157,87,87,0,0,491,26,465
360110401021,36, New York,011, Cayuga County,219,65,35,0,30,4,4,4,0,0,215,61,31,0,30,607,38,569
360110401022,36, New York,011, Cayuga County,367,144,106,0,38,104,79,41,0,38,263,65,65,0,0,942,215,727
360110401023,36, New York,011, Cayuga County,361,49,46,0,3,7,3,0,0,3,354,46,46,0,0,1102,74,1028
360110402011,36, New York,011, Cayuga County,234,61,28,5,28,13,0,0,0,0,221,61,28,5,28,677,40,637
360110402012,36, New York,011, Cayuga County,199,59,44,6,9,33,12,9,0,3,166,47,35,6,6,657,109,548
360110402013,36, New York,011, Cayuga County,251,83,54,15,14,18,0,0,0,0,233,83,54,15,14,826,109,717
360110402021,36, New York,011, Cayuga County,221,140,97,33,10,23,23,0,21,2,198,117,97,12,8,664,64,600
360110402022,36, New York,011, Cayuga County,315,106,99,0,7,7,7,0,0,7,308,99,99,0,0,933,39,894
360110403001,36, New York,011, Cayuga County,192,68,44,16,8,22,15,7,0,8,170,53,37,16,0,791,133,658
360110403002,36, New York,011, Cayuga County,269,116,76,20,20,26,15,9,0,6,243,101,67,20,14,748,124,624
360110403003,36, New York,011, Cayuga County,160,73,16,3,54,32,27,5,0,22,128,46,11,3,32,440,60,380
360110403004,36, New York,011, Cayuga County,352,172,86,53,33,42,7,0,0,7,310,165,86,53,26,1027,136,891
360110404001,36, New York,011, Cayuga County,434,193,103,52,38,6,3,0,3,0,428,190,103,49,38,1405,242,1163
360110404002,36, New York,011, Cayuga County,314,108,85,6,17,9,9,3,6,0,305,99,82,0,17,821,17,804
360110404003,36, New York,011, Cayuga County,442,169,81,22,66,65,38,0,10,28,377,131,81,12,38,1326,258,1068
360110405001,36, New York,011, Cayuga County,376,137,92,21,24,20,17,5,8,4,356,120,87,13,20,1177,103,1074
360110405002,36, New York,011, Cayuga County,330,118,94,18,6,0,0,0,0,0,330,118,94,18,6,870,7,863
360110405003,36, New York,011, Cayuga County,182,78,72,0,6,0,0,0,0,0,182,78,72,0,6,498,45,453
360110406001,36, New York,011, Cayuga County,449,143,114,14,15,0,0,0,0,0,449,143,114,14,15,1109,11,1098
360110406002,36, New York,011, Cayuga County,159,84,52,0,32,21,21,0,0,21,138,63,52,0,11,509,66,443
360110406003,36, New York,011, Cayuga County,291,97,78,12,7,0,0,0,0,0,291,97,78,12,7,755,39,716
360110407001,36, New York,011, Cayuga County,143,45,45,0,0,0,0,0,0,0,143,45,45,0,0,451,9,442
360110407002,36, New York,011, Cayuga County,366,195,166,19,10,10,10,0,0,10,356,185,166,19,0,886,43,843
360110407003,36, New York,011, Cayuga County,354,88,88,0,0,0,0,0,0,0,354,88,88,0,0,978,13,965
360110407004,36, New York,011, Cayuga County,212,32,10,0,22,11,0,0,0,0,201,32,10,0,22,608,41,567
360110408001,36, New York,011, Cayuga County,336,153,59,36,58,20,20,0,0,20,316,133,59,36,38,948,126,822
360110408002,36, New York,011, Cayuga County,322,192,128,53,11,21,10,0,6,4,301,182,128,47,7,943,84,859
360110408003,36, New York,011, Cayuga County,139,35,20,3,12,2,0,0,0,0,137,35,20,3,12,383,34,349
360110408004,36, New York,011, Cayuga County,163,47,41,6,0,19,0,0,0,0,144,47,41,6,0,504,80,424
360110409001,36, New York,011, Cayuga County,192,67,43,10,14,16,10,7,3,0,176,57,36,7,14,614,53,561
360110409002,36, New York,011, Cayuga County,227,63,44,11,8,26,21,6,11,4,201,42,38,0,4,727,83,644
360110409003,36, New York,011, Cayuga County,240,114,64,18,32,9,6,3,0,3,231,108,61,18,29,730,74,656
360110409004,36, New York,011, Cayuga County,235,129,47,45,37,44,44,4,29,11,191,85,43,16,26,627,96,531
360110410011,36, New York,011, Cayuga County,388,124,107,6,11,17,14,8,0,6,371,110,99,6,5,1064,63,1001
360110410012,36, New York,011, Cayuga County,201,86,55,8,23,14,0,0,0,0,187,86,55,8,23,633,73,560
360110410013,36, New York,011, Cayuga County,241,86,61,0,25,4,4,0,0,4,237,82,61,0,21,603,24,579
360110410021,36, New York,011, Cayuga County,163,61,43,5,13,23,23,9,3,11,140,38,34,2,2,505,63,442
360110410022,36, New York,011, Cayuga County,211,29,25,0,4,11,0,0,0,0,200,29,25,0,4,594,50,544
360110411011,36, New York,011, Cayuga County,238,136,101,22,13,13,13,0,0,13,225,123,101,22,0,718,24,694
360110411012,36, New York,011, Cayuga County,294,61,35,8,18,9,0,0,0,0,285,61,35,8,18,747,29,718
360110411013,36, New York,011, Cayuga County,181,48,40,4,4,0,0,0,0,0,181,48,40,4,4,499,8,491
360110411021,36, New York,011, Cayuga County,180,52,29,11,12,12,9,2,0,7,168,43,27,11,5,493,45,448
360110411022,36, New York,011, Cayuga County,217,115,72,40,3,9,2,0,0,2,208,113,72,40,1,624,51,573
360110412011,36, New York,011, Cayuga County,190,72,62,0,10,0,0,0,0,0,190,72,62,0,10,529,37,492
360110412012,36, New York,011, Cayuga County,399,186,145,8,33,2,2,0,0,2,397,184,145,8,31,1194,54,1140
360110412021,36, New York,011, Cayuga County,146,64,51,13,0,16,15,3,12,0,130,49,48,1,0,515,60,455
360110412022,36, New York,011, Cayuga County,389,93,72,11,10,15,10,0,0,10,374,83,72,11,0,1071,76,995
360110412023,36, New York,011, Cayuga County,187,99,75,8,16,1,1,0,0,1,186,98,75,8,15,518,16,502
360110413001,36, New York,011, Cayuga County,174,126,45,66,15,12,0,0,0,0,162,126,45,66,15,483,63,420
360110413002,36, New York,011, Cayuga County,147,63,0,20,43,59,59,0,20,39,88,4,0,0,4,666,187,479
360110413003,36, New York,011, Cayuga County,215,34,0,0,34,42,34,0,0,34,173,0,0,0,0,618,48,570
360110413004,36, New York,011, Cayuga County,187,128,43,0,85,77,77,0,0,77,110,51,43,0,8,368,112,256
360110413005,36, New York,011, Cayuga County,145,73,29,0,44,22,7,0,0,7,123,66,29,0,37,562,137,425
360110414001,36, New York,011, Cayuga County,376,194,99,0,95,82,82,0,0,82,294,112,99,0,13,1654,121,1533
360110414002,36, New York,011, Cayuga County,181,101,42,49,10,11,0,0,0,0,170,101,42,49,10,699,196,503
360110414003,36, New York,011, Cayuga County,189,50,36,14,0,14,14,0,14,0,175,36,36,0,0,819,95,724
360110414004,36, New York,011, Cayuga County,186,77,11,0,66,30,0,0,0,0,156,77,11,0,66,783,172,611
360110415001,36, New York,011, Cayuga County,264,36,0,22,14,22,22,0,22,0,242,14,0,0,14,894,100,794
360110415002,36, New York,011, Cayuga County,141,101,39,21,41,14,14,0,0,14,127,87,39,21,27,306,14,292
360110415003,36, New York,011, Cayuga County,185,94,72,0,22,0,0,0,0,0,185,94,72,0,22,577,45,532
360110415004,36, New York,011, Cayuga County,132,122,0,33,89,33,33,0,33,0,99,89,0,0,89,450,94,356
360110416001,36, New York,011, Cayuga County,281,184,62,74,48,30,30,6,0,24,251,154,56,74,24,780,127,653
360110416002,36, New York,011, Cayuga County,174,60,19,0,41,0,0,0,0,0,174,60,19,0,41,395,10,385
360110416003,36, New York,011, Cayuga County,262,83,13,0,70,34,34,0,0,34,228,49,13,0,36,863,34,829
360110417001,36, New York,011, Cayuga County,98,71,2,0,69,5,5,0,0,5,93,66,2,0,64,748,272,476
360110417002,36, New York,011, Cayuga County,145,75,21,14,40,15,15,0,0,15,130,60,21,14,25,463,51,412
360110417003,36, New York,011, Cayuga County,225,98,51,0,47,4,4,0,0,4,221,94,51,0,43,694,60,634
360110417004,36, New York,011, Cayuga County,258,95,40,0,55,0,0,0,0,0,258,95,40,0,55,789,33,756
360110417005,36, New York,011, Cayuga County,150,53,39,0,14,0,0,0,0,0,150,53,39,0,14,420,0,420
360110418001,36, New York,011, Cayuga County,254,77,58,0,19,0,0,0,0,0,254,77,58,0,19,713,0,713
360110418002,36, New York,011, Cayuga County,276,196,88,108,0,0,0,0,0,0,276,196,88,108,0,863,96,767
360110418003,36, New York,011, Cayuga County,187,111,75,0,36,0,0,0,0,0,187,111,75,0,36,702,183,519
360110418004,36, New York,011, Cayuga County,80,67,23,16,28,67,67,23,16,28,13,0,0,0,0,440,286,154
360110418005,36, New York,011, Cayuga County,349,291,28,70,193,110,110,0,18,92,239,181,28,52,101,687,231,456
360110421001,36, New York,011, Cayuga County,214,126,37,52,37,61,61,7,40,14,153,65,30,12,23,816,237,579
360110421002,36, New York,011, Cayuga County,72,52,37,0,15,37,37,37,0,0,35,15,0,0,15,492,231,261
360110421003,36, New York,011, Cayuga County,94,62,0,0,62,11,11,0,0,11,83,51,0,0,51,661,265,396
360119902000,36, New York,011, Cayuga County,0,0,0,0,0,0,0,0,0,0,0,0,0,0,0,0,0,0
360850003000,36, New York,085, Richmond County,0,0,0,0,0,0,0,0,0,0,0,0,0,0,0,0,0,0
360850003001,36, New York,085, Richmond County,198,79,71,0,8,31,31,23,0,8,167,48,48,0,0,480,23,457
360850003002,36, New York,085, Richmond County,250,42,20,0,22,23,10,0,0,10,227,32,20,0,12,1073,290,783
360850006000,36, New York,085, Richmond County,0,0,0,0,0,0,0,0,0,0,0,0,0,0,0,0,0,0
360850006001,36, New York,085, Richmond County,206,151,46,19,86,25,25,25,0,0,181,126,21,19,86,838,183,655
360850006002,36, New York,085, Richmond County,401,115,45,0,70,62,0,0,0,0,339,115,45,0,70,1362,279,1083
360850007000,36, New York,085, Richmond County,0,0,0,0,0,0,0,0,0,0,0,0,0,0,0,0,0,0
360850007001,36, New York,085, Richmond County,260,144,0,0,144,0,0,0,0,0,260,144,0,0,144,1057,202,855
360850007002,36, New York,085, Richmond County,289,60,0,0,60,23,0,0,0,0,266,60,0,0,60,993,60,933
360850007003,36, New York,085, Richmond County,177,143,0,0,143,0,0,0,0,0,177,143,0,0,143,314,10,304
360850007004,36, New York,085, Richmond County,325,157,65,0,92,179,65,0,0,65,146,92,65,0,27,983,338,645
360850008001,36, New York,085, Richmond County,516,258,206,28,24,37,33,9,0,24,479,225,197,28,0,1010,77,933
360850008002,36, New York,085, Richmond County,419,152,138,0,14,16,16,16,0,0,403,136,122,0,14,1223,102,1121
360850008003,36, New York,085, Richmond County,503,284,147,56,81,28,0,0,0,0,475,284,147,56,81,1593,88,1505
360850009001,36, New York,085, Richmond County,312,133,96,0,37,14,11,0,0,11,298,122,96,0,26,1046,145,901
360850009002,36, New York,085, Richmond County,104,34,34,0,0,7,0,0,0,0,97,34,34,0,0,346,47,299
360850011001,36, New York,085, Richmond County,126,64,28,13,23,49,41,28,13,0,77,23,0,0,23,465,92,373
360850011002,36, New York,085, Richmond County,291,137,17,87,33,18,0,0,0,0,273,137,17,87,33,828,182,646
360850011003,36, New York,085, Richmond County,380,289,164,68,57,101,101,65,0,36,279,188,99,68,21,1299,513,786
360850017001,36, New York,085, Richmond County,158,65,52,0,13,1,0,0,0,0,157,65,52,0,13,635,24,611
360850017002,36, New York,085, Richmond County,179,103,54,19,30,3,3,3,0,0,176,100,51,19,30,545,106,439
360850018000,36, New York,085, Richmond County,0,0,0,0,0,0,0,0,0,0,0,0,0,0,0,0,0,0
360850018001,36, New York,085, Richmond County,170,121,107,0,14,0,0,0,0,0,170,121,107,0,14,342,0,342
360850020011,36, New York,085, Richmond County,226,38,38,0,0,0,0,0,0,0,226,38,38,0,0,1253,50,1203
360850020012,36, New York,085, Richmond County,441,95,95,0,0,10,0,0,0,0,431,95,95,0,0,1168,66,1102
360850020021,36, New York,085, Richmond County,478,176,144,32,0,0,0,0,0,0,478,176,144,32,0,1348,54,1294
360850020022,36, New York,085, Richmond County,305,145,127,8,10,24,0,0,0,0,281,145,127,8,10,980,115,865
360850021000,36, New York,085, Richmond County,0,0,0,0,0,0,0,0,0,0,0,0,0,0,0,0,0,0
360850021001,36, New York,085, Richmond County,282,158,81,0,77,81,80,33,0,47,201,78,48,0,30,858,152,706
360850021002,36, New York,085, Richmond County,407,148,56,0,92,42,14,14,0,0,365,134,42,0,92,1070,288,782
360850021003,36, New York,085, Richmond County,380,160,86,10,64,150,79,24,0,55,230,81,62,10,9,968,339,629
360850027001,36, New York,085, Richmond County,47,28,7,21,0,7,7,7,0,0,40,21,0,21,0,330,96,234
360850027002,36, New York,085, Richmond County,153,141,94,27,20,108,108,81,27,0,45,33,13,0,20,174,0,174
360850029001,36, New York,085, Richmond County,243,68,41,13,14,13,0,0,0,0,230,68,41,13,14,630,136,494
360850029002,36, New York,085, Richmond County,609,410,34,24,352,399,240,34,15,191,210,170,0,9,161,1577,1020,557
360850029003,36, New York,085, Richmond County,317,102,69,0,33,0,0,0,0,0,317,102,69,0,33,971,24,947
360850029004,36, New York,085, Richmond County,209,132,17,14,101,19,19,5,0,14,190,113,12,14,87,714,81,633
360850033001,36, New York,085, Richmond County,359,195,171,0,24,11,11,0,0,11,348,184,171,0,13,1149,88,1061
360850033002,36, New York,085, Richmond County,513,247,202,30,15,0,0,0,0,0,513,247,202,30,15,1528,118,1410
360850036001,36, New York,085, Richmond County,390,244,152,2,90,9,9,9,0,0,381,235,143,2,90,929,17,912
360850036002,36, New York,085, Richmond County,401,144,134,0,10,51,51,51,0,0,350,93,83,0,10,968,39,929
360850039001,36, New York,085, Richmond County,212,110,52,13,45,0,0,0,0,0,212,110,52,13,45,556,12,544
360850039002,36, New York,085, Richmond County,317,129,116,0,13,0,0,0,0,0,317,129,116,0,13,1016,120,896
360850040011,36, New York,085, Richmond County,297,0,0,0,0,0,0,0,0,0,297,0,0,0,0,1235,60,1175
360850040012,36, New York,085, Richmond County,221,182,117,0,65,5,0,0,0,0,216,182,117,0,65,1318,65,1253
360850040021,36, New York,085, Richmond County,162,121,115,0,6,6,6,0,0,6,156,115,115,0,0,474,6,468
360850040022,36, New York,085, Richmond County,475,169,169,0,0,42,0,0,0,0,433,169,169,0,0,1277,87,1190
360850040031,36, New York,085, Richmond County,508,422,180,64,178,242,242,0,64,178,266,180,180,0,0,958,478,480
360850040032,36, New York,085, Richmond County,87,87,0,0,87,0,0,0,0,0,87,87,0,0,87,504,294,210
360850040033,36, New York,085, Richmond County,174,83,0,0,83,0,0,0,0,0,174,83,0,0,83,571,113,458
360850040041,36, New York,085, Richmond County,544,197,5,0,192,50,0,0,0,0,494,197,5,0,192,1549,162,1387
360850040042,36, New York,085, Richmond County,338,276,0,95,181,89,62,0,44,18,249,214,0,51,163,1270,310,960
360850047001,36, New York,085, Richmond County,401,207,113,25,69,0,0,0,0,0,401,207,113,25,69,1388,126,1262
360850047002,36, New York,085, Richmond County,170,26,0,26,0,0,0,0,0,0,170,26,0,26,0,471,6,465
360850050001,36, New York,085, Richmond County,723,295,189,0,106,0,0,0,0,0,723,295,189,0,106,1675,22,1653
360850050002,36, New York,085, Richmond County,336,143,62,38,43,124,33,0,0,33,212,110,62,38,10,995,365,630
360850050003,36, New York,085, Richmond County,200,114,102,8,4,0,0,0,0,0,200,114,102,8,4,412,0,412
360850059011,36, New York,085, Richmond County,328,72,64,0,8,11,0,0,0,0,317,72,64,0,8,1083,120,963
360850059012,36, New York,085, Richmond County,468,288,153,9,126,0,0,0,0,0,468,288,153,9,126,1485,32,1453
360850059021,36, New York,085, Richmond County,0,0,0,0,0,0,0,0,0,0,0,0,0,0,0,0,0,0
360850064001,36, New York,085, Richmond County,234,71,21,0,50,0,0,0,0,0,234,71,21,0,50,755,9,746
360850064002,36, New York,085, Richmond County,143,42,42,0,0,0,0,0,0,0,143,42,42,0,0,381,48,333
360850064003,36, New York,085, Richmond County,493,129,65,0,64,76,67,20,0,47,417,62,45,0,17,1182,179,1003
360850067001,36, New York,085, Richmond County,180,83,83,0,0,0,0,0,0,0,180,83,83,0,0,614,51,563
360850067002,36, New York,085, Richmond County,342,67,54,0,13,26,0,0,0,0,316,67,54,0,13,975,95,880
360850067003,36, New York,085, Richmond County,339,130,101,0,29,21,21,21,0,0,318,109,80,0,29,775,55,720
360850070011,36, New York,085, Richmond County,382,159,109,15,35,26,11,6,0,5,356,148,103,15,30,890,83,807
360850070012,36, New York,085, Richmond County,527,75,17,23,35,21,21,0,0,21,506,54,17,23,14,1260,19,1241
360850070020,36, New York,085, Richmond County,0,0,0,0,0,0,0,0,0,0,0,0,0,0,0,0,0,0
360850070021,36, New York,085, Richmond County,471,356,285,32,39,33,0,0,0,0,438,356,285,32,39,1023,128,895
360850070022,36, New York,085, Richmond County,863,357,127,0,230,60,22,3,0,19,803,335,124,0,211,2319,128,2191
360850070023,36, New York,085, Richmond County,94,32,32,0,0,47,0,0,0,0,47,32,32,0,0,557,302,255
360850070024,36, New York,085, Richmond County,0,0,0,0,0,0,0,0,0,0,0,0,0,0,0,0,0,0
360850074000,36, New York,085, Richmond County,0,0,0,0,0,0,0,0,0,0,0,0,0,0,0,0,0,0
360850074001,36, New York,085, Richmond County,504,239,173,0,66,14,14,14,0,0,490,225,159,0,66,1453,93,1360
360850074002,36, New York,085, Richmond County,584,287,271,0,16,73,16,0,0,16,511,271,271,0,0,2141,506,1635
360850074003,36, New York,085, Richmond County,0,0,0,0,0,0,0,0,0,0,0,0,0,0,0,0,0,0
360850075001,36, New York,085, Richmond County,60,60,60,0,0,50,50,50,0,0,10,10,10,0,0,204,154,50
360850075002,36, New York,085, Richmond County,440,333,247,0,86,0,0,0,0,0,440,333,247,0,86,862,0,862
360850075003,36, New York,085, Richmond County,373,118,83,0,35,49,49,20,0,29,324,69,63,0,6,1307,92,1215
360850077001,36, New York,085, Richmond County,403,252,189,14,49,51,13,13,0,0,352,239,176,14,49,1207,160,1047
360850081000,36, New York,085, Richmond County,0,0,0,0,0,0,0,0,0,0,0,0,0,0,0,0,0,0
360850081001,36, New York,085, Richmond County,250,97,65,0,32,36,25,0,0,25,214,72,65,0,7,1172,237,935
360850081002,36, New York,085, Richmond County,144,96,88,0,8,0,0,0,0,0,144,96,88,0,8,561,70,491
360850081003,36, New York,085, Richmond County,574,182,104,0,78,61,61,56,0,5,513,121,48,0,73,1235,75,1160
360850096011,36, New York,085, Richmond County,571,250,250,0,0,0,0,0,0,0,571,250,250,0,0,1714,7,1707
360850096012,36, New York,085, Richmond County,546,167,105,45,17,18,12,0,12,0,528,155,105,33,17,1578,198,1380
360850096021,36, New York,085, Richmond County,300,169,169,0,0,5,0,0,0,0,295,169,169,0,0,805,29,776
360850096022,36, New York,085, Richmond County,190,52,17,0,35,11,11,0,0,11,179,41,17,0,24,536,23,513
360850096023,36, New York,085, Richmond County,417,183,39,3,141,0,0,0,0,0,417,183,39,3,141,1177,20,1157
360850097010,36, New York,085, Richmond County,0,0,0,0,0,0,0,0,0,0,0,0,0,0,0,0,0,0
360850097011,36, New York,085, Richmond County,358,278,134,0,144,41,41,0,0,41,317,237,134,0,103,744,73,671
360850097012,36, New York,085, Richmond County,351,143,107,0,36,11,11,11,0,0,340,132,96,0,36,785,21,764
360850097013,36, New York,085, Richmond County,453,262,214,0,48,0,0,0,0,0,453,262,214,0,48,1063,13,1050
360850097020,36, New York,085, Richmond County,0,0,0,0,0,0,0,0,0,0,0,0,0,0,0,0,0,0
360850097021,36, New York,085, Richmond County,19,0,0,0,0,0,0,0,0,0,19,0,0,0,0,42,0,42
360850105001,36, New York,085, Richmond County,217,103,40,0,63,0,0,0,0,0,217,103,40,0,63,603,0,603
360850105002,36, New York,085, Richmond County,333,164,50,0,114,62,62,0,0,62,271,102,50,0,52,735,120,615
360850105003,36, New York,085, Richmond County,152,89,61,0,28,9,0,0,0,0,143,89,61,0,28,454,19,435
360850105004,36, New York,085, Richmond County,273,111,28,0,83,80,68,0,0,68,193,43,28,0,15,798,149,649
360850105005,36, New York,085, Richmond County,316,153,135,0,18,31,10,0,0,10,285,143,135,0,8,755,117,638
360850112010,36, New York,085, Richmond County,0,0,0,0,0,0,0,0,0,0,0,0,0,0,0,0,0,0
360850112011,36, New York,085, Richmond County,331,219,187,32,0,41,41,41,0,0,290,178,146,32,0,777,38,739
360850112012,36, New York,085, Richmond County,474,177,157,0,20,15,15,15,0,0,459,162,142,0,20,1432,59,1373
360850112013,36, New York,085, Richmond County,699,299,208,79,12,0,0,0,0,0,699,299,208,79,12,1768,0,1768
360850112014,36, New York,085, Richmond County,0,0,0,0,0,0,0,0,0,0,0,0,0,0,0,0,0,0
360850112031,36, New York,085, Richmond County,543,147,98,40,9,40,40,0,40,0,503,107,98,0,9,1523,103,1420
360850112032,36, New York,085, Richmond County,723,288,168,0,120,22,10,10,0,0,701,278,158,0,120,1322,72,1250
360850112033,36, New York,085, Richmond County,421,256,135,43,78,11,1,0,0,1,410,255,135,43,77,863,128,735
360850112040,36, New York,085, Richmond County,0,0,0,0,0,0,0,0,0,0,0,0,0,0,0,0,0,0
360850112041,36, New York,085, Richmond County,16,16,16,0,0,0,0,0,0,0,16,16,16,0,0,67,0,67
360850112042,36, New York,085, Richmond County,0,0,0,0,0,0,0,0,0,0,0,0,0,0,0,0,0,0
360850114011,36, New York,085, Richmond County,305,44,44,0,0,0,0,0,0,0,305,44,44,0,0,696,41,655
360850114012,36, New York,085, Richmond County,734,379,162,0,217,189,112,0,0,112,545,267,162,0,105,1731,418,1313
360850114021,36, New York,085, Richmond County,343,203,116,53,34,9,9,0,0,9,334,194,116,53,25,899,25,874
360850114022,36, New York,085, Richmond County,260,106,65,0,41,12,7,0,0,7,248,99,65,0,34,907,37,870
360850114023,36, New York,085, Richmond County,237,103,103,0,0,0,0,0,0,0,237,103,103,0,0,600,29,571
360850121001,36, New York,085, Richmond County,251,111,111,0,0,0,0,0,0,0,251,111,111,0,0,739,27,712
360850121002,36, New York,085, Richmond County,214,129,117,0,12,0,0,0,0,0,214,129,117,0,12,552,0,552
360850121003,36, New York,085, Richmond County,501,152,144,8,0,0,0,0,0,0,501,152,144,8,0,1199,9,1190
360850122001,36, New York,085, Richmond County,316,198,123,16,59,59,59,0,0,59,257,139,123,16,0,895,74,821
360850122002,36, New York,085, Richmond County,237,113,80,0,33,0,0,0,0,0,237,113,80,0,33,681,12,669
360850122003,36, New York,085, Richmond County,304,183,166,0,17,0,0,0,0,0,304,183,166,0,17,826,0,826
360850122004,36, New York,085, Richmond County,148,35,35,0,0,0,0,0,0,0,148,35,35,0,0,339,0,339
360850125001,36, New York,085, Richmond County,303,79,42,16,21,0,0,0,0,0,303,79,42,16,21,638,44,594
360850125002,36, New York,085, Richmond County,202,130,93,0,37,16,16,16,0,0,186,114,77,0,37,746,137,609
360850125003,36, New York,085, Richmond County,259,94,79,0,15,12,0,0,0,0,247,94,79,0,15,709,39,670
360850128040,36, New York,085, Richmond County,0,0,0,0,0,0,0,0,0,0,0,0,0,0,0,0,0,0
360850128041,36, New York,085, Richmond County,609,314,175,0,139,54,38,9,0,29,555,276,166,0,110,1635,113,1522
360850128042,36, New York,085, Richmond County,552,202,164,5,33,31,14,8,0,6,521,188,156,5,27,1408,73,1335
360850128043,36, New York,085, Richmond County,0,0,0,0,0,0,0,0,0,0,0,0,0,0,0,0,0,0
360850128050,36, New York,085, Richmond County,0,0,0,0,0,0,0,0,0,0,0,0,0,0,0,0,0,0
360850128051,36, New York,085, Richmond County,552,289,248,0,41,32,32,0,0,32,520,257,248,0,9,1613,56,1557
360850128052,36, New York,085, Richmond County,51,13,0,0,13,0,0,0,0,0,51,13,0,0,13,188,11,177
360850128053,36, New York,085, Richmond County,0,0,0,0,0,0,0,0,0,0,0,0,0,0,0,0,0,0
360850128054,36, New York,085, Richmond County,5,0,0,0,0,0,0,0,0,0,5,0,0,0,0,58,20,38
360850128060,36, New York,085, Richmond County,0,0,0,0,0,0,0,0,0,0,0,0,0,0,0,0,0,0
360850128061,36, New York,085, Richmond County,184,56,38,0,18,9,0,0,0,0,175,56,38,0,18,787,28,759
360850128062,36, New York,085, Richmond County,253,164,127,0,37,51,51,38,0,13,202,113,89,0,24,669,13,656
360850128063,36, New York,085, Richmond County,307,72,41,0,31,15,15,0,0,15,292,57,41,0,16,1365,293,1072
360850128064,36, New York,085, Richmond County,0,0,0,0,0,0,0,0,0,0,0,0,0,0,0,0,0,0
360850128065,36, New York,085, Richmond County,502,253,196,0,57,45,0,0,0,0,457,253,196,0,57,1378,103,1275
360850132011,36, New York,085, Richmond County,189,60,60,0,0,6,0,0,0,0,183,60,60,0,0,524,21,503
360850132012,36, New York,085, Richmond County,214,93,93,0,0,14,14,14,0,0,200,79,79,0,0,574,48,526
360850132031,36, New York,085, Richmond County,435,191,124,0,67,48,0,0,0,0,387,191,124,0,67,1299,107,1192
360850132032,36, New York,085, Richmond County,723,410,384,0,26,20,0,0,0,0,703,410,384,0,26,2306,88,2218
360850132033,36, New York,085, Richmond County,739,364,296,0,68,0,0,0,0,0,739,364,296,0,68,1716,141,1575
360850132041,36, New York,085, Richmond County,414,218,189,29,0,23,23,23,0,0,391,195,166,29,0,1036,123,913
360850132042,36, New York,085, Richmond County,566,300,281,13,6,0,0,0,0,0,566,300,281,13,6,1586,10,1576
360850132043,36, New York,085, Richmond County,293,97,57,9,31,15,0,0,0,0,278,97,57,9,31,1040,121,919
360850133011,36, New York,085, Richmond County,210,141,28,21,92,88,49,6,0,43,122,92,22,21,49,768,337,431
360850133021,36, New York,085, Richmond County,62,41,10,0,31,32,32,10,0,22,30,9,0,0,9,185,87,98
360850133022,36, New York,085, Richmond County,345,254,31,0,223,133,108,0,0,108,212,146,31,0,115,682,240,442
360850133023,36, New York,085, Richmond County,447,372,130,12,230,41,28,9,0,19,406,344,121,12,211,1080,136,944
360850134001,36, New York,085, Richmond County,302,166,133,0,33,68,56,56,0,0,234,110,77,0,33,643,68,575
360850134002,36, New York,085, Richmond County,283,46,39,0,7,0,0,0,0,0,283,46,39,0,7,836,27,809
360850134003,36, New York,085, Richmond County,374,192,73,17,102,82,82,0,17,65,292,110,73,0,37,1007,195,812
360850138001,36, New York,085, Richmond County,240,66,52,0,14,0,0,0,0,0,240,66,52,0,14,646,2,644
360850138002,36, New York,085, Richmond County,356,179,164,0,15,21,0,0,0,0,335,179,164,0,15,1009,43,966
360850138003,36, New York,085, Richmond County,659,167,126,0,41,30,12,12,0,0,629,155,114,0,41,1496,107,1389
360850138004,36, New York,085, Richmond County,297,98,71,0,27,24,0,0,0,0,273,98,71,0,27,650,0,650
360850138005,36, New York,085, Richmond County,491,160,99,61,0,0,0,0,0,0,491,160,99,61,0,1262,54,1208
360850141001,36, New York,085, Richmond County,295,83,33,0,50,31,26,0,0,26,264,57,33,0,24,761,84,677
360850141002,36, New York,085, Richmond County,269,145,98,0,47,59,59,37,0,22,210,86,61,0,25,929,102,827
360850146041,36, New York,085, Richmond County,333,89,89,0,0,0,0,0,0,0,333,89,89,0,0,1015,0,1015
360850146042,36, New York,085, Richmond County,483,230,230,0,0,0,0,0,0,0,483,230,230,0,0,1319,43,1276
360850146043,36, New York,085, Richmond County,607,310,261,0,49,19,19,0,0,19,588,291,261,0,30,1396,116,1280
360850146044,36, New York,085, Richmond County,473,226,226,0,0,17,17,17,0,0,456,209,209,0,0,1335,46,1289
360850146051,36, New York,085, Richmond County,533,189,105,0,84,9,9,0,0,9,524,180,105,0,75,1557,55,1502
360850146052,36, New York,085, Richmond County,550,224,224,0,0,42,42,42,0,0,508,182,182,0,0,1448,62,1386
360850146061,36, New York,085, Richmond County,373,166,166,0,0,17,0,0,0,0,356,166,166,0,0,1077,234,843
360850146062,36, New York,085, Richmond County,631,224,202,0,22,0,0,0,0,0,631,224,202,0,22,2085,141,1944
360850146063,36, New York,085, Richmond County,411,101,101,0,0,0,0,0,0,0,411,101,101,0,0,1434,2,1432
360850146064,36, New York,085, Richmond County,132,98,35,22,41,0,0,0,0,0,132,98,35,22,41,352,0,352
360850146071,36, New York,085, Richmond County,801,352,228,57,67,70,48,48,0,0,731,304,180,57,67,2226,174,2052
360850146072,36, New York,085, Richmond County,415,196,154,14,28,28,28,0,0,28,387,168,154,14,0,1471,53,1418
360850146081,36, New York,085, Richmond County,468,235,156,9,70,33,24,24,0,0,435,211,132,9,70,1122,89,1033
360850146082,36, New York,085, Richmond County,478,123,110,13,0,0,0,0,0,0,478,123,110,13,0,1409,12,1397
360850147001,36, New York,085, Richmond County,173,39,15,0,24,0,0,0,0,0,173,39,15,0,24,490,19,471
360850147002,36, New York,085, Richmond County,352,113,90,0,23,0,0,0,0,0,352,113,90,0,23,1154,72,1082
360850147003,36, New York,085, Richmond County,433,80,57,0,23,0,0,0,0,0,433,80,57,0,23,1307,30,1277
360850151001,36, New York,085, Richmond County,499,331,319,0,12,0,0,0,0,0,499,331,319,0,12,1698,16,1682
360850151002,36, New York,085, Richmond County,70,31,31,0,0,0,0,0,0,0,70,31,31,0,0,171,8,163
360850151003,36, New York,085, Richmond County,193,139,139,0,0,0,0,0,0,0,193,139,139,0,0,728,20,708
360850151004,36, New York,085, Richmond County,346,62,62,0,0,0,0,0,0,0,346,62,62,0,0,992,0,992
360850151005,36, New York,085, Richmond County,122,92,72,0,20,0,0,0,0,0,122,92,72,0,20,476,51,425
360850154000,36, New York,085, Richmond County,0,0,0,0,0,0,0,0,0,0,0,0,0,0,0,0,0,0
360850154001,36, New York,085, Richmond County,0,0,0,0,0,0,0,0,0,0,0,0,0,0,0,0,0,0
360850156011,36, New York,085, Richmond County,550,190,190,0,0,0,0,0,0,0,550,190,190,0,0,1474,14,1460
360850156012,36, New York,085, Richmond County,220,110,110,0,0,0,0,0,0,0,220,110,110,0,0,579,32,547
360850156013,36, New York,085, Richmond County,227,0,0,0,0,1,0,0,0,0,226,0,0,0,0,631,3,628
360850156014,36, New York,085, Richmond County,327,131,105,0,26,10,0,0,0,0,317,131,105,0,26,944,56,888
360850156015,36, New York,085, Richmond County,78,0,0,0,0,0,0,0,0,0,78,0,0,0,0,286,25,261
360850156016,36, New York,085, Richmond County,509,78,78,0,0,33,0,0,0,0,476,78,78,0,0,1226,70,1156
360850156021,36, New York,085, Richmond County,192,121,101,0,20,9,0,0,0,0,183,121,101,0,20,594,29,565
360850156022,36, New York,085, Richmond County,262,107,89,0,18,0,0,0,0,0,262,107,89,0,18,606,5,601
360850156023,36, New York,085, Richmond County,179,43,30,0,13,0,0,0,0,0,179,43,30,0,13,642,1,641
360850156024,36, New York,085, Richmond County,339,157,67,26,64,78,70,6,0,64,261,87,61,26,0,923,92,831
360850156030,36, New York,085, Richmond County,0,0,0,0,0,0,0,0,0,0,0,0,0,0,0,0,0,0
360850156031,36, New York,085, Richmond County,267,39,32,0,7,14,0,0,0,0,253,39,32,0,7,766,38,728
360850156032,36, New York,085, Richmond County,583,386,310,70,6,25,25,19,0,6,558,361,291,70,0,1624,124,1500
360850156033,36, New York,085, Richmond County,460,193,163,24,6,66,27,27,0,0,394,166,136,24,6,1081,99,982
360850169011,36, New York,085, Richmond County,369,181,157,7,17,2,0,0,0,0,367,181,157,7,17,1046,37,1009
360850169012,36, New York,085, Richmond County,538,311,184,0,127,0,0,0,0,0,538,311,184,0,127,1563,7,1556
360850170051,36, New York,085, Richmond County,716,403,274,0,129,21,10,10,0,0,695,393,264,0,129,2169,80,2089
360850170052,36, New York,085, Richmond County,405,196,184,12,0,0,0,0,0,0,405,196,184,12,0,1426,81,1345
360850170071,36, New York,085, Richmond County,662,393,305,7,81,37,37,13,0,24,625,356,292,7,57,1927,125,1802
360850170072,36, New York,085, Richmond County,327,215,141,43,31,4,0,0,0,0,323,215,141,43,31,931,44,887
360850170073,36, New York,085, Richmond County,555,348,266,20,62,82,74,22,0,52,473,274,244,20,10,1257,67,1190
360850170091,36, New York,085, Richmond County,312,214,165,11,38,0,0,0,0,0,312,214,165,11,38,888,0,888
360850170092,36, New York,085, Richmond County,531,297,256,0,41,0,0,0,0,0,531,297,256,0,41,1636,25,1611
360850170093,36, New York,085, Richmond County,425,122,93,29,0,0,0,0,0,0,425,122,93,29,0,1161,43,1118
360850170111,36, New York,085, Richmond County,683,232,103,47,82,95,53,0,0,53,588,179,103,47,29,1707,296,1411
360850170112,36, New York,085, Richmond County,659,293,265,13,15,0,0,0,0,0,659,293,265,13,15,1919,0,1919
360850170121,36, New York,085, Richmond County,402,179,164,0,15,83,0,0,0,0,319,179,164,0,15,1639,200,1439
360850170122,36, New York,085, Richmond County,437,191,161,18,12,6,0,0,0,0,431,191,161,18,12,1218,31,1187
360850170123,36, New York,085, Richmond County,261,89,71,8,10,9,0,0,0,0,252,89,71,8,10,839,32,807
360850170131,36, New York,085, Richmond County,736,317,271,0,46,14,0,0,0,0,722,317,271,0,46,2409,124,2285
360850170132,36, New York,085, Richmond County,358,123,112,0,11,0,0,0,0,0,358,123,112,0,11,1043,0,1043
360850170141,36, New York,085, Richmond County,731,239,174,0,65,83,83,31,0,52,648,156,143,0,13,2093,66,2027
360850170142,36, New York,085, Richmond County,447,179,82,0,97,0,0,0,0,0,447,179,82,0,97,941,11,930
360850170151,36, New York,085, Richmond County,827,318,318,0,0,14,0,0,0,0,813,318,318,0,0,2083,38,2045
360850170161,36, New York,085, Richmond County,757,281,174,45,62,44,44,23,0,21,713,237,151,45,41,2105,66,2039
360850170162,36, New York,085, Richmond County,560,221,206,0,15,0,0,0,0,0,560,221,206,0,15,1685,0,1685
360850173001,36, New York,085, Richmond County,358,216,128,38,50,31,19,0,0,19,327,197,128,38,31,790,73,717
360850173002,36, New York,085, Richmond County,394,116,29,6,81,59,37,0,0,37,335,79,29,6,44,852,132,720
360850176000,36, New York,085, Richmond County,0,0,0,0,0,0,0,0,0,0,0,0,0,0,0,0,0,0
360850176001,36, New York,085, Richmond County,331,192,192,0,0,17,0,0,0,0,314,192,192,0,0,743,35,708
360850176002,36, New York,085, Richmond County,267,158,124,0,34,10,10,10,0,0,257,148,114,0,34,611,19,592
360850176003,36, New York,085, Richmond County,426,147,130,0,17,6,6,0,0,6,420,141,130,0,11,1591,63,1528
360850176004,36, New York,085, Richmond County,255,96,71,15,10,0,0,0,0,0,255,96,71,15,10,728,36,692
360850177011,36, New York,085, Richmond County,202,113,113,0,0,7,0,0,0,0,195,113,113,0,0,461,14,447
360850177012,36, New York,085, Richmond County,367,158,158,0,0,0,0,0,0,0,367,158,158,0,0,882,40,842
360850177013,36, New York,085, Richmond County,122,16,16,0,0,0,0,0,0,0,122,16,16,0,0,334,0,334
360850177014,36, New York,085, Richmond County,560,359,214,0,145,0,0,0,0,0,560,359,214,0,145,1151,0,1151
360850177021,36, New York,085, Richmond County,335,180,136,20,24,24,24,24,0,0,311,156,112,20,24,765,53,712
360850177022,36, New York,085, Richmond County,444,50,43,0,7,30,0,0,0,0,414,50,43,0,7,993,62,931
360850181001,36, New York,085, Richmond County,78,0,0,0,0,50,0,0,0,0,28,0,0,0,0,472,246,226
360850181002,36, New York,085, Richmond County,662,270,206,64,0,51,51,0,51,0,611,219,206,13,0,1461,148,1313
360850181003,36, New York,085, Richmond County,189,49,41,0,8,0,0,0,0,0,189,49,41,0,8,519,1,518
360850187011,36, New York,085, Richmond County,233,129,94,0,35,4,0,0,0,0,229,129,94,0,35,640,93,547
360850187012,36, New York,085, Richmond County,271,135,119,0,16,6,6,6,0,0,265,129,113,0,16,731,43,688
360850187031,36, New York,085, Richmond County,558,225,225,0,0,0,0,0,0,0,558,225,225,0,0,1667,205,1462
360850187032,36, New York,085, Richmond County,395,294,238,0,56,49,49,6,0,43,346,245,232,0,13,798,12,786
360850187041,36, New York,085, Richmond County,482,165,136,0,29,48,1,0,0,1,434,164,136,0,28,1480,161,1319
360850187042,36, New York,085, Richmond County,351,133,110,23,0,23,23,0,23,0,328,110,110,0,0,1284,23,1261
360850189011,36, New York,085, Richmond County,578,308,291,0,17,0,0,0,0,0,578,308,291,0,17,1571,17,1554
360850189012,36, New York,085, Richmond County,318,132,115,0,17,0,0,0,0,0,318,132,115,0,17,908,0,908
360850189013,36, New York,085, Richmond County,380,170,95,0,75,1,1,0,0,1,379,169,95,0,74,1332,38,1294
360850189021,36, New York,085, Richmond County,466,186,156,23,7,55,55,55,0,0,411,131,101,23,7,1176,133,1043
360850189022,36, New York,085, Richmond County,568,264,234,0,30,8,0,0,0,0,560,264,234,0,30,1755,26,1729
360850189023,36, New York,085, Richmond County,337,133,120,0,13,128,77,77,0,0,209,56,43,0,13,1079,456,623
360850197001,36, New York,085, Richmond County,315,185,174,0,11,0,0,0,0,0,315,185,174,0,11,913,23,890
360850197002,36, New York,085, Richmond County,187,68,60,8,0,18,0,0,0,0,169,68,60,8,0,614,56,558
360850198000,36, New York,085, Richmond County,0,0,0,0,0,0,0,0,0,0,0,0,0,0,0,0,0,0
360850198001,36, New York,085, Richmond County,386,321,308,0,13,0,0,0,0,0,386,321,308,0,13,1258,17,1241
360850198002,36, New York,085, Richmond County,388,207,207,0,0,0,0,0,0,0,388,207,207,0,0,1196,0,1196
360850198003,36, New York,085, Richmond County,563,109,34,0,75,37,11,0,0,11,526,98,34,0,64,1688,104,1584
360850198004,36, New York,085, Richmond County,714,298,208,0,90,153,153,63,0,90,561,145,145,0,0,1809,239,1570
360850201001,36, New York,085, Richmond County,476,292,210,0,82,74,74,18,0,56,402,218,192,0,26,885,101,784
360850201002,36, New York,085, Richmond County,284,141,117,0,24,24,24,0,0,24,260,117,117,0,0,629,32,597
360850201003,36, New York,085, Richmond County,306,179,175,0,4,14,14,14,0,0,292,165,161,0,4,864,17,847
360850207010,36, New York,085, Richmond County,0,0,0,0,0,0,0,0,0,0,0,0,0,0,0,0,0,0
360850207011,36, New York,085, Richmond County,209,55,29,0,26,26,26,0,0,26,183,29,29,0,0,799,222,577
360850207012,36, New York,085, Richmond County,253,85,73,0,12,0,0,0,0,0,253,85,73,0,12,831,29,802
360850207013,36, New York,085, Richmond County,258,105,81,0,24,24,24,0,0,24,234,81,81,0,0,558,48,510
360850207020,36, New York,085, Richmond County,0,0,0,0,0,0,0,0,0,0,0,0,0,0,0,0,0,0
360850207021,36, New York,085, Richmond County,165,128,30,0,98,118,98,0,0,98,47,30,30,0,0,136,0,136
360850207022,36, New York,085, Richmond County,118,39,39,0,0,0,0,0,0,0,118,39,39,0,0,614,195,419
360850207023,36, New York,085, Richmond County,186,3,0,0,3,44,3,0,0,3,142,0,0,0,0,717,185,532
360850208031,36, New York,085, Richmond County,534,354,336,18,0,115,115,97,18,0,419,239,239,0,0,1433,231,1202
360850208032,36, New York,085, Richmond County,691,280,256,0,24,8,8,0,0,8,683,272,256,0,16,1709,12,1697
360850208033,36, New York,085, Richmond County,311,55,55,0,0,20,0,0,0,0,291,55,55,0,0,813,38,775
360850208034,36, New York,085, Richmond County,514,441,403,0,38,88,88,50,0,38,426,353,353,0,0,1349,242,1107
360850208041,36, New York,085, Richmond County,605,212,188,0,24,0,0,0,0,0,605,212,188,0,24,1719,29,1690
360850208042,36, New York,085, Richmond County,653,239,203,0,36,0,0,0,0,0,653,239,203,0,36,1623,23,1600
360850208043,36, New York,085, Richmond County,283,132,132,0,0,19,11,11,0,0,264,121,121,0,0,902,127,775
360850208051,36, New York,085, Richmond County,418,156,110,0,46,19,19,0,0,19,399,137,110,0,27,1131,19,1112
360850208052,36, New York,085, Richmond County,758,358,305,28,25,53,0,0,0,0,705,358,305,28,25,2315,194,2121
360850208053,36, New York,085, Richmond County,484,207,144,22,41,0,0,0,0,0,484,207,144,22,41,1297,49,1248
360850208061,36, New York,085, Richmond County,419,248,241,7,0,37,7,0,7,0,382,241,241,0,0,1298,129,1169
360850208062,36, New York,085, Richmond County,250,70,70,0,0,0,0,0,0,0,250,70,70,0,0,756,0,756
360850213001,36, New York,085, Richmond County,284,156,84,0,72,0,0,0,0,0,284,156,84,0,72,540,16,524
360850213002,36, New York,085, Richmond County,162,48,27,0,21,36,21,0,0,21,126,27,27,0,0,999,401,598
360850213003,36, New York,085, Richmond County,318,197,141,0,56,43,43,9,0,34,275,154,132,0,22,835,99,736
360850213004,36, New York,085, Richmond County,307,194,144,39,11,50,50,0,39,11,257,144,144,0,0,684,50,634
360850213005,36, New York,085, Richmond County,123,90,11,0,79,30,30,0,0,30,93,60,11,0,49,247,44,203
360850223000,36, New York,085, Richmond County,0,0,0,0,0,0,0,0,0,0,0,0,0,0,0,0,0,0
360850223001,36, New York,085, Richmond County,296,143,109,0,34,39,7,7,0,0,257,136,102,0,34,1238,154,1084
360850223002,36, New York,085, Richmond County,235,120,65,0,55,96,89,34,0,55,139,31,31,0,0,660,170,490
360850223003,36, New York,085, Richmond County,0,0,0,0,0,0,0,0,0,0,0,0,0,0,0,0,0,0
360850226011,36, New York,085, Richmond County,753,413,362,0,51,12,12,12,0,0,741,401,350,0,51,1929,184,1745
360850226012,36, New York,085, Richmond County,362,194,121,0,73,0,0,0,0,0,362,194,121,0,73,911,70,841
360850226013,36, New York,085, Richmond County,293,172,172,0,0,0,0,0,0,0,293,172,172,0,0,700,0,700
360850226014,36, New York,085, Richmond County,441,252,209,0,43,0,0,0,0,0,441,252,209,0,43,1237,0,1237
360850226020,36, New York,085, Richmond County,0,0,0,0,0,0,0,0,0,0,0,0,0,0,0,0,0,0
360850226021,36, New York,085, Richmond County,151,33,33,0,0,0,0,0,0,0,151,33,33,0,0,701,283,418
360850226022,36, New York,085, Richmond County,222,29,8,0,21,21,21,0,0,21,201,8,8,0,0,599,73,526
360850226023,36, New York,085, Richmond County,0,0,0,0,0,0,0,0,0,0,0,0,0,0,0,0,0,0
360850228010,36, New York,085, Richmond County,0,0,0,0,0,0,0,0,0,0,0,0,0,0,0,0,0,0
360850228011,36, New York,085, Richmond County,9,0,0,0,0,0,0,0,0,0,9,0,0,0,0,5,0,5
360850228012,36, New York,085, Richmond County,0,0,0,0,0,0,0,0,0,0,0,0,0,0,0,0,0,0
360850228021,36, New York,085, Richmond County,0,0,0,0,0,0,0,0,0,0,0,0,0,0,0,0,0,0
360850231001,36, New York,085, Richmond County,454,227,196,0,31,47,12,12,0,0,407,215,184,0,31,1366,191,1175
360850231002,36, New York,085, Richmond County,265,158,84,27,47,37,10,0,0,10,228,148,84,27,37,759,81,678
360850231003,36, New York,085, Richmond County,445,156,58,0,98,38,28,0,0,28,407,128,58,0,70,998,74,924
360850239001,36, New York,085, Richmond County,558,306,275,0,31,56,56,56,0,0,502,250,219,0,31,1343,9,1334
360850239002,36, New York,085, Richmond County,281,129,94,0,35,0,0,0,0,0,281,129,94,0,35,891,84,807
360850244010,36, New York,085, Richmond County,0,0,0,0,0,0,0,0,0,0,0,0,0,0,0,0,0,0
360850244011,36, New York,085, Richmond County,420,130,130,0,0,77,0,0,0,0,343,130,130,0,0,1134,175,959
360850244012,36, New York,085, Richmond County,544,310,270,40,0,0,0,0,0,0,544,310,270,40,0,1418,44,1374
360850244013,36, New York,085, Richmond County,451,256,236,0,20,20,20,0,0,20,431,236,236,0,0,1280,20,1260
360850244020,36, New York,085, Richmond County,0,0,0,0,0,0,0,0,0,0,0,0,0,0,0,0,0,0
360850244021,36, New York,085, Richmond County,640,287,261,16,10,0,0,0,0,0,640,287,261,16,10,2005,25,1980
360850244022,36, New York,085, Richmond County,673,252,238,0,14,8,8,8,0,0,665,244,230,0,14,1912,66,1846
360850247001,36, New York,085, Richmond County,302,179,82,9,88,41,20,0,9,11,261,159,82,0,77,773,105,668
360850247002,36, New York,085, Richmond County,357,200,150,0,50,20,20,20,0,0,337,180,130,0,50,935,126,809
360850248000,36, New York,085, Richmond County,0,0,0,0,0,0,0,0,0,0,0,0,0,0,0,0,0,0
360850248001,36, New York,085, Richmond County,284,136,136,0,0,49,49,49,0,0,235,87,87,0,0,782,170,612
360850248002,36, New York,085, Richmond County,462,250,103,0,147,29,21,0,0,21,433,229,103,0,126,1448,55,1393
360850248003,36, New York,085, Richmond County,552,279,230,35,14,0,0,0,0,0,552,279,230,35,14,1497,36,1461
360850251001,36, New York,085, Richmond County,437,215,215,0,0,0,0,0,0,0,437,215,215,0,0,1826,188,1638
360850251002,36, New York,085, Richmond County,497,221,181,0,40,0,0,0,0,0,497,221,181,0,40,1431,0,1431
360850251003,36, New York,085, Richmond County,536,312,274,20,18,22,22,22,0,0,514,290,252,20,18,1576,60,1516
360850273011,36, New York,085, Richmond County,0,0,0,0,0,0,0,0,0,0,0,0,0,0,0,34,12,22
360850273012,36, New York,085, Richmond County,0,0,0,0,0,0,0,0,0,0,0,0,0,0,0,23,23,0
360850273013,36, New York,085, Richmond County,594,214,182,0,32,13,13,0,0,13,581,201,182,0,19,1820,64,1756
360850273014,36, New York,085, Richmond County,116,42,10,0,32,32,32,0,0,32,84,10,10,0,0,347,138,209
360850273015,36, New York,085, Richmond County,339,126,119,0,7,19,19,12,0,7,320,107,107,0,0,976,34,942
360850273021,36, New York,085, Richmond County,791,374,313,0,61,76,67,67,0,0,715,307,246,0,61,1682,94,1588
360850273022,36, New York,085, Richmond County,255,187,162,12,13,0,0,0,0,0,255,187,162,12,13,821,73,748
360850277021,36, New York,085, Richmond County,577,294,146,30,118,88,29,0,0,29,489,265,146,30,89,1588,149,1439
360850277022,36, New York,085, Richmond County,426,276,209,54,13,52,52,39,0,13,374,224,170,54,0,1198,127,1071
360850277023,36, New York,085, Richmond County,348,167,95,0,72,15,0,0,0,0,333,167,95,0,72,1174,213,961
360850277024,36, New York,085, Richmond County,266,78,78,0,0,12,12,12,0,0,254,66,66,0,0,949,135,814
360850277041,36, New York,085, Richmond County,630,347,241,38,68,56,44,0,0,44,574,303,241,38,24,1309,97,1212
360850277042,36, New York,085, Richmond County,707,332,282,35,15,94,49,49,0,0,613,283,233,35,15,1742,168,1574
360850277051,36, New York,085, Richmond County,730,321,259,52,10,70,61,24,28,9,660,260,235,24,1,2063,216,1847
360850277052,36, New York,085, Richmond County,356,124,97,9,18,0,0,0,0,0,356,124,97,9,18,720,0,720
360850277053,36, New York,085, Richmond County,522,182,172,0,10,7,7,7,0,0,515,175,165,0,10,1381,74,1307
360850277061,36, New York,085, Richmond County,390,93,57,0,36,180,24,24,0,0,210,69,33,0,36,1327,556,771
360850277062,36, New York,085, Richmond County,151,58,58,0,0,27,0,0,0,0,124,58,58,0,0,409,45,364
360850277063,36, New York,085, Richmond County,303,143,134,0,9,0,0,0,0,0,303,143,134,0,9,616,9,607
360850279001,36, New York,085, Richmond County,314,138,133,0,5,13,13,8,0,5,301,125,125,0,0,902,46,856
360850279002,36, New York,085, Richmond County,167,91,52,4,35,36,31,6,0,25,131,60,46,4,10,417,63,354
360850279003,36, New York,085, Richmond County,0,0,0,0,0,0,0,0,0,0,0,0,0,0,0,0,0,0
360850279004,36, New York,085, Richmond County,0,0,0,0,0,0,0,0,0,0,0,0,0,0,0,0,0,0
360850291020,36, New York,085, Richmond County,0,0,0,0,0,0,0,0,0,0,0,0,0,0,0,0,0,0
360850291021,36, New York,085, Richmond County,63,20,16,0,4,0,0,0,0,0,63,20,16,0,4,213,12,201
360850291022,36, New York,085, Richmond County,716,475,387,36,52,17,16,0,0,16,699,459,387,36,36,1994,100,1894
360850291041,36, New York,085, Richmond County,593,147,125,0,22,9,9,9,0,0,584,138,116,0,22,1666,50,1616
360850291042,36, New York,085, Richmond County,539,88,54,0,34,0,0,0,0,0,539,88,54,0,34,1455,52,1403
360850291043,36, New York,085, Richmond County,516,89,89,0,0,15,0,0,0,0,501,89,89,0,0,1216,25,1191
360850291044,36, New York,085, Richmond County,378,195,180,0,15,22,0,0,0,0,356,195,180,0,15,907,24,883
360850291051,36, New York,085, Richmond County,187,98,79,10,9,0,0,0,0,0,187,98,79,10,9,810,16,794
360850291052,36, New York,085, Richmond County,441,290,290,0,0,73,36,36,0,0,368,254,254,0,0,1199,41,1158
360850291053,36, New York,085, Richmond County,431,237,158,0,79,11,0,0,0,0,420,237,158,0,79,1402,84,1318
360850291061,36, New York,085, Richmond County,320,126,113,0,13,0,0,0,0,0,320,126,113,0,13,861,0,861
360850291062,36, New York,085, Richmond County,528,204,114,0,90,89,32,0,0,32,439,172,114,0,58,1681,225,1456
360850303011,36, New York,085, Richmond County,1039,444,307,137,0,6,0,0,0,0,1033,444,307,137,0,2430,155,2275
360850303012,36, New York,085, Richmond County,513,114,62,25,27,8,0,0,0,0,505,114,62,25,27,1661,31,1630
360850303021,36, New York,085, Richmond County,262,70,38,0,32,13,0,0,0,0,249,70,38,0,32,871,53,818
360850303022,36, New York,085, Richmond County,707,423,309,25,89,68,68,68,0,0,639,355,241,25,89,2189,300,1889
360850303023,36, New York,085, Richmond County,537,174,145,0,29,71,31,31,0,0,466,143,114,0,29,1584,254,1330
360850303024,36, New York,085, Richmond County,0,0,0,0,0,0,0,0,0,0,0,0,0,0,0,0,0,0
360850319011,36, New York,085, Richmond County,664,272,57,0,215,282,104,0,0,104,382,168,57,0,111,1770,826,944
360850319012,36, New York,085, Richmond County,302,163,145,0,18,0,0,0,0,0,302,163,145,0,18,860,0,860
360850319020,36, New York,085, Richmond County,0,0,0,0,0,0,0,0,0,0,0,0,0,0,0,0,0,0
360850319021,36, New York,085, Richmond County,327,254,37,0,217,212,184,0,0,184,115,70,37,0,33,609,251,358
360850319022,36, New York,085, Richmond County,458,153,21,36,96,85,45,0,36,9,373,108,21,0,87,1287,164,1123
360850319023,36, New York,085, Richmond County,424,246,178,4,64,27,27,0,0,27,397,219,178,4,37,1015,90,925
360850323000,36, New York,085, Richmond County,0,0,0,0,0,0,0,0,0,0,0,0,0,0,0,0,0,0
360850323001,36, New York,085, Richmond County,288,171,120,0,51,0,0,0,0,0,288,171,120,0,51,783,56,727
360859901000,36, New York,085, Richmond County,0,0,0,0,0,0,0,0,0,0,0,0,0,0,0,0,0,0
360210001001,36, New York,021, Columbia County,396,125,111,0,14,14,8,0,0,8,382,117,111,0,6,1201,97,1104
360210001002,36, New York,021, Columbia County,181,51,40,6,5,10,10,10,0,0,171,41,30,6,5,781,92,689
360210002001,36, New York,021, Columbia County,240,35,23,10,2,2,2,0,0,2,238,33,23,10,0,619,34,585
360210002002,36, New York,021, Columbia County,241,93,66,5,22,16,9,4,5,0,225,84,62,0,22,760,67,693
360210003001,36, New York,021, Columbia County,236,52,17,21,14,5,5,0,0,5,231,47,17,21,9,685,51,634
360210003002,36, New York,021, Columbia County,248,83,52,0,31,0,0,0,0,0,248,83,52,0,31,626,27,599
360210003003,36, New York,021, Columbia County,156,42,42,0,0,9,0,0,0,0,147,42,42,0,0,543,64,479
360210003004,36, New York,021, Columbia County,328,123,48,20,55,67,56,0,8,48,261,67,48,12,7,710,88,622
360210003005,36, New York,021, Columbia County,230,137,69,23,45,0,0,0,0,0,230,137,69,23,45,626,32,594
360210004011,36, New York,021, Columbia County,399,142,102,27,13,21,21,0,18,3,378,121,102,9,10,1307,128,1179
360210004012,36, New York,021, Columbia County,210,74,74,0,0,22,0,0,0,0,188,74,74,0,0,576,52,524
360210004021,36, New York,021, Columbia County,585,295,106,72,117,0,0,0,0,0,585,295,106,72,117,1570,145,1425
360210004022,36, New York,021, Columbia County,149,48,32,7,9,46,0,0,0,0,103,48,32,7,9,457,114,343
360210004023,36, New York,021, Columbia County,407,210,141,44,25,20,18,18,0,0,387,192,123,44,25,1150,49,1101
360210004024,36, New York,021, Columbia County,466,161,105,0,56,0,0,0,0,0,466,161,105,0,56,1319,10,1309
360210005001,36, New York,021, Columbia County,624,260,142,33,85,57,17,17,0,0,567,243,125,33,85,1666,177,1489
360210006001,36, New York,021, Columbia County,246,62,31,31,0,0,0,0,0,0,246,62,31,31,0,631,51,580
360210006002,36, New York,021, Columbia County,332,166,82,7,77,10,5,0,0,5,322,161,82,7,72,913,50,863
360210006003,36, New York,021, Columbia County,101,67,24,0,43,25,25,0,0,25,76,42,24,0,18,282,25,257
360210007001,36, New York,021, Columbia County,273,142,121,0,21,9,9,0,0,9,264,133,121,0,12,979,151,828
360210007002,36, New York,021, Columbia County,241,119,59,34,26,0,0,0,0,0,241,119,59,34,26,839,46,793
360210007003,36, New York,021, Columbia County,221,68,57,5,6,17,6,0,0,6,204,62,57,5,0,657,38,619
360210007004,36, New York,021, Columbia County,276,40,26,0,14,14,14,0,0,14,262,26,26,0,0,759,14,745
360210007005,36, New York,021, Columbia County,317,184,156,28,0,11,11,11,0,0,306,173,145,28,0,1030,26,1004
360210008001,36, New York,021, Columbia County,260,56,56,0,0,3,0,0,0,0,257,56,56,0,0,765,18,747
360210008002,36, New York,021, Columbia County,182,33,25,0,8,7,0,0,0,0,175,33,25,0,8,721,49,672
360210009001,36, New York,021, Columbia County,225,70,55,13,2,2,2,0,0,2,223,68,55,13,0,731,55,676
360210009002,36, New York,021, Columbia County,334,90,46,12,32,24,19,7,0,12,310,71,39,12,20,821,66,755
360210010001,36, New York,021, Columbia County,182,117,51,15,51,11,0,0,0,0,171,117,51,15,51,489,21,468
360210010002,36, New York,021, Columbia County,244,117,33,0,84,34,34,0,0,34,210,83,33,0,50,914,103,811
360210010003,36, New York,021, Columbia County,291,95,95,0,0,11,0,0,0,0,280,95,95,0,0,996,23,973
360210010004,36, New York,021, Columbia County,389,157,0,0,157,61,61,0,0,61,328,96,0,0,96,898,104,794
360210010005,36, New York,021, Columbia County,260,0,0,0,0,0,0,0,0,0,260,0,0,0,0,904,0,904
360210010006,36, New York,021, Columbia County,247,171,171,0,0,0,0,0,0,0,247,171,171,0,0,585,27,558
360210011001,36, New York,021, Columbia County,189,43,22,21,0,14,0,0,0,0,175,43,22,21,0,587,35,552
360210011002,36, New York,021, Columbia County,243,98,68,30,0,30,30,0,30,0,213,68,68,0,0,692,70,622
360210011003,36, New York,021, Columbia County,547,239,123,17,99,69,44,0,17,27,478,195,123,0,72,1324,142,1182
360210011004,36, New York,021, Columbia County,259,128,37,0,91,51,51,0,0,51,208,77,37,0,40,909,93,816
360210012001,36, New York,021, Columbia County,254,66,66,0,0,22,0,0,0,0,232,66,66,0,0,949,64,885
360210012002,36, New York,021, Columbia County,91,24,0,0,24,67,24,0,0,24,24,0,0,0,0,282,219,63
360210012003,36, New York,021, Columbia County,158,94,66,17,11,21,21,0,17,4,137,73,66,0,7,459,44,415
360210012004,36, New York,021, Columbia County,100,67,15,30,22,30,30,0,30,0,70,37,15,0,22,536,48,488
360210013001,36, New York,021, Columbia County,312,257,88,0,169,199,182,20,0,162,113,75,68,0,7,562,249,313
360210013002,36, New York,021, Columbia County,142,79,59,4,16,21,0,0,0,0,121,79,59,4,16,346,59,287
360210013003,36, New York,021, Columbia County,57,0,0,0,0,0,0,0,0,0,57,0,0,0,0,227,18,209
360210013004,36, New York,021, Columbia County,61,19,19,0,0,17,11,11,0,0,44,8,8,0,0,350,86,264
360210013005,36, New York,021, Columbia County,124,56,43,0,13,8,0,0,0,0,116,56,43,0,13,408,74,334
360210014001,36, New York,021, Columbia County,477,38,38,0,0,18,0,0,0,0,459,38,38,0,0,1211,194,1017
360210014002,36, New York,021, Columbia County,313,31,0,17,14,14,14,0,0,14,299,17,0,17,0,1153,80,1073
360210014003,36, New York,021, Columbia County,229,79,75,0,4,31,31,31,0,0,198,48,44,0,4,563,83,480
360210015001,36, New York,021, Columbia County,188,62,35,4,23,9,9,9,0,0,179,53,26,4,23,469,37,432
360210015002,36, New York,021, Columbia County,177,52,49,0,3,3,0,0,0,0,174,52,49,0,3,538,40,498
360210016001,36, New York,021, Columbia County,343,62,36,26,0,0,0,0,0,0,343,62,36,26,0,1346,209,1137
360210016002,36, New York,021, Columbia County,226,39,31,0,8,0,0,0,0,0,226,39,31,0,8,667,19,648
360210016003,36, New York,021, Columbia County,135,33,25,8,0,0,0,0,0,0,135,33,25,8,0,487,0,487
360210016004,36, New York,021, Columbia County,185,53,18,0,35,0,0,0,0,0,185,53,18,0,35,456,0,456
360210017001,36, New York,021, Columbia County,179,50,50,0,0,0,0,0,0,0,179,50,50,0,0,643,12,631
360210017002,36, New York,021, Columbia County,168,64,48,0,16,18,7,5,0,2,150,57,43,0,14,479,52,427
360210018001,36, New York,021, Columbia County,124,19,15,0,4,0,0,0,0,0,124,19,15,0,4,331,5,326
360210018002,36, New York,021, Columbia County,290,118,97,11,10,28,19,15,0,4,262,99,82,11,6,851,55,796
360210019001,36, New York,021, Columbia County,330,107,71,26,10,5,3,0,0,3,325,104,71,26,7,992,122,870
360210019002,36, New York,021, Columbia County,253,101,67,24,10,0,0,0,0,0,253,101,67,24,10,756,31,725
360210020001,36, New York,021, Columbia County,172,56,15,23,18,0,0,0,0,0,172,56,15,23,18,552,36,516
360210020002,36, New York,021, Columbia County,360,71,55,11,5,28,0,0,0,0,332,71,55,11,5,1007,93,914
360150001001,36, New York,015, Chemung County,315,116,17,0,99,57,57,0,0,57,258,59,17,0,42,1188,274,914
360150001002,36, New York,015, Chemung County,128,61,22,9,30,18,9,0,9,0,110,52,22,0,30,549,121,428
360150001003,36, New York,015, Chemung County,131,83,28,0,55,39,39,28,0,11,92,44,0,0,44,428,85,343
360150002001,36, New York,015, Chemung County,237,155,82,35,38,32,32,0,14,18,205,123,82,21,20,766,86,680
360150002002,36, New York,015, Chemung County,371,148,61,22,65,44,40,11,11,18,327,108,50,11,47,1045,152,893
360150003001,36, New York,015, Chemung County,0,0,0,0,0,0,0,0,0,0,0,0,0,0,0,0,0,0
360150004001,36, New York,015, Chemung County,179,92,14,10,68,8,8,8,0,0,171,84,6,10,68,521,15,506
360150004002,36, New York,015, Chemung County,211,162,10,0,152,154,154,10,0,144,57,8,0,0,8,369,216,153
360150004003,36, New York,015, Chemung County,199,82,31,0,51,51,51,0,0,51,148,31,31,0,0,706,109,597
360150005001,36, New York,015, Chemung County,105,28,24,0,4,4,4,0,0,4,101,24,24,0,0,374,15,359
360150005002,36, New York,015, Chemung County,284,105,45,0,60,48,9,0,0,9,236,96,45,0,51,956,233,723
360150005003,36, New York,015, Chemung County,313,177,102,13,62,38,33,0,0,33,275,144,102,13,29,883,153,730
360150006001,36, New York,015, Chemung County,42,20,0,8,12,22,0,0,0,0,20,20,0,8,12,282,182,100
360150006002,36, New York,015, Chemung County,293,262,149,58,55,57,57,0,2,55,236,205,149,56,0,900,375,525
360150006003,36, New York,015, Chemung County,175,45,11,8,26,24,19,0,8,11,151,26,11,0,15,612,141,471
360150007001,36, New York,015, Chemung County,136,100,38,0,62,62,62,0,0,62,74,38,38,0,0,494,207,287
360150007002,36, New York,015, Chemung County,191,170,14,0,156,108,108,0,0,108,83,62,14,0,48,661,360,301
360150007003,36, New York,015, Chemung County,63,16,0,16,0,29,16,0,16,0,34,0,0,0,0,217,100,117
360150009001,36, New York,015, Chemung County,128,74,65,0,9,12,8,8,0,0,116,66,57,0,9,483,32,451
360150009002,36, New York,015, Chemung County,73,13,0,13,0,38,13,0,13,0,35,0,0,0,0,230,78,152
360150009003,36, New York,015, Chemung County,160,113,113,0,0,23,23,23,0,0,137,90,90,0,0,461,84,377
360150009004,36, New York,015, Chemung County,226,92,50,20,22,11,11,0,0,11,215,81,50,20,11,603,50,553
360150009005,36, New York,015, Chemung County,101,39,30,0,9,19,19,10,0,9,82,20,20,0,0,339,51,288
360150010001,36, New York,015, Chemung County,134,94,0,52,42,61,61,0,19,42,73,33,0,33,0,335,126,209
360150010002,36, New York,015, Chemung County,227,78,45,0,33,26,0,0,0,0,201,78,45,0,33,698,115,583
360150010003,36, New York,015, Chemung County,298,202,68,21,113,146,125,14,21,90,152,77,54,0,23,918,418,500
360150011001,36, New York,015, Chemung County,240,125,110,0,15,8,0,0,0,0,232,125,110,0,15,694,51,643
360150011002,36, New York,015, Chemung County,257,158,86,23,49,49,49,0,0,49,208,109,86,23,0,664,88,576
360150011003,36, New York,015, Chemung County,228,88,54,34,0,0,0,0,0,0,228,88,54,34,0,743,70,673
360150011004,36, New York,015, Chemung County,126,75,40,0,35,35,35,0,0,35,91,40,40,0,0,505,186,319
360150101001,36, New York,015, Chemung County,268,131,80,24,27,16,3,3,0,0,252,128,77,24,27,840,97,743
360150101002,36, New York,015, Chemung County,244,88,49,25,14,29,18,0,15,3,215,70,49,10,11,653,80,573
360150101003,36, New York,015, Chemung County,127,68,50,8,10,10,10,0,0,10,117,58,50,8,0,332,17,315
360150101004,36, New York,015, Chemung County,207,88,65,14,9,15,15,6,9,0,192,73,59,5,9,677,98,579
360150102001,36, New York,015, Chemung County,236,61,52,0,9,9,9,0,0,9,227,52,52,0,0,575,9,566
360150102002,36, New York,015, Chemung County,253,154,122,12,20,5,5,0,5,0,248,149,122,7,20,690,43,647
360150102003,36, New York,015, Chemung County,330,116,83,0,33,24,17,12,0,5,306,99,71,0,28,770,68,702
360150102004,36, New York,015, Chemung County,300,124,106,0,18,0,0,0,0,0,300,124,106,0,18,698,52,646
360150102005,36, New York,015, Chemung County,407,184,137,27,20,0,0,0,0,0,407,184,137,27,20,1079,131,948
360150102006,36, New York,015, Chemung County,225,150,95,9,46,7,5,5,0,0,218,145,90,9,46,685,46,639
360150103011,36, New York,015, Chemung County,443,217,167,50,0,18,0,0,0,0,425,217,167,50,0,1115,33,1082
360150103012,36, New York,015, Chemung County,334,104,83,0,21,0,0,0,0,0,334,104,83,0,21,865,11,854
360150103013,36, New York,015, Chemung County,594,152,130,14,8,22,22,14,0,8,572,130,116,14,0,1599,91,1508
360150103021,36, New York,015, Chemung County,351,130,130,0,0,0,0,0,0,0,351,130,130,0,0,1045,22,1023
360150103022,36, New York,015, Chemung County,185,74,74,0,0,0,0,0,0,0,185,74,74,0,0,638,22,616
360150103023,36, New York,015, Chemung County,198,128,128,0,0,21,21,21,0,0,177,107,107,0,0,660,54,606
360150104001,36, New York,015, Chemung County,202,67,59,0,8,8,8,0,0,8,194,59,59,0,0,785,53,732
360150104002,36, New York,015, Chemung County,386,148,74,19,55,0,0,0,0,0,386,148,74,19,55,1165,38,1127
360150104003,36, New York,015, Chemung County,253,78,9,21,48,0,0,0,0,0,253,78,9,21,48,908,6,902
360150105001,36, New York,015, Chemung County,119,89,29,0,60,45,45,0,0,45,74,44,29,0,15,192,54,138
360150105002,36, New York,015, Chemung County,248,162,96,8,58,64,59,23,0,36,184,103,73,8,22,1045,184,861
360150105003,36, New York,015, Chemung County,313,120,89,0,31,0,0,0,0,0,313,120,89,0,31,952,54,898
360150106001,36, New York,015, Chemung County,167,57,35,0,22,0,0,0,0,0,167,57,35,0,22,568,19,549
360150106002,36, New York,015, Chemung County,216,159,111,25,23,60,60,52,0,8,156,99,59,25,15,735,217,518
360150106003,36, New York,015, Chemung County,203,86,86,0,0,0,0,0,0,0,203,86,86,0,0,731,24,707
360150107011,36, New York,015, Chemung County,313,180,82,0,98,8,0,0,0,0,305,180,82,0,98,986,132,854
360150107012,36, New York,015, Chemung County,295,109,109,0,0,0,0,0,0,0,295,109,109,0,0,945,200,745
360150107013,36, New York,015, Chemung County,135,21,0,0,21,0,0,0,0,0,135,21,0,0,21,323,0,323
360150107021,36, New York,015, Chemung County,225,118,118,0,0,0,0,0,0,0,225,118,118,0,0,597,0,597
360150107022,36, New York,015, Chemung County,566,272,210,38,24,34,34,34,0,0,532,238,176,38,24,1427,146,1281
360150107023,36, New York,015, Chemung County,493,177,90,17,70,1,1,0,0,1,492,176,90,17,69,1241,14,1227
360150108001,36, New York,015, Chemung County,190,50,0,40,10,11,0,0,0,0,179,50,0,40,10,462,55,407
360150108002,36, New York,015, Chemung County,217,91,20,12,59,0,0,0,0,0,217,91,20,12,59,820,58,762
360150108003,36, New York,015, Chemung County,202,71,25,11,35,11,0,0,0,0,191,71,25,11,35,536,34,502
360150108004,36, New York,015, Chemung County,197,141,77,32,32,64,64,0,32,32,133,77,77,0,0,629,137,492
360150108005,36, New York,015, Chemung County,168,46,46,0,0,39,0,0,0,0,129,46,46,0,0,666,219,447
360150109001,36, New York,015, Chemung County,413,239,169,0,70,0,0,0,0,0,413,239,169,0,70,1102,53,1049
360150109002,36, New York,015, Chemung County,206,49,49,0,0,0,0,0,0,0,206,49,49,0,0,594,46,548
360150109003,36, New York,015, Chemung County,334,165,128,29,8,0,0,0,0,0,334,165,128,29,8,972,0,972
360150109004,36, New York,015, Chemung County,436,143,78,0,65,62,0,0,0,0,374,143,78,0,65,1025,116,909
360150110001,36, New York,015, Chemung County,303,114,73,25,16,76,44,22,6,16,227,70,51,19,0,891,184,707
360150110002,36, New York,015, Chemung County,319,140,67,16,57,13,13,0,0,13,306,127,67,16,44,835,28,807
360150110003,36, New York,015, Chemung County,247,73,49,9,15,7,7,2,3,2,240,66,47,6,13,738,28,710
360150110004,36, New York,015, Chemung County,161,71,36,26,9,14,0,0,0,0,147,71,36,26,9,353,29,324
360150111011,36, New York,015, Chemung County,376,75,29,46,0,23,23,0,23,0,353,52,29,23,0,1089,84,1005
360150111012,36, New York,015, Chemung County,331,197,20,98,79,19,8,0,0,8,312,189,20,98,71,971,253,718
360150111021,36, New York,015, Chemung County,194,87,87,0,0,15,15,15,0,0,179,72,72,0,0,573,74,499
360150111022,36, New York,015, Chemung County,251,161,108,38,15,29,29,14,0,15,222,132,94,38,0,923,299,624
360150111023,36, New York,015, Chemung County,184,85,0,9,76,47,0,0,0,0,137,85,0,9,76,917,165,752
360150111024,36, New York,015, Chemung County,401,108,108,0,0,0,0,0,0,0,401,108,108,0,0,1072,18,1054
360150112001,36, New York,015, Chemung County,205,87,87,0,0,21,0,0,0,0,184,87,87,0,0,561,41,520
360150112002,36, New York,015, Chemung County,177,73,50,23,0,9,0,0,0,0,168,73,50,23,0,668,71,597
360150112003,36, New York,015, Chemung County,332,86,0,55,31,57,31,0,0,31,275,55,0,55,0,837,168,669
360150112004,36, New York,015, Chemung County,171,93,68,2,23,40,38,28,2,8,131,55,40,0,15,526,103,423
360150112005,36, New York,015, Chemung County,167,67,13,32,22,24,24,0,12,12,143,43,13,20,10,650,60,590
360150112006,36, New York,015, Chemung County,10,0,0,0,0,0,0,0,0,0,10,0,0,0,0,40,21,19
360319601001,36, New York,031, Essex County,143,80,41,13,26,12,12,0,5,7,131,68,41,8,19,499,73,426
360319601002,36, New York,031, Essex County,177,110,52,6,52,23,23,6,0,17,154,87,46,6,35,566,71,495
360319601003,36, New York,031, Essex County,251,93,55,11,27,26,26,0,1,25,225,67,55,10,2,873,59,814
360319602001,36, New York,031, Essex County,245,95,81,7,7,0,0,0,0,0,245,95,81,7,7,819,34,785
360319602002,36, New York,031, Essex County,424,167,99,27,41,19,14,0,0,14,405,153,99,27,27,1274,137,1137
360319603001,36, New York,031, Essex County,416,181,145,21,15,14,14,12,0,2,402,167,133,21,13,1324,104,1220
360319603002,36, New York,031, Essex County,383,131,81,27,23,16,7,0,0,7,367,124,81,27,16,1051,41,1010
360319604011,36, New York,031, Essex County,124,71,51,9,11,4,0,0,0,0,120,71,51,9,11,559,129,430
360319604012,36, New York,031, Essex County,50,25,1,5,19,0,0,0,0,0,50,25,1,5,19,185,17,168
360319604021,36, New York,031, Essex County,91,35,35,0,0,0,0,0,0,0,91,35,35,0,0,311,34,277
360319604022,36, New York,031, Essex County,125,93,93,0,0,0,0,0,0,0,125,93,93,0,0,291,26,265
360319604023,36, New York,031, Essex County,46,13,4,9,0,0,0,0,0,0,46,13,4,9,0,192,0,192
360319605011,36, New York,031, Essex County,254,159,32,127,0,0,0,0,0,0,254,159,32,127,0,741,22,719
360319605012,36, New York,031, Essex County,80,52,52,0,0,0,0,0,0,0,80,52,52,0,0,461,35,426
360319605013,36, New York,031, Essex County,153,49,24,0,25,0,0,0,0,0,153,49,24,0,25,502,32,470
360319605021,36, New York,031, Essex County,173,60,35,0,25,0,0,0,0,0,173,60,35,0,25,774,30,744
360319605022,36, New York,031, Essex County,279,201,35,35,131,46,35,0,35,0,233,166,35,0,131,538,73,465
360319605023,36, New York,031, Essex County,5,0,0,0,0,0,0,0,0,0,5,0,0,0,0,11,0,11
360319607001,36, New York,031, Essex County,369,140,77,20,43,9,3,0,0,3,360,137,77,20,40,875,25,850
360319607002,36, New York,031, Essex County,205,45,24,6,15,10,10,3,0,7,195,35,21,6,8,574,51,523
360319608001,36, New York,031, Essex County,218,82,25,35,22,41,35,0,35,0,177,47,25,0,22,572,86,486
360319608002,36, New York,031, Essex County,86,52,0,0,52,0,0,0,0,0,86,52,0,0,52,283,15,268
360319608003,36, New York,031, Essex County,318,76,61,14,1,20,20,6,14,0,298,56,55,0,1,796,35,761
360319609011,36, New York,031, Essex County,119,84,64,7,13,2,2,0,0,2,117,82,64,7,11,414,49,365
360319609012,36, New York,031, Essex County,169,81,73,0,8,12,12,8,0,4,157,69,65,0,4,621,97,524
360319609021,36, New York,031, Essex County,229,40,28,0,12,14,0,0,0,0,215,40,28,0,12,764,67,697
360319609022,36, New York,031, Essex County,253,96,60,10,26,24,20,4,9,7,229,76,56,1,19,853,65,788
360319610011,36, New York,031, Essex County,449,160,135,0,25,0,0,0,0,0,449,160,135,0,25,1155,48,1107
360319610021,36, New York,031, Essex County,168,69,1,0,68,10,10,0,0,10,158,59,1,0,58,704,81,623
360319610022,36, New York,031, Essex County,227,57,39,0,18,74,14,0,0,14,153,43,39,0,4,870,187,683
360319610023,36, New York,031, Essex County,70,39,39,0,0,0,0,0,0,0,70,39,39,0,0,275,17,258
360319610024,36, New York,031, Essex County,352,192,61,76,55,87,76,0,76,0,265,116,61,0,55,846,104,742
360319611001,36, New York,031, Essex County,417,152,124,8,20,9,0,0,0,0,408,152,124,8,20,1141,102,1039
360319611002,36, New York,031, Essex County,165,64,22,42,0,0,0,0,0,0,165,64,22,42,0,403,17,386
360319612011,36, New York,031, Essex County,91,67,20,14,33,14,14,0,14,0,77,53,20,0,33,483,14,469
360319612012,36, New York,031, Essex County,221,105,65,40,0,0,0,0,0,0,221,105,65,40,0,745,19,726
360319612013,36, New York,031, Essex County,200,14,14,0,0,0,0,0,0,0,200,14,14,0,0,576,80,496
360319612021,36, New York,031, Essex County,387,316,177,13,126,72,60,60,0,0,315,256,117,13,126,966,186,780
360319612022,36, New York,031, Essex County,159,42,13,29,0,39,18,0,18,0,120,24,13,11,0,541,144,397
360319612023,36, New York,031, Essex County,166,101,83,18,0,0,0,0,0,0,166,101,83,18,0,564,108,456
360319613001,36, New York,031, Essex County,368,115,91,0,24,14,11,8,0,3,354,104,83,0,21,1004,80,924
360319613002,36, New York,031, Essex County,275,63,41,0,22,28,28,6,0,22,247,35,35,0,0,679,48,631
360319614001,36, New York,031, Essex County,263,75,32,14,29,23,11,4,0,7,240,64,28,14,22,816,75,741
360319614002,36, New York,031, Essex County,175,41,37,0,4,8,4,0,0,4,167,37,37,0,0,492,42,450
360430101001,36, New York,043, Herkimer County,187,62,50,0,12,8,4,4,0,0,179,58,46,0,12,561,32,529
360430101002,36, New York,043, Herkimer County,222,69,49,0,20,5,4,4,0,0,217,65,45,0,20,697,40,657
360430101003,36, New York,043, Herkimer County,349,119,90,23,6,26,19,4,12,3,323,100,86,11,3,1000,80,920
360430101004,36, New York,043, Herkimer County,128,39,21,0,18,10,0,0,0,0,118,39,21,0,18,442,76,366
360430101005,36, New York,043, Herkimer County,385,209,97,63,49,81,76,13,51,12,304,133,84,12,37,994,173,821
360430101006,36, New York,043, Herkimer County,279,82,30,40,12,27,13,3,4,6,252,69,27,36,6,996,235,761
360430102011,36, New York,043, Herkimer County,193,104,35,0,69,33,29,20,0,9,160,75,15,0,60,480,70,410
360430102012,36, New York,043, Herkimer County,121,42,37,0,5,0,0,0,0,0,121,42,37,0,5,492,26,466
360430102013,36, New York,043, Herkimer County,392,247,78,11,158,32,32,0,0,32,360,215,78,11,126,980,56,924
360430102014,36, New York,043, Herkimer County,134,35,35,0,0,0,0,0,0,0,134,35,35,0,0,596,7,589
360430102021,36, New York,043, Herkimer County,369,141,103,13,25,0,0,0,0,0,369,141,103,13,25,1229,60,1169
360430102022,36, New York,043, Herkimer County,373,170,159,0,11,25,25,14,0,11,348,145,145,0,0,1052,58,994
360430102023,36, New York,043, Herkimer County,258,74,67,0,7,11,0,0,0,0,247,74,67,0,7,749,32,717
360430103001,36, New York,043, Herkimer County,483,166,139,0,27,27,27,0,0,27,456,139,139,0,0,1302,138,1164
360430103002,36, New York,043, Herkimer County,87,55,55,0,0,0,0,0,0,0,87,55,55,0,0,276,16,260
360430103003,36, New York,043, Herkimer County,520,207,139,0,68,27,0,0,0,0,493,207,139,0,68,1356,189,1167
360430103004,36, New York,043, Herkimer County,158,34,34,0,0,0,0,0,0,0,158,34,34,0,0,549,92,457
360430103005,36, New York,043, Herkimer County,272,81,81,0,0,0,0,0,0,0,272,81,81,0,0,859,41,818
360430104001,36, New York,043, Herkimer County,64,43,43,0,0,0,0,0,0,0,64,43,43,0,0,572,125,447
360430104002,36, New York,043, Herkimer County,203,73,73,0,0,24,0,0,0,0,179,73,73,0,0,755,75,680
360430104003,36, New York,043, Herkimer County,226,70,27,0,43,25,25,0,0,25,201,45,27,0,18,575,71,504
360430105011,36, New York,043, Herkimer County,0,0,0,0,0,0,0,0,0,0,0,0,0,0,0,0,0,0
360430105012,36, New York,043, Herkimer County,285,96,73,0,23,28,28,8,0,20,257,68,65,0,3,1055,82,973
360430105013,36, New York,043, Herkimer County,304,162,66,0,96,27,23,0,0,23,277,139,66,0,73,762,54,708
360430105021,36, New York,043, Herkimer County,234,46,46,0,0,20,0,0,0,0,214,46,46,0,0,590,71,519
360430105022,36, New York,043, Herkimer County,206,86,80,0,6,13,6,0,0,6,193,80,80,0,0,607,42,565
360430107011,36, New York,043, Herkimer County,202,107,81,0,26,10,0,0,0,0,192,107,81,0,26,652,60,592
360430107012,36, New York,043, Herkimer County,320,152,130,9,13,41,41,28,0,13,279,111,102,9,0,980,93,887
360430107021,36, New York,043, Herkimer County,232,127,47,0,80,37,37,0,0,37,195,90,47,0,43,923,180,743
360430107022,36, New York,043, Herkimer County,186,105,45,0,60,72,26,0,0,26,114,79,45,0,34,728,362,366
360430109001,36, New York,043, Herkimer County,362,152,118,15,19,6,3,0,0,3,356,149,118,15,16,1013,69,944
360430109002,36, New York,043, Herkimer County,468,165,136,16,13,33,12,4,8,0,435,153,132,8,13,1391,121,1270
360430110011,36, New York,043, Herkimer County,262,96,48,35,13,0,0,0,0,0,262,96,48,35,13,800,88,712
360430110012,36, New York,043, Herkimer County,218,81,49,8,24,32,19,0,0,19,186,62,49,8,5,817,152,665
360430110021,36, New York,043, Herkimer County,206,110,61,11,38,25,25,22,0,3,181,85,39,11,35,532,56,476
360430110022,36, New York,043, Herkimer County,376,67,62,0,5,46,26,26,0,0,330,41,36,0,5,917,137,780
360430110023,36, New York,043, Herkimer County,282,153,136,17,0,17,17,0,17,0,265,136,136,0,0,807,37,770
360430111001,36, New York,043, Herkimer County,0,0,0,0,0,0,0,0,0,0,0,0,0,0,0,0,0,0
360430111002,36, New York,043, Herkimer County,306,127,97,6,24,52,39,21,6,12,254,88,76,0,12,1032,241,791
360430111003,36, New York,043, Herkimer County,222,107,54,0,53,0,0,0,0,0,222,107,54,0,53,772,117,655
360430112001,36, New York,043, Herkimer County,105,35,0,0,35,0,0,0,0,0,105,35,0,0,35,410,39,371
360430112002,36, New York,043, Herkimer County,0,0,0,0,0,0,0,0,0,0,0,0,0,0,0,0,0,0
360430112003,36, New York,043, Herkimer County,256,103,50,0,53,0,0,0,0,0,256,103,50,0,53,600,18,582
360430112004,36, New York,043, Herkimer County,430,93,93,0,0,0,0,0,0,0,430,93,93,0,0,1143,39,1104
360430112005,36, New York,043, Herkimer County,129,53,34,0,19,53,53,34,0,19,76,0,0,0,0,785,166,619
360430112006,36, New York,043, Herkimer County,285,114,90,24,0,24,24,0,24,0,261,90,90,0,0,860,66,794
360430112007,36, New York,043, Herkimer County,128,64,20,0,44,0,0,0,0,0,128,64,20,0,44,630,28,602
360430113011,36, New York,043, Herkimer County,214,49,41,8,0,7,7,7,0,0,207,42,34,8,0,733,26,707
360430113012,36, New York,043, Herkimer County,154,65,26,19,20,9,9,2,0,7,145,56,24,19,13,609,89,520
360430113021,36, New York,043, Herkimer County,420,171,140,9,22,10,0,0,0,0,410,171,140,9,22,1266,37,1229
360430113022,36, New York,043, Herkimer County,179,55,13,29,13,28,23,0,12,11,151,32,13,17,2,815,123,692
360430113023,36, New York,043, Herkimer County,203,62,53,0,9,27,27,27,0,0,176,35,26,0,9,615,116,499
360430114001,36, New York,043, Herkimer County,226,77,69,3,5,16,9,9,0,0,210,68,60,3,5,604,45,559
360430114002,36, New York,043, Herkimer County,238,69,52,11,6,7,2,0,2,0,231,67,52,9,6,698,35,663
360430114003,36, New York,043, Herkimer County,283,78,49,23,6,19,19,0,19,0,264,59,49,4,6,816,116,700
360430114004,36, New York,043, Herkimer County,232,95,73,18,4,13,9,9,0,0,219,86,64,18,4,647,66,581
360430114005,36, New York,043, Herkimer County,204,129,97,12,20,12,8,5,0,3,192,121,92,12,17,570,45,525
360430115021,36, New York,043, Herkimer County,189,37,37,0,0,20,20,20,0,0,169,17,17,0,0,620,147,473
360430115022,36, New York,043, Herkimer County,180,42,42,0,0,0,0,0,0,0,180,42,42,0,0,437,0,437
360430115023,36, New York,043, Herkimer County,250,25,25,0,0,0,0,0,0,0,250,25,25,0,0,617,31,586
360430115031,36, New York,043, Herkimer County,249,126,89,14,23,11,10,0,5,5,238,116,89,9,18,674,48,626
360430115032,36, New York,043, Herkimer County,297,101,62,9,30,14,13,7,0,6,283,88,55,9,24,727,37,690
360430115041,36, New York,043, Herkimer County,176,48,34,0,14,6,6,0,0,6,170,42,34,0,8,520,39,481
360430115042,36, New York,043, Herkimer County,134,30,25,0,5,9,5,5,0,0,125,25,20,0,5,406,43,363
360450601011,36, New York,045, Jefferson County,259,134,121,13,0,13,12,12,0,0,246,122,109,13,0,717,57,660
360450601012,36, New York,045, Jefferson County,139,70,51,9,10,6,6,0,0,6,133,64,51,9,4,477,50,427
360450601013,36, New York,045, Jefferson County,65,0,0,0,0,0,0,0,0,0,65,0,0,0,0,184,13,171
360450601021,36, New York,045, Jefferson County,123,31,25,6,0,10,10,4,6,0,113,21,21,0,0,319,32,287
360450601022,36, New York,045, Jefferson County,184,51,36,7,8,7,7,0,7,0,177,44,36,0,8,647,67,580
360450601023,36, New York,045, Jefferson County,252,86,48,13,25,2,2,0,0,2,250,84,48,13,23,683,28,655
360450602011,36, New York,045, Jefferson County,140,59,31,0,28,17,14,8,0,6,123,45,23,0,22,526,116,410
360450602012,36, New York,045, Jefferson County,225,27,27,0,0,9,0,0,0,0,216,27,27,0,0,557,19,538
360450602013,36, New York,045, Jefferson County,150,43,15,24,4,0,0,0,0,0,150,43,15,24,4,384,10,374
360450602014,36, New York,045, Jefferson County,116,21,14,2,5,1,0,0,0,0,115,21,14,2,5,351,14,337
360450602021,36, New York,045, Jefferson County,191,47,30,10,7,11,7,0,0,7,180,40,30,10,0,452,26,426
360450602022,36, New York,045, Jefferson County,302,61,51,10,0,4,0,0,0,0,298,61,51,10,0,1060,192,868
360450602031,36, New York,045, Jefferson County,245,112,86,10,16,8,8,8,0,0,237,104,78,10,16,830,35,795
360450602032,36, New York,045, Jefferson County,260,100,81,3,16,31,11,0,0,11,229,89,81,3,5,925,91,834
360450603011,36, New York,045, Jefferson County,208,83,46,7,30,12,12,12,0,0,196,71,34,7,30,599,39,560
360450603012,36, New York,045, Jefferson County,249,86,70,3,13,12,5,0,0,5,237,81,70,3,8,739,67,672
360450603021,36, New York,045, Jefferson County,130,23,6,0,17,4,0,0,0,0,126,23,6,0,17,365,27,338
360450603022,36, New York,045, Jefferson County,141,24,18,0,6,0,0,0,0,0,141,24,18,0,6,427,9,418
360450603023,36, New York,045, Jefferson County,288,140,94,12,34,33,21,0,5,16,255,119,94,7,18,775,102,673
360450604011,36, New York,045, Jefferson County,554,225,180,5,40,42,18,0,0,18,512,207,180,5,22,1333,213,1120
360450604012,36, New York,045, Jefferson County,282,67,43,24,0,23,0,0,0,0,259,67,43,24,0,777,93,684
360450604013,36, New York,045, Jefferson County,217,113,97,2,14,2,2,2,0,0,215,111,95,2,14,609,24,585
360450604021,36, New York,045, Jefferson County,387,157,113,11,33,13,13,4,0,9,374,144,109,11,24,1222,65,1157
360450604022,36, New York,045, Jefferson County,329,141,105,29,7,16,0,0,0,0,313,141,105,29,7,897,114,783
360450605001,36, New York,045, Jefferson County,513,270,176,26,68,80,80,16,0,64,433,190,160,26,4,1432,260,1172
360450605002,36, New York,045, Jefferson County,112,45,16,0,29,0,0,0,0,0,112,45,16,0,29,384,0,384
360450605003,36, New York,045, Jefferson County,390,62,24,25,13,25,25,0,25,0,365,37,24,0,13,1364,357,1007
360450605004,36, New York,045, Jefferson County,521,243,142,0,101,0,0,0,0,0,521,243,142,0,101,1206,0,1206
360450606011,36, New York,045, Jefferson County,239,120,97,9,14,32,27,13,6,8,207,93,84,3,6,568,69,499
360450606012,36, New York,045, Jefferson County,203,81,25,18,38,39,27,1,4,22,164,54,24,14,16,570,127,443
360450606013,36, New York,045, Jefferson County,342,209,127,22,60,11,9,1,0,8,331,200,126,22,52,869,62,807
360450606021,36, New York,045, Jefferson County,427,282,220,0,62,0,0,0,0,0,427,282,220,0,62,1310,0,1310
360450606022,36, New York,045, Jefferson County,326,150,58,88,4,66,66,16,50,0,260,84,42,38,4,740,78,662
360450606023,36, New York,045, Jefferson County,176,82,0,0,82,0,0,0,0,0,176,82,0,0,82,765,32,733
360450607001,36, New York,045, Jefferson County,268,112,91,10,11,17,15,6,0,9,251,97,85,10,2,702,38,664
360450607002,36, New York,045, Jefferson County,246,95,82,7,6,11,6,0,0,6,235,89,82,7,0,569,23,546
360450607003,36, New York,045, Jefferson County,324,169,88,29,52,39,34,3,5,26,285,135,85,24,26,1215,150,1065
360450607004,36, New York,045, Jefferson County,324,144,123,4,17,31,19,8,4,7,293,125,115,0,10,975,146,829
360450608031,36, New York,045, Jefferson County,247,205,205,0,0,0,0,0,0,0,247,205,205,0,0,565,0,565
360450608032,36, New York,045, Jefferson County,1186,632,609,0,23,47,47,31,0,16,1139,585,578,0,7,2381,170,2211
360450608033,36, New York,045, Jefferson County,912,509,477,18,14,82,82,68,0,14,830,427,409,18,0,1807,146,1661
360450608051,36, New York,045, Jefferson County,515,490,445,0,45,26,26,13,0,13,489,464,432,0,32,1101,65,1036
360450608052,36, New York,045, Jefferson County,512,323,319,0,4,88,71,71,0,0,424,252,248,0,4,1337,163,1174
360450608061,36, New York,045, Jefferson County,505,440,390,0,50,68,68,18,0,50,437,372,372,0,0,909,86,823
360450608062,36, New York,045, Jefferson County,110,49,45,0,4,4,4,4,0,0,106,45,41,0,4,434,19,415
360450609011,36, New York,045, Jefferson County,232,84,67,0,17,0,0,0,0,0,232,84,67,0,17,764,27,737
360450609012,36, New York,045, Jefferson County,296,162,70,16,76,18,5,0,0,5,278,157,70,16,71,624,64,560
360450609013,36, New York,045, Jefferson County,388,141,43,0,98,56,40,0,0,40,332,101,43,0,58,978,121,857
360450609021,36, New York,045, Jefferson County,343,160,75,32,53,57,56,0,15,41,286,104,75,17,12,910,127,783
360450609022,36, New York,045, Jefferson County,264,133,112,4,17,17,17,0,0,17,247,116,112,4,0,849,71,778
360450610001,36, New York,045, Jefferson County,157,72,60,5,7,21,8,8,0,0,136,64,52,5,7,597,113,484
360450610002,36, New York,045, Jefferson County,482,211,101,10,100,97,60,0,10,50,385,151,101,0,50,1364,187,1177
360450610003,36, New York,045, Jefferson County,203,135,79,0,56,0,0,0,0,0,203,135,79,0,56,701,30,671
360450611011,36, New York,045, Jefferson County,304,199,103,6,90,86,81,0,0,81,218,118,103,6,9,713,183,530
360450611012,36, New York,045, Jefferson County,428,178,166,4,8,33,33,29,4,0,395,145,137,0,8,1173,109,1064
360450611021,36, New York,045, Jefferson County,252,84,72,0,12,73,4,4,0,0,179,80,68,0,12,573,144,429
360450611022,36, New York,045, Jefferson County,241,88,52,0,36,0,0,0,0,0,241,88,52,0,36,774,125,649
360450611023,36, New York,045, Jefferson County,398,111,37,0,74,53,13,13,0,0,345,98,24,0,74,832,102,730
360450612001,36, New York,045, Jefferson County,245,234,47,49,138,137,126,32,36,58,108,108,15,13,80,651,314,337
360450612002,36, New York,045, Jefferson County,165,96,60,0,36,25,25,0,0,25,140,71,60,0,11,553,39,514
360450612003,36, New York,045, Jefferson County,343,269,170,22,77,56,56,0,0,56,287,213,170,22,21,840,82,758
360450613001,36, New York,045, Jefferson County,102,49,21,0,28,28,28,0,0,28,74,21,21,0,0,369,179,190
360450613002,36, New York,045, Jefferson County,326,129,46,42,41,37,37,0,11,26,289,92,46,31,15,821,101,720
360450613003,36, New York,045, Jefferson County,353,101,10,0,91,19,19,0,0,19,334,82,10,0,72,1023,94,929
360450614001,36, New York,045, Jefferson County,130,31,6,0,25,7,7,0,0,7,123,24,6,0,18,535,40,495
360450614002,36, New York,045, Jefferson County,81,70,0,21,49,49,49,0,0,49,32,21,0,21,0,405,201,204
360450614003,36, New York,045, Jefferson County,374,224,153,39,32,74,74,11,39,24,300,150,142,0,8,1132,239,893
360450614004,36, New York,045, Jefferson County,153,72,52,0,20,10,0,0,0,0,143,72,52,0,20,590,63,527
360450615001,36, New York,045, Jefferson County,215,88,12,10,66,56,18,0,10,8,159,70,12,0,58,656,235,421
360450615002,36, New York,045, Jefferson County,192,100,66,14,20,21,0,0,0,0,171,100,66,14,20,734,153,581
360450615003,36, New York,045, Jefferson County,288,137,76,53,8,0,0,0,0,0,288,137,76,53,8,924,100,824
360450615004,36, New York,045, Jefferson County,257,43,0,0,43,10,10,0,0,10,247,33,0,0,33,895,36,859
360450616001,36, New York,045, Jefferson County,341,157,36,78,43,26,26,0,0,26,315,131,36,78,17,924,95,829
360450616002,36, New York,045, Jefferson County,572,341,228,48,65,100,97,2,45,50,472,244,226,3,15,1356,209,1147
360450616003,36, New York,045, Jefferson County,681,286,249,24,13,20,20,20,0,0,661,266,229,24,13,1650,49,1601
360450617001,36, New York,045, Jefferson County,265,64,34,21,9,23,15,7,8,0,242,49,27,13,9,690,98,592
360450617002,36, New York,045, Jefferson County,207,73,51,14,8,10,10,0,5,5,197,63,51,9,3,512,41,471
360450617003,36, New York,045, Jefferson County,293,71,21,25,25,47,30,0,16,14,246,41,21,9,11,664,94,570
360450618011,36, New York,045, Jefferson County,559,30,30,0,0,30,0,0,0,0,529,30,30,0,0,1289,112,1177
360450618012,36, New York,045, Jefferson County,244,135,58,28,49,38,34,10,0,24,206,101,48,28,25,740,121,619
360450618013,36, New York,045, Jefferson County,369,142,101,39,2,6,0,0,0,0,363,142,101,39,2,955,24,931
360450618021,36, New York,045, Jefferson County,255,112,68,3,41,44,44,0,3,41,211,68,68,0,0,731,80,651
360450618022,36, New York,045, Jefferson County,575,374,237,26,111,33,33,0,5,28,542,341,237,21,83,1537,137,1400
360450619001,36, New York,045, Jefferson County,220,107,73,11,23,8,8,0,0,8,212,99,73,11,15,724,141,583
360450619002,36, New York,045, Jefferson County,245,145,145,0,0,0,0,0,0,0,245,145,145,0,0,784,69,715
360450619003,36, New York,045, Jefferson County,267,112,102,0,10,0,0,0,0,0,267,112,102,0,10,873,72,801
360450621001,36, New York,045, Jefferson County,144,129,15,0,114,0,0,0,0,0,144,129,15,0,114,1051,438,613
360450621002,36, New York,045, Jefferson County,395,255,255,0,0,0,0,0,0,0,395,255,255,0,0,1121,95,1026
360450621003,36, New York,045, Jefferson County,102,0,0,0,0,0,0,0,0,0,102,0,0,0,0,843,104,739
360450622001,36, New York,045, Jefferson County,447,323,198,105,20,156,156,79,72,5,291,167,119,33,15,1028,291,737
360450622002,36, New York,045, Jefferson County,197,75,52,13,10,13,13,0,13,0,184,62,52,0,10,628,128,500
360450622003,36, New York,045, Jefferson County,300,111,71,19,21,12,12,0,12,0,288,99,71,7,21,883,71,812
360450622004,36, New York,045, Jefferson County,235,107,62,16,29,29,29,0,0,29,206,78,62,16,0,702,135,567
360450624001,36, New York,045, Jefferson County,387,171,132,8,31,22,9,6,0,3,365,162,126,8,28,1063,66,997
360450624002,36, New York,045, Jefferson County,478,213,92,98,23,42,35,0,35,0,436,178,92,63,23,1247,115,1132
360450624003,36, New York,045, Jefferson County,385,146,94,39,13,0,0,0,0,0,385,146,94,39,13,1009,18,991
360450625001,36, New York,045, Jefferson County,263,119,109,0,10,11,8,0,0,8,252,111,109,0,2,656,26,630
360450625002,36, New York,045, Jefferson County,388,204,168,26,10,26,16,0,11,5,362,188,168,15,5,914,92,822
360450625003,36, New York,045, Jefferson County,233,95,64,4,27,15,7,0,0,7,218,88,64,4,20,622,51,571
360459800001,36, New York,045, Jefferson County,0,0,0,0,0,0,0,0,0,0,0,0,0,0,0,0,0,0
360459900010,36, New York,045, Jefferson County,0,0,0,0,0,0,0,0,0,0,0,0,0,0,0,0,0,0
360499501011,36, New York,049, Lewis County,533,279,232,24,23,51,32,24,2,6,482,247,208,22,17,1299,133,1166
360499501012,36, New York,049, Lewis County,135,59,28,15,16,12,10,9,0,1,123,49,19,15,15,507,34,473
360499502001,36, New York,049, Lewis County,550,261,227,5,29,64,44,19,0,25,486,217,208,5,4,1674,284,1390
360499502002,36, New York,049, Lewis County,312,133,64,47,22,32,30,2,16,12,280,103,62,31,10,941,104,837
360499502003,36, New York,049, Lewis County,282,126,112,14,0,19,10,10,0,0,263,116,102,14,0,647,50,597
360499503011,36, New York,049, Lewis County,457,153,117,19,17,2,2,0,0,2,455,151,117,19,15,1142,47,1095
360499503012,36, New York,049, Lewis County,203,57,57,0,0,44,0,0,0,0,159,57,57,0,0,657,100,557
360499503013,36, New York,049, Lewis County,306,209,99,16,94,53,53,11,0,42,253,156,88,16,52,905,156,749
360499503021,36, New York,049, Lewis County,557,265,231,21,13,61,51,34,4,13,496,214,197,17,0,1533,195,1338
360499503022,36, New York,049, Lewis County,558,167,113,22,32,89,75,41,7,27,469,92,72,15,5,1648,220,1428
360499504011,36, New York,049, Lewis County,251,115,93,3,19,14,3,0,2,1,237,112,93,1,18,721,80,641
360499504012,36, New York,049, Lewis County,471,177,146,15,16,24,21,10,11,0,447,156,136,4,16,1208,97,1111
360499505001,36, New York,049, Lewis County,265,98,75,8,15,17,1,1,0,0,248,97,74,8,15,753,57,696
360499505002,36, New York,049, Lewis County,439,196,106,27,63,43,35,2,0,33,396,161,104,27,30,1148,116,1032
360499506011,36, New York,049, Lewis County,174,108,57,39,12,18,18,6,12,0,156,90,51,27,12,499,98,401
360499506012,36, New York,049, Lewis County,141,47,29,0,18,18,12,0,0,12,123,35,29,0,6,403,42,361
360499507001,36, New York,049, Lewis County,273,177,107,20,50,40,33,23,0,10,233,144,84,20,40,756,152,604
360499507002,36, New York,049, Lewis County,355,134,91,13,30,22,15,8,0,7,333,119,83,13,23,1027,76,951
360499507003,36, New York,049, Lewis County,198,89,38,41,10,0,0,0,0,0,198,89,38,41,10,571,2,569
360499507004,36, New York,049, Lewis County,350,158,115,23,20,24,20,0,16,4,326,138,115,7,16,920,69,851
360499507005,36, New York,049, Lewis County,243,120,81,4,35,20,10,10,0,0,223,110,71,4,35,602,92,510
360499508001,36, New York,049, Lewis County,243,53,38,3,12,24,9,0,3,6,219,44,38,0,6,724,93,631
360630201001,36, New York,063, Niagara County,156,38,22,0,16,0,0,0,0,0,156,38,22,0,16,721,27,694
360630201002,36, New York,063, Niagara County,81,44,17,15,12,18,10,0,0,10,63,34,17,15,2,346,95,251
360630201003,36, New York,063, Niagara County,331,127,115,12,0,24,15,15,0,0,307,112,100,12,0,1003,267,736
360630201004,36, New York,063, Niagara County,241,111,90,12,9,0,0,0,0,0,241,111,90,12,9,590,11,579
360630202001,36, New York,063, Niagara County,418,306,2,7,297,218,166,2,0,164,200,140,0,7,133,1014,498,516
360630202002,36, New York,063, Niagara County,217,144,27,0,117,213,140,23,0,117,4,4,4,0,0,729,432,297
360630203001,36, New York,063, Niagara County,24,17,0,0,17,24,17,0,0,17,0,0,0,0,0,114,107,7
360630203002,36, New York,063, Niagara County,177,95,48,28,19,14,14,0,0,14,163,81,48,28,5,538,60,478
360630203003,36, New York,063, Niagara County,341,157,95,0,62,13,0,0,0,0,328,157,95,0,62,973,88,885
360630204001,36, New York,063, Niagara County,226,112,20,44,48,48,48,0,0,48,178,64,20,44,0,622,102,520
360630204002,36, New York,063, Niagara County,210,81,25,39,17,15,3,0,0,3,195,78,25,39,14,547,70,477
360630205001,36, New York,063, Niagara County,185,29,13,0,16,0,0,0,0,0,185,29,13,0,16,1174,363,811
360630205002,36, New York,063, Niagara County,168,96,0,24,72,62,62,0,0,62,106,34,0,24,10,586,215,371
360630206001,36, New York,063, Niagara County,124,104,44,48,12,35,24,0,24,0,89,80,44,24,12,376,138,238
360630206002,36, New York,063, Niagara County,215,131,104,0,27,15,15,15,0,0,200,116,89,0,27,667,78,589
360630207001,36, New York,063, Niagara County,179,38,9,0,29,29,29,0,0,29,150,9,9,0,0,650,119,531
360630207002,36, New York,063, Niagara County,166,57,0,8,49,0,0,0,0,0,166,57,0,8,49,538,107,431
360630207003,36, New York,063, Niagara County,262,121,31,0,90,107,107,17,0,90,155,14,14,0,0,782,206,576
360630209001,36, New York,063, Niagara County,80,65,44,21,0,0,0,0,0,0,80,65,44,21,0,259,51,208
360630209002,36, New York,063, Niagara County,67,35,9,0,26,9,9,9,0,0,58,26,0,0,26,726,330,396
360630209003,36, New York,063, Niagara County,418,320,35,0,285,329,276,35,0,241,89,44,0,0,44,819,558,261
360630210001,36, New York,063, Niagara County,97,26,9,7,10,9,9,9,0,0,88,17,0,7,10,536,29,507
360630210002,36, New York,063, Niagara County,226,123,110,0,13,20,13,0,0,13,206,110,110,0,0,810,37,773
360630210003,36, New York,063, Niagara County,94,48,24,24,0,48,48,24,24,0,46,0,0,0,0,624,153,471
360630210004,36, New York,063, Niagara County,70,36,2,0,34,20,20,2,0,18,50,16,0,0,16,303,134,169
360630211001,36, New York,063, Niagara County,33,9,9,0,0,9,9,9,0,0,24,0,0,0,0,375,89,286
360630211002,36, New York,063, Niagara County,303,189,0,83,106,181,172,0,70,102,122,17,0,13,4,752,293,459
360630212001,36, New York,063, Niagara County,44,38,38,0,0,0,0,0,0,0,44,38,38,0,0,249,99,150
360630212002,36, New York,063, Niagara County,91,76,76,0,0,0,0,0,0,0,91,76,76,0,0,307,61,246
360630212003,36, New York,063, Niagara County,0,0,0,0,0,0,0,0,0,0,0,0,0,0,0,9,9,0
360630212004,36, New York,063, Niagara County,326,198,119,69,10,69,69,0,69,0,257,129,119,0,10,1065,224,841
360630213001,36, New York,063, Niagara County,232,132,22,15,95,125,116,6,15,95,107,16,16,0,0,728,231,497
360630213002,36, New York,063, Niagara County,242,119,30,8,81,108,68,18,0,50,134,51,12,8,31,1035,541,494
360630214001,36, New York,063, Niagara County,245,85,18,27,40,54,33,4,0,29,191,52,14,27,11,752,82,670
360630214002,36, New York,063, Niagara County,289,112,33,12,67,31,15,0,0,15,258,97,33,12,52,896,115,781
360630217001,36, New York,063, Niagara County,206,157,1,12,144,55,55,0,0,55,151,102,1,12,89,347,77,270
360630217002,36, New York,063, Niagara County,192,152,8,25,119,32,32,0,25,7,160,120,8,0,112,595,95,500
360630217003,36, New York,063, Niagara County,163,40,11,0,29,11,11,11,0,0,152,29,0,0,29,512,89,423
360630217004,36, New York,063, Niagara County,182,151,16,64,71,37,37,0,26,11,145,114,16,38,60,512,135,377
360630217005,36, New York,063, Niagara County,107,58,23,35,0,35,35,0,35,0,72,23,23,0,0,426,66,360
360630220001,36, New York,063, Niagara County,225,149,33,24,92,67,67,11,0,56,158,82,22,24,36,550,80,470
360630220002,36, New York,063, Niagara County,129,73,14,10,49,0,0,0,0,0,129,73,14,10,49,511,84,427
360630220003,36, New York,063, Niagara County,232,73,23,11,39,20,10,0,0,10,212,63,23,11,29,584,73,511
360630220004,36, New York,063, Niagara County,232,171,115,0,56,39,34,0,0,34,193,137,115,0,22,798,185,613
360630221001,36, New York,063, Niagara County,203,127,127,0,0,7,0,0,0,0,196,127,127,0,0,593,43,550
360630221002,36, New York,063, Niagara County,203,56,0,27,29,28,0,0,0,0,175,56,0,27,29,487,64,423
360630221003,36, New York,063, Niagara County,154,71,43,0,28,29,0,0,0,0,125,71,43,0,28,521,82,439
360630222001,36, New York,063, Niagara County,520,206,62,0,144,139,112,0,0,112,381,94,62,0,32,1454,290,1164
360630222002,36, New York,063, Niagara County,252,13,13,0,0,10,0,0,0,0,242,13,13,0,0,724,55,669
360630222003,36, New York,063, Niagara County,340,84,51,15,18,11,0,0,0,0,329,84,51,15,18,858,28,830
360630223001,36, New York,063, Niagara County,187,109,38,0,71,19,5,5,0,0,168,104,33,0,71,378,40,338
360630223002,36, New York,063, Niagara County,153,104,70,0,34,0,0,0,0,0,153,104,70,0,34,454,17,437
360630223003,36, New York,063, Niagara County,234,66,66,0,0,0,0,0,0,0,234,66,66,0,0,959,48,911
360630224011,36, New York,063, Niagara County,296,114,69,0,45,28,28,8,0,20,268,86,61,0,25,926,70,856
360630224012,36, New York,063, Niagara County,217,105,64,0,41,0,0,0,0,0,217,105,64,0,41,640,3,637
360630225001,36, New York,063, Niagara County,299,58,8,6,44,8,8,0,0,8,291,50,8,6,36,1026,86,940
360630225002,36, New York,063, Niagara County,190,78,41,0,37,10,10,0,0,10,180,68,41,0,27,468,51,417
360630225003,36, New York,063, Niagara County,210,71,50,0,21,10,0,0,0,0,200,71,50,0,21,586,27,559
360630226011,36, New York,063, Niagara County,438,155,114,0,41,30,16,0,0,16,408,139,114,0,25,1246,100,1146
360630226012,36, New York,063, Niagara County,205,55,25,16,14,26,9,0,9,0,179,46,25,7,14,673,101,572
360630226021,36, New York,063, Niagara County,649,149,135,14,0,29,0,0,0,0,620,149,135,14,0,1701,93,1608
360630226022,36, New York,063, Niagara County,528,91,0,34,57,71,71,0,14,57,457,20,0,20,0,1705,334,1371
360630226023,36, New York,063, Niagara County,480,238,76,107,55,126,98,33,10,55,354,140,43,97,0,1293,422,871
360630227021,36, New York,063, Niagara County,243,120,103,0,17,0,0,0,0,0,243,120,103,0,17,659,0,659
360630227022,36, New York,063, Niagara County,570,214,164,38,12,10,0,0,0,0,560,214,164,38,12,1416,47,1369
360630227023,36, New York,063, Niagara County,764,342,282,24,36,40,0,0,0,0,724,342,282,24,36,1773,102,1671
360630227024,36, New York,063, Niagara County,570,194,119,21,54,14,0,0,0,0,556,194,119,21,54,1518,27,1491
360630227131,36, New York,063, Niagara County,477,163,153,0,10,0,0,0,0,0,477,163,153,0,10,1153,19,1134
360630227132,36, New York,063, Niagara County,425,239,94,101,44,0,0,0,0,0,425,239,94,101,44,1373,27,1346
360630227141,36, New York,063, Niagara County,258,79,63,0,16,0,0,0,0,0,258,79,63,0,16,891,70,821
360630227142,36, New York,063, Niagara County,170,67,67,0,0,0,0,0,0,0,170,67,67,0,0,788,124,664
360630227143,36, New York,063, Niagara County,701,290,180,67,43,0,0,0,0,0,701,290,180,67,43,1733,8,1725
360630227151,36, New York,063, Niagara County,231,31,14,0,17,5,0,0,0,0,226,31,14,0,17,547,15,532
360630227152,36, New York,063, Niagara County,432,258,226,23,9,0,0,0,0,0,432,258,226,23,9,1166,34,1132
360630227161,36, New York,063, Niagara County,422,170,161,0,9,9,9,0,0,9,413,161,161,0,0,1284,52,1232
360630227162,36, New York,063, Niagara County,636,219,144,0,75,66,0,0,0,0,570,219,144,0,75,1511,132,1379
360630227171,36, New York,063, Niagara County,507,284,189,71,24,50,50,0,26,24,457,234,189,45,0,1277,79,1198
360630227172,36, New York,063, Niagara County,575,254,64,0,190,12,0,0,0,0,563,254,64,0,190,1556,110,1446
360630227173,36, New York,063, Niagara County,389,258,174,0,84,59,59,0,0,59,330,199,174,0,25,867,83,784
360630228031,36, New York,063, Niagara County,431,121,105,0,16,0,0,0,0,0,431,121,105,0,16,1158,93,1065
360630228032,36, New York,063, Niagara County,559,214,188,0,26,0,0,0,0,0,559,214,188,0,26,1521,51,1470
360630228041,36, New York,063, Niagara County,401,80,45,15,20,8,8,0,8,0,393,72,45,7,20,1211,29,1182
360630228042,36, New York,063, Niagara County,533,190,116,18,56,6,0,0,0,0,527,190,116,18,56,1650,67,1583
360630229011,36, New York,063, Niagara County,371,208,149,0,59,78,78,48,0,30,293,130,101,0,29,1051,194,857
360630229012,36, New York,063, Niagara County,278,106,69,0,37,15,0,0,0,0,263,106,69,0,37,827,84,743
360630229021,36, New York,063, Niagara County,351,112,80,10,22,0,0,0,0,0,351,112,80,10,22,946,30,916
360630229022,36, New York,063, Niagara County,447,110,84,7,19,7,7,0,0,7,440,103,84,7,12,1249,18,1231
360630230011,36, New York,063, Niagara County,520,249,51,42,156,58,58,0,0,58,462,191,51,42,98,1734,365,1369
360630231001,36, New York,063, Niagara County,87,22,22,0,0,0,0,0,0,0,87,22,22,0,0,314,35,279
360630231002,36, New York,063, Niagara County,481,169,93,18,58,129,19,19,0,0,352,150,74,18,58,1643,384,1259
360630232001,36, New York,063, Niagara County,487,224,165,0,59,60,35,0,0,35,427,189,165,0,24,1202,156,1046
360630232002,36, New York,063, Niagara County,192,35,22,0,13,12,12,12,0,0,180,23,10,0,13,821,99,722
360630232003,36, New York,063, Niagara County,11,11,11,0,0,0,0,0,0,0,11,11,11,0,0,387,97,290
360630233011,36, New York,063, Niagara County,77,35,35,0,0,0,0,0,0,0,77,35,35,0,0,534,80,454
360630233012,36, New York,063, Niagara County,692,179,132,33,14,15,0,0,0,0,677,179,132,33,14,1894,46,1848
360630233021,36, New York,063, Niagara County,399,190,76,27,87,81,81,23,27,31,318,109,53,0,56,1091,276,815
360630233022,36, New York,063, Niagara County,549,282,181,25,76,25,25,0,25,0,524,257,181,0,76,1572,59,1513
360630234011,36, New York,063, Niagara County,588,119,86,26,7,34,0,0,0,0,554,119,86,26,7,1625,189,1436
360630234012,36, New York,063, Niagara County,417,178,138,0,40,12,0,0,0,0,405,178,138,0,40,1150,39,1111
360630234013,36, New York,063, Niagara County,353,148,35,66,47,61,61,0,14,47,292,87,35,52,0,1068,260,808
360630234014,36, New York,063, Niagara County,417,196,142,0,54,29,29,0,0,29,388,167,142,0,25,1377,127,1250
360630234021,36, New York,063, Niagara County,641,141,141,0,0,0,0,0,0,0,641,141,141,0,0,1749,17,1732
360630234022,36, New York,063, Niagara County,799,301,222,28,51,8,0,0,0,0,791,301,222,28,51,2021,48,1973
360630234041,36, New York,063, Niagara County,419,149,83,0,66,12,12,0,0,12,407,137,83,0,54,1078,35,1043
360630234042,36, New York,063, Niagara County,647,415,369,27,19,30,19,0,19,0,617,396,369,8,19,1826,95,1731
360630234043,36, New York,063, Niagara County,198,81,25,24,32,19,19,0,0,19,179,62,25,24,13,889,83,806
360630234051,36, New York,063, Niagara County,305,108,41,43,24,14,14,14,0,0,291,94,27,43,24,1637,248,1389
360630234052,36, New York,063, Niagara County,561,319,198,8,113,0,0,0,0,0,561,319,198,8,113,1654,63,1591
360630235001,36, New York,063, Niagara County,276,183,71,74,38,36,27,9,0,18,240,156,62,74,20,787,85,702
360630235002,36, New York,063, Niagara County,71,18,18,0,0,0,0,0,0,0,71,18,18,0,0,293,49,244
360630235003,36, New York,063, Niagara County,218,93,49,16,28,28,28,0,0,28,190,65,49,16,0,765,135,630
360630236001,36, New York,063, Niagara County,497,294,189,0,105,112,101,36,0,65,385,193,153,0,40,1496,279,1217
360630236002,36, New York,063, Niagara County,86,38,13,0,25,25,25,0,0,25,61,13,13,0,0,259,28,231
360630236003,36, New York,063, Niagara County,402,332,120,98,114,53,45,0,9,36,349,287,120,89,78,1101,79,1022
360630237001,36, New York,063, Niagara County,225,137,42,64,31,29,11,0,0,11,196,126,42,64,20,735,192,543
360630237002,36, New York,063, Niagara County,214,167,82,0,85,110,72,51,0,21,104,95,31,0,64,733,323,410
360630238001,36, New York,063, Niagara County,185,101,21,22,58,87,78,12,8,58,98,23,9,14,0,487,116,371
360630238002,36, New York,063, Niagara County,235,85,23,0,62,101,42,0,0,42,134,43,23,0,20,804,159,645
360630238003,36, New York,063, Niagara County,406,233,115,91,27,0,0,0,0,0,406,233,115,91,27,1206,58,1148
360630239011,36, New York,063, Niagara County,462,237,154,0,83,20,9,0,0,9,442,228,154,0,74,1445,90,1355
360630239012,36, New York,063, Niagara County,138,85,0,28,57,13,13,0,0,13,125,72,0,28,44,392,63,329
360630239013,36, New York,063, Niagara County,264,132,115,0,17,12,12,0,0,12,252,120,115,0,5,657,40,617
360630239014,36, New York,063, Niagara County,199,72,52,0,20,0,0,0,0,0,199,72,52,0,20,700,125,575
360630239021,36, New York,063, Niagara County,194,51,34,0,17,0,0,0,0,0,194,51,34,0,17,597,13,584
360630239022,36, New York,063, Niagara County,571,349,61,70,218,57,57,0,0,57,514,292,61,70,161,1921,166,1755
360630239023,36, New York,063, Niagara County,500,138,107,12,19,27,14,14,0,0,473,124,93,12,19,1310,90,1220
360630240011,36, New York,063, Niagara County,488,123,123,0,0,54,16,16,0,0,434,107,107,0,0,1220,111,1109
360630240012,36, New York,063, Niagara County,145,12,12,0,0,0,0,0,0,0,145,12,12,0,0,439,33,406
360630240013,36, New York,063, Niagara County,238,90,76,14,0,0,0,0,0,0,238,90,76,14,0,684,0,684
360630240014,36, New York,063, Niagara County,415,219,200,0,19,0,0,0,0,0,415,219,200,0,19,1410,0,1410
360630240015,36, New York,063, Niagara County,316,130,62,0,68,0,0,0,0,0,316,130,62,0,68,895,34,861
360630240021,36, New York,063, Niagara County,502,251,153,12,86,57,52,29,3,20,445,199,124,9,66,1466,143,1323
360630241011,36, New York,063, Niagara County,401,213,133,35,45,29,22,9,13,0,372,191,124,22,45,1060,115,945
360630241012,36, New York,063, Niagara County,676,140,90,12,38,17,11,0,0,11,659,129,90,12,27,1880,54,1826
360630241021,36, New York,063, Niagara County,149,100,75,12,13,19,19,19,0,0,130,81,56,12,13,470,136,334
360630241022,36, New York,063, Niagara County,345,171,136,11,24,30,23,16,0,7,315,148,120,11,17,885,73,812
360630241023,36, New York,063, Niagara County,355,182,140,30,12,16,16,16,0,0,339,166,124,30,12,888,67,821
360630242011,36, New York,063, Niagara County,372,176,171,0,5,0,0,0,0,0,372,176,171,0,5,1147,73,1074
360630242012,36, New York,063, Niagara County,560,317,242,64,11,12,0,0,0,0,548,317,242,64,11,1803,131,1672
360630242013,36, New York,063, Niagara County,532,315,231,17,67,41,41,24,17,0,491,274,207,0,67,1247,118,1129
360630242014,36, New York,063, Niagara County,295,164,53,24,87,15,15,0,0,15,280,149,53,24,72,730,69,661
360630242021,36, New York,063, Niagara County,210,94,73,0,21,0,0,0,0,0,210,94,73,0,21,614,10,604
360630242022,36, New York,063, Niagara County,242,111,70,24,17,9,9,0,0,9,233,102,70,24,8,830,9,821
360630242023,36, New York,063, Niagara County,209,49,27,0,22,0,0,0,0,0,209,49,27,0,22,707,29,678
360630243011,36, New York,063, Niagara County,402,168,78,39,51,84,13,0,0,13,318,155,78,39,38,1095,276,819
360630243021,36, New York,063, Niagara County,376,145,123,0,22,0,0,0,0,0,376,145,123,0,22,962,8,954
360630243022,36, New York,063, Niagara County,279,85,72,0,13,0,0,0,0,0,279,85,72,0,13,807,11,796
360630243023,36, New York,063, Niagara County,642,244,191,0,53,19,0,0,0,0,623,244,191,0,53,1792,150,1642
360630243031,36, New York,063, Niagara County,389,123,123,0,0,15,0,0,0,0,374,123,123,0,0,971,46,925
360630243032,36, New York,063, Niagara County,661,155,139,0,16,0,0,0,0,0,661,155,139,0,16,1713,131,1582
360630243033,36, New York,063, Niagara County,567,223,173,0,50,0,0,0,0,0,567,223,173,0,50,1919,30,1889
360630244011,36, New York,063, Niagara County,192,38,27,0,11,0,0,0,0,0,192,38,27,0,11,992,87,905
360630244012,36, New York,063, Niagara County,183,84,54,19,11,19,11,0,0,11,164,73,54,19,0,556,51,505
360630244013,36, New York,063, Niagara County,209,42,42,0,0,0,0,0,0,0,209,42,42,0,0,416,7,409
360630244041,36, New York,063, Niagara County,522,208,125,10,73,0,0,0,0,0,522,208,125,10,73,1561,91,1470
360630244042,36, New York,063, Niagara County,281,135,80,44,11,12,0,0,0,0,269,135,80,44,11,793,65,728
360630244043,36, New York,063, Niagara County,319,49,37,0,12,0,0,0,0,0,319,49,37,0,12,940,14,926
360630244051,36, New York,063, Niagara County,452,140,83,16,41,0,0,0,0,0,452,140,83,16,41,1058,0,1058
360630244052,36, New York,063, Niagara County,607,200,137,0,63,46,46,0,0,46,561,154,137,0,17,1654,16,1638
360630244053,36, New York,063, Niagara County,546,194,185,0,9,96,96,96,0,0,450,98,89,0,9,1657,417,1240
360630244061,36, New York,063, Niagara County,75,24,24,0,0,29,18,18,0,0,46,6,6,0,0,192,73,119
360630244062,36, New York,063, Niagara County,363,110,83,8,19,9,5,5,0,0,354,105,78,8,19,1015,88,927
360630244063,36, New York,063, Niagara County,199,96,55,19,22,5,5,0,0,5,194,91,55,19,17,531,14,517
360630245011,36, New York,063, Niagara County,474,220,161,0,59,36,30,24,0,6,438,190,137,0,53,1144,82,1062
360630245012,36, New York,063, Niagara County,369,126,71,0,55,18,10,0,0,10,351,116,71,0,45,899,67,832
360630245021,36, New York,063, Niagara County,415,222,211,0,11,0,0,0,0,0,415,222,211,0,11,1066,4,1062
360630245022,36, New York,063, Niagara County,393,96,63,0,33,51,36,10,0,26,342,60,53,0,7,1128,111,1017
360630245023,36, New York,063, Niagara County,359,140,60,12,68,0,0,0,0,0,359,140,60,12,68,882,17,865
360630246001,36, New York,063, Niagara County,623,233,206,16,11,51,0,0,0,0,572,233,206,16,11,1906,231,1675
360630246002,36, New York,063, Niagara County,173,8,8,0,0,16,0,0,0,0,157,8,8,0,0,647,55,592
360630246003,36, New York,063, Niagara County,478,166,166,0,0,32,32,32,0,0,446,134,134,0,0,1237,69,1168
360639400011,36, New York,063, Niagara County,0,0,0,0,0,0,0,0,0,0,0,0,0,0,0,134,29,105
360639400012,36, New York,063, Niagara County,193,113,39,0,74,39,39,39,0,0,154,74,0,0,74,323,0,323
360639401001,36, New York,063, Niagara County,0,0,0,0,0,0,0,0,0,0,0,0,0,0,0,0,0,0
360639900000,36, New York,063, Niagara County,0,0,0,0,0,0,0,0,0,0,0,0,0,0,0,0,0,0
361150801001,36, New York,115, Washington County,294,65,27,38,0,0,0,0,0,0,294,65,27,38,0,960,29,931
361150801002,36, New York,115, Washington County,119,28,28,0,0,0,0,0,0,0,119,28,28,0,0,736,17,719
361150801003,36, New York,115, Washington County,477,228,44,86,98,121,121,23,0,98,356,107,21,86,0,1454,312,1142
361150801004,36, New York,115, Washington County,276,164,29,115,20,54,42,0,22,20,222,122,29,93,0,1043,415,628
361150802001,36, New York,115, Washington County,320,147,82,39,26,4,0,0,0,0,316,147,82,39,26,908,62,846
361150802002,36, New York,115, Washington County,230,131,123,0,8,0,0,0,0,0,230,131,123,0,8,930,74,856
361150803011,36, New York,115, Washington County,267,92,21,0,71,56,56,0,0,56,211,36,21,0,15,1319,316,1003
361150803012,36, New York,115, Washington County,383,242,187,46,9,24,0,0,0,0,359,242,187,46,9,1174,160,1014
361150803021,36, New York,115, Washington County,313,66,55,11,0,0,0,0,0,0,313,66,55,11,0,925,14,911
361150803022,36, New York,115, Washington County,148,56,0,21,35,24,24,0,0,24,124,32,0,21,11,529,44,485
361150803023,36, New York,115, Washington County,212,73,73,0,0,14,0,0,0,0,198,73,73,0,0,451,40,411
361150810011,36, New York,115, Washington County,269,123,88,10,25,36,25,0,0,25,233,98,88,10,0,995,104,891
361150810012,36, New York,115, Washington County,220,91,91,0,0,0,0,0,0,0,220,91,91,0,0,617,17,600
361150810021,36, New York,115, Washington County,0,0,0,0,0,0,0,0,0,0,0,0,0,0,0,0,0,0
361150810022,36, New York,115, Washington County,284,124,103,7,14,14,0,0,0,0,270,124,103,7,14,853,35,818
361150810023,36, New York,115, Washington County,175,34,26,8,0,12,12,12,0,0,163,22,14,8,0,528,83,445
361150820011,36, New York,115, Washington County,198,145,121,24,0,17,17,0,17,0,181,128,121,7,0,851,51,800
361150820012,36, New York,115, Washington County,226,100,26,4,70,49,43,0,0,43,177,57,26,4,27,842,158,684
361150820013,36, New York,115, Washington County,291,78,72,6,0,0,0,0,0,0,291,78,72,6,0,698,11,687
361150820014,36, New York,115, Washington County,135,76,41,0,35,39,33,11,0,22,96,43,30,0,13,512,199,313
361150820015,36, New York,115, Washington County,297,108,42,34,32,43,32,4,0,28,254,76,38,34,4,926,105,821
361150820021,36, New York,115, Washington County,154,29,25,4,0,11,1,1,0,0,143,28,24,4,0,448,35,413
361150820022,36, New York,115, Washington County,184,64,30,8,26,26,17,0,0,17,158,47,30,8,9,453,37,416
361150840011,36, New York,115, Washington County,463,217,192,13,12,52,0,0,0,0,411,217,192,13,12,1411,134,1277
361150840012,36, New York,115, Washington County,331,94,42,15,37,16,11,0,0,11,315,83,42,15,26,974,141,833
361150840021,36, New York,115, Washington County,354,113,80,0,33,0,0,0,0,0,354,113,80,0,33,1030,15,1015
361150840022,36, New York,115, Washington County,483,272,138,20,114,151,132,12,14,106,332,140,126,6,8,1533,286,1247
361150850001,36, New York,115, Washington County,200,86,58,28,0,7,0,0,0,0,193,86,58,28,0,548,22,526
361150850002,36, New York,115, Washington County,356,126,93,9,24,32,28,4,0,24,324,98,89,9,0,1032,116,916
361150860001,36, New York,115, Washington County,177,54,37,3,14,25,22,11,1,10,152,32,26,2,4,586,106,480
361150860002,36, New York,115, Washington County,267,80,63,4,13,24,0,0,0,0,243,80,63,4,13,878,139,739
361150870001,36, New York,115, Washington County,300,168,110,0,58,46,46,17,0,29,254,122,93,0,29,1126,108,1018
361150870002,36, New York,115, Washington County,317,85,59,6,20,28,3,0,0,3,289,82,59,6,17,930,75,855
361150870003,36, New York,115, Washington County,263,147,101,42,4,10,10,6,0,4,253,137,95,42,0,726,23,703
361150880011,36, New York,115, Washington County,188,87,41,14,32,0,0,0,0,0,188,87,41,14,32,728,52,676
361150880012,36, New York,115, Washington County,475,190,0,26,164,5,5,0,0,5,470,185,0,26,159,1284,182,1102
361150880021,36, New York,115, Washington County,335,117,38,49,30,17,0,0,0,0,318,117,38,49,30,1080,96,984
361150880022,36, New York,115, Washington County,338,111,83,14,14,0,0,0,0,0,338,111,83,14,14,842,10,832
361150880023,36, New York,115, Washington County,227,104,18,0,86,62,62,0,0,62,165,42,18,0,24,728,132,596
361150890001,36, New York,115, Washington County,600,234,162,0,72,65,49,0,0,49,535,185,162,0,23,2039,195,1844
361150890002,36, New York,115, Washington County,327,132,102,22,8,6,3,3,0,0,321,129,99,22,8,977,100,877
361150890003,36, New York,115, Washington County,320,88,68,6,14,13,0,0,0,0,307,88,68,6,14,915,54,861
361150900001,36, New York,115, Washington County,331,122,105,0,17,46,24,19,0,5,285,98,86,0,12,1013,176,837
361150900002,36, New York,115, Washington County,108,38,6,0,32,0,0,0,0,0,108,38,6,0,32,463,16,447
361150900003,36, New York,115, Washington County,158,58,19,3,36,18,7,0,0,7,140,51,19,3,29,705,71,634
361150910001,36, New York,115, Washington County,255,71,36,15,20,14,11,4,0,7,241,60,32,15,13,726,43,683
361150910002,36, New York,115, Washington County,255,77,54,0,23,7,4,4,0,0,248,73,50,0,23,682,62,620
361150920001,36, New York,115, Washington County,427,193,89,18,86,8,8,0,0,8,419,185,89,18,78,1413,168,1245
361150920002,36, New York,115, Washington County,447,125,106,0,19,28,19,0,0,19,419,106,106,0,0,1225,73,1152
361150930001,36, New York,115, Washington County,188,44,33,11,0,0,0,0,0,0,188,44,33,11,0,604,7,597
361150930002,36, New York,115, Washington County,297,142,76,51,15,39,29,23,0,6,258,113,53,51,9,872,138,734
361150940001,36, New York,115, Washington County,262,104,77,8,19,4,4,4,0,0,258,100,73,8,19,776,39,737
361150940002,36, New York,115, Washington County,379,66,48,8,10,4,4,4,0,0,375,62,44,8,10,1078,20,1058
360099400001,36, New York,009, Cattaraugus County,22,12,3,0,9,3,3,0,0,3,19,9,3,0,6,80,6,74
360099400002,36, New York,009, Cattaraugus County,10,10,0,5,5,0,0,0,0,0,10,10,0,5,5,29,4,25
360099402001,36, New York,009, Cattaraugus County,0,0,0,0,0,0,0,0,0,0,0,0,0,0,0,0,0,0
360099403011,36, New York,009, Cattaraugus County,228,126,48,40,38,82,56,4,20,32,146,70,44,20,6,674,198,476
360099403012,36, New York,009, Cattaraugus County,349,195,62,32,101,117,72,14,17,41,232,123,48,15,60,983,337,646
360099403013,36, New York,009, Cattaraugus County,88,39,6,12,21,21,17,3,0,14,67,22,3,12,7,223,44,179
360099403021,36, New York,009, Cattaraugus County,318,172,61,11,100,45,26,0,0,26,273,146,61,11,74,1077,185,892
360099403022,36, New York,009, Cattaraugus County,377,199,80,40,79,59,50,4,15,31,318,149,76,25,48,1217,262,955
360099403023,36, New York,009, Cattaraugus County,109,49,27,8,14,9,9,7,0,2,100,40,20,8,12,320,45,275
360099601001,36, New York,009, Cattaraugus County,261,91,73,0,18,3,0,0,0,0,258,91,73,0,18,875,81,794
360099601002,36, New York,009, Cattaraugus County,446,205,177,24,4,30,30,18,12,0,416,175,159,12,4,1202,136,1066
360099601003,36, New York,009, Cattaraugus County,269,77,47,9,21,45,32,23,9,0,224,45,24,0,21,704,123,581
360099602001,36, New York,009, Cattaraugus County,180,94,59,17,18,14,14,0,8,6,166,80,59,9,12,572,118,454
360099602002,36, New York,009, Cattaraugus County,417,267,75,41,151,169,156,2,10,144,248,111,73,31,7,966,235,731
360099602003,36, New York,009, Cattaraugus County,316,118,64,0,54,34,34,16,0,18,282,84,48,0,36,957,147,810
360099602004,36, New York,009, Cattaraugus County,361,121,52,26,43,63,49,10,0,39,298,72,42,26,4,964,143,821
360099603001,36, New York,009, Cattaraugus County,408,126,105,10,11,36,31,20,0,11,372,95,85,10,0,1165,124,1041
360099603002,36, New York,009, Cattaraugus County,322,110,86,0,24,5,0,0,0,0,317,110,86,0,24,954,39,915
360099603003,36, New York,009, Cattaraugus County,201,65,51,3,11,4,4,4,0,0,197,61,47,3,11,596,55,541
360099603004,36, New York,009, Cattaraugus County,321,103,71,21,11,15,6,2,4,0,306,97,69,17,11,967,59,908
360099604001,36, New York,009, Cattaraugus County,220,93,50,32,11,0,0,0,0,0,220,93,50,32,11,775,66,709
360099604002,36, New York,009, Cattaraugus County,292,154,74,28,52,21,21,0,0,21,271,133,74,28,31,875,114,761
360099604003,36, New York,009, Cattaraugus County,374,144,61,43,40,50,13,4,0,9,324,131,57,43,31,974,163,811
360099604004,36, New York,009, Cattaraugus County,198,65,40,0,25,13,4,0,0,4,185,61,40,0,21,820,166,654
360099605001,36, New York,009, Cattaraugus County,109,21,12,9,0,6,4,4,0,0,103,17,8,9,0,439,66,373
360099605002,36, New York,009, Cattaraugus County,254,128,61,3,64,46,38,11,0,27,208,90,50,3,37,730,149,581
360099605003,36, New York,009, Cattaraugus County,383,263,259,4,0,73,73,73,0,0,310,190,186,4,0,1093,176,917
360099605004,36, New York,009, Cattaraugus County,133,67,63,0,4,4,0,0,0,0,129,67,63,0,4,361,45,316
360099605005,36, New York,009, Cattaraugus County,281,173,70,23,80,33,20,3,8,9,248,153,67,15,71,801,123,678
360099606001,36, New York,009, Cattaraugus County,220,89,68,16,5,3,3,0,0,3,217,86,68,16,2,846,113,733
360099606002,36, New York,009, Cattaraugus County,172,77,60,9,8,16,7,4,3,0,156,70,56,6,8,542,103,439
360099606003,36, New York,009, Cattaraugus County,222,117,60,10,47,54,31,0,3,28,168,86,60,7,19,685,226,459
360099606004,36, New York,009, Cattaraugus County,230,79,48,0,31,5,4,4,0,0,225,75,44,0,31,655,45,610
360099607031,36, New York,009, Cattaraugus County,269,119,80,18,21,0,0,0,0,0,269,119,80,18,21,717,20,697
360099607032,36, New York,009, Cattaraugus County,222,80,36,15,29,13,11,0,0,11,209,69,36,15,18,538,56,482
360099607041,36, New York,009, Cattaraugus County,208,82,61,15,6,29,4,0,0,4,179,78,61,15,2,598,98,500
360099607042,36, New York,009, Cattaraugus County,76,16,2,0,14,0,0,0,0,0,76,16,2,0,14,231,16,215
360099608001,36, New York,009, Cattaraugus County,424,145,67,40,38,40,14,3,7,4,384,131,64,33,34,1167,119,1048
360099608002,36, New York,009, Cattaraugus County,114,36,30,0,6,12,12,10,0,2,102,24,20,0,4,361,39,322
360099608003,36, New York,009, Cattaraugus County,209,146,120,13,13,22,15,12,0,3,187,131,108,13,10,623,68,555
360099608004,36, New York,009, Cattaraugus County,299,146,108,16,22,29,22,8,2,12,270,124,100,14,10,804,104,700
360099610001,36, New York,009, Cattaraugus County,189,79,65,6,8,28,28,14,6,8,161,51,51,0,0,473,76,397
360099610002,36, New York,009, Cattaraugus County,542,233,111,36,86,39,17,0,9,8,503,216,111,27,78,1338,177,1161
360099610003,36, New York,009, Cattaraugus County,361,144,72,32,40,16,16,0,0,16,345,128,72,32,24,1004,76,928
360099610004,36, New York,009, Cattaraugus County,321,99,47,17,35,23,23,0,0,23,298,76,47,17,12,848,66,782
360099611001,36, New York,009, Cattaraugus County,218,74,48,14,12,8,8,5,0,3,210,66,43,14,9,575,24,551
360099611002,36, New York,009, Cattaraugus County,161,41,32,9,0,13,6,6,0,0,148,35,26,9,0,562,150,412
360099611003,36, New York,009, Cattaraugus County,407,147,126,0,21,3,3,3,0,0,404,144,123,0,21,1196,170,1026
360099611004,36, New York,009, Cattaraugus County,351,108,105,0,3,7,4,4,0,0,344,104,101,0,3,1193,194,999
360099612001,36, New York,009, Cattaraugus County,298,113,74,3,36,3,3,0,0,3,295,110,74,3,33,724,16,708
360099612002,36, New York,009, Cattaraugus County,248,157,89,46,22,45,34,0,34,0,203,123,89,12,22,616,106,510
360099612003,36, New York,009, Cattaraugus County,240,104,90,14,0,22,19,9,10,0,218,85,81,4,0,730,87,643
360099612004,36, New York,009, Cattaraugus County,176,81,70,0,11,13,13,13,0,0,163,68,57,0,11,450,73,377
360099613011,36, New York,009, Cattaraugus County,353,128,50,57,21,74,64,0,57,7,279,64,50,0,14,821,110,711
360099613012,36, New York,009, Cattaraugus County,339,125,94,16,15,32,25,13,0,12,307,100,81,16,3,983,110,873
360099613021,36, New York,009, Cattaraugus County,134,67,39,0,28,0,0,0,0,0,134,67,39,0,28,431,82,349
360099613022,36, New York,009, Cattaraugus County,143,44,36,0,8,8,8,0,0,8,135,36,36,0,0,409,31,378
360099614001,36, New York,009, Cattaraugus County,306,97,73,0,24,20,18,3,0,15,286,79,70,0,9,950,90,860
360099614002,36, New York,009, Cattaraugus County,317,183,159,0,24,83,59,47,0,12,234,124,112,0,12,852,233,619
360099614003,36, New York,009, Cattaraugus County,200,72,39,15,18,11,6,0,0,6,189,66,39,15,12,582,38,544
360099614004,36, New York,009, Cattaraugus County,426,120,94,15,11,19,11,0,0,11,407,109,94,15,0,1336,168,1168
360099615001,36, New York,009, Cattaraugus County,232,138,108,13,17,9,9,9,0,0,223,129,99,13,17,730,52,678
360099615002,36, New York,009, Cattaraugus County,362,225,196,10,19,62,19,0,0,19,300,206,196,10,0,952,161,791
360099616001,36, New York,009, Cattaraugus County,121,74,74,0,0,16,0,0,0,0,105,74,74,0,0,422,89,333
360099616002,36, New York,009, Cattaraugus County,118,57,36,0,21,9,0,0,0,0,109,57,36,0,21,462,106,356
360099616003,36, New York,009, Cattaraugus County,407,245,94,106,45,22,22,0,22,0,385,223,94,84,45,1254,194,1060
360099616004,36, New York,009, Cattaraugus County,192,140,68,0,72,59,59,6,0,53,133,81,62,0,19,548,76,472
360099617001,36, New York,009, Cattaraugus County,248,116,19,0,97,97,97,0,0,97,151,19,19,0,0,902,233,669
360099617002,36, New York,009, Cattaraugus County,167,41,32,0,9,51,9,0,0,9,116,32,32,0,0,541,160,381
360099617003,36, New York,009, Cattaraugus County,296,176,93,57,26,162,147,82,45,20,134,29,11,12,6,1027,461,566
360099618001,36, New York,009, Cattaraugus County,193,68,68,0,0,21,0,0,0,0,172,68,68,0,0,709,140,569
360099618002,36, New York,009, Cattaraugus County,158,109,49,0,60,19,0,0,0,0,139,109,49,0,60,546,184,362
360099618003,36, New York,009, Cattaraugus County,210,142,91,8,43,0,0,0,0,0,210,142,91,8,43,700,20,680
360099618004,36, New York,009, Cattaraugus County,151,42,42,0,0,0,0,0,0,0,151,42,42,0,0,392,0,392
360099618005,36, New York,009, Cattaraugus County,114,61,0,0,61,0,0,0,0,0,114,61,0,0,61,348,97,251
360099618006,36, New York,009, Cattaraugus County,382,262,86,121,55,151,128,12,72,44,231,134,74,49,11,782,196,586
360099622001,36, New York,009, Cattaraugus County,187,97,75,0,22,13,13,6,0,7,174,84,69,0,15,416,20,396
360099622002,36, New York,009, Cattaraugus County,199,104,56,14,34,12,12,3,5,4,187,92,53,9,30,600,71,529
360099622003,36, New York,009, Cattaraugus County,271,84,55,14,15,40,16,5,0,11,231,68,50,14,4,815,144,671
360099622004,36, New York,009, Cattaraugus County,148,50,34,9,7,21,17,8,9,0,127,33,26,0,7,451,76,375
361231501011,36, New York,123, Yates County,173,21,21,0,0,16,0,0,0,0,157,21,21,0,0,620,31,589
361231501012,36, New York,123, Yates County,127,55,41,2,12,46,31,19,0,12,81,24,22,2,0,552,142,410
361231501013,36, New York,123, Yates County,285,177,122,7,48,48,48,30,0,18,237,129,92,7,30,823,133,690
361231501014,36, New York,123, Yates County,126,74,62,0,12,44,44,32,0,12,82,30,30,0,0,492,150,342
361231501021,36, New York,123, Yates County,220,91,63,16,12,23,20,18,0,2,197,71,45,16,10,676,128,548
361231501022,36, New York,123, Yates County,213,27,27,0,0,17,0,0,0,0,196,27,27,0,0,581,64,517
361231501023,36, New York,123, Yates County,166,101,101,0,0,35,35,35,0,0,131,66,66,0,0,502,60,442
361231502001,36, New York,123, Yates County,410,212,197,3,12,33,6,6,0,0,377,206,191,3,12,1137,105,1032
361231502002,36, New York,123, Yates County,171,99,48,16,35,21,16,0,0,16,150,83,48,16,19,490,36,454
361231502003,36, New York,123, Yates County,531,215,160,0,55,23,23,0,0,23,508,192,160,0,32,1708,171,1537
361231502004,36, New York,123, Yates County,173,69,0,69,0,16,0,0,0,0,157,69,0,69,0,736,108,628
361231503011,36, New York,123, Yates County,189,42,12,21,9,5,5,0,0,5,184,37,12,21,4,550,38,512
361231503012,36, New York,123, Yates County,330,175,107,14,54,22,16,10,0,6,308,159,97,14,48,1067,73,994
361231503013,36, New York,123, Yates County,156,42,36,3,3,4,0,0,0,0,152,42,36,3,3,502,53,449
361231503021,36, New York,123, Yates County,267,79,54,11,14,20,8,4,0,4,247,71,50,11,10,821,106,715
361231503022,36, New York,123, Yates County,214,91,84,0,7,12,12,12,0,0,202,79,72,0,7,757,117,640
361231504001,36, New York,123, Yates County,237,128,98,0,30,37,37,7,0,30,200,91,91,0,0,694,56,638
361231504002,36, New York,123, Yates County,124,25,25,0,0,0,0,0,0,0,124,25,25,0,0,311,0,311
361231504003,36, New York,123, Yates County,65,8,0,8,0,0,0,0,0,0,65,8,0,8,0,329,41,288
361231504004,36, New York,123, Yates County,200,79,79,0,0,24,24,24,0,0,176,55,55,0,0,568,69,499
361231504005,36, New York,123, Yates County,154,35,30,5,0,0,0,0,0,0,154,35,30,5,0,345,0,345
361231505011,36, New York,123, Yates County,366,105,53,0,52,20,20,0,0,20,346,85,53,0,32,1329,217,1112
361231505012,36, New York,123, Yates County,191,71,22,13,36,14,6,0,0,6,177,65,22,13,30,545,39,506
361231505021,36, New York,123, Yates County,430,187,163,5,19,47,39,31,0,8,383,148,132,5,11,1247,137,1110
361231505022,36, New York,123, Yates County,262,17,11,0,6,10,2,0,0,2,252,15,11,0,4,732,47,685
361070201011,36, New York,107, Tioga County,284,91,67,7,17,33,14,0,4,10,251,77,67,3,7,777,106,671
361070201012,36, New York,107, Tioga County,338,126,83,14,29,27,27,4,12,11,311,99,79,2,18,974,102,872
361070201021,36, New York,107, Tioga County,249,92,80,0,12,12,12,0,0,12,237,80,80,0,0,650,34,616
361070201022,36, New York,107, Tioga County,236,87,66,0,21,0,0,0,0,0,236,87,66,0,21,563,17,546
361070201023,36, New York,107, Tioga County,188,107,62,2,43,5,5,0,0,5,183,102,62,2,38,518,26,492
361070201024,36, New York,107, Tioga County,403,164,124,5,35,37,35,32,3,0,366,129,92,2,35,1054,98,956
361070202001,36, New York,107, Tioga County,346,108,39,69,0,69,69,0,69,0,277,39,39,0,0,962,151,811
361070202002,36, New York,107, Tioga County,342,122,91,17,14,9,9,0,0,9,333,113,91,17,5,1107,114,993
361070202003,36, New York,107, Tioga County,373,186,36,59,91,110,44,0,44,0,263,142,36,15,91,1230,315,915
361070202004,36, New York,107, Tioga County,326,113,81,2,30,32,27,2,0,25,294,86,79,2,5,913,66,847
361070203001,36, New York,107, Tioga County,308,126,66,0,60,38,38,0,0,38,270,88,66,0,22,815,70,745
361070203002,36, New York,107, Tioga County,370,111,111,0,0,0,0,0,0,0,370,111,111,0,0,921,33,888
361070203003,36, New York,107, Tioga County,343,75,53,0,22,27,0,0,0,0,316,75,53,0,22,1045,194,851
361070203004,36, New York,107, Tioga County,187,78,78,0,0,0,0,0,0,0,187,78,78,0,0,560,0,560
361070203005,36, New York,107, Tioga County,354,155,128,27,0,0,0,0,0,0,354,155,128,27,0,827,0,827
361070203006,36, New York,107, Tioga County,363,110,92,0,18,0,0,0,0,0,363,110,92,0,18,924,0,924
361070204011,36, New York,107, Tioga County,185,63,41,22,0,14,14,14,0,0,171,49,27,22,0,844,168,676
361070204012,36, New York,107, Tioga County,289,131,58,41,32,27,27,0,0,27,262,104,58,41,5,773,47,726
361070204013,36, New York,107, Tioga County,466,159,85,68,6,0,0,0,0,0,466,159,85,68,6,1170,28,1142
361070204014,36, New York,107, Tioga County,312,159,159,0,0,13,0,0,0,0,299,159,159,0,0,770,45,725
361070204021,36, New York,107, Tioga County,656,220,192,0,28,57,0,0,0,0,599,220,192,0,28,1534,144,1390
361070204022,36, New York,107, Tioga County,198,99,84,0,15,0,0,0,0,0,198,99,84,0,15,511,20,491
361070204023,36, New York,107, Tioga County,383,123,112,0,11,11,11,0,0,11,372,112,112,0,0,1024,17,1007
361070205001,36, New York,107, Tioga County,263,161,32,75,54,29,29,15,0,14,234,132,17,75,40,604,195,409
361070205002,36, New York,107, Tioga County,150,54,13,0,41,7,7,0,0,7,143,47,13,0,34,728,63,665
361070205003,36, New York,107, Tioga County,73,23,13,0,10,22,10,0,0,10,51,13,13,0,0,525,175,350
361070205004,36, New York,107, Tioga County,271,156,128,8,20,8,0,0,0,0,263,156,128,8,20,947,60,887
361070206001,36, New York,107, Tioga County,279,54,24,30,0,43,30,0,30,0,236,24,24,0,0,908,73,835
361070206002,36, New York,107, Tioga County,176,0,0,0,0,0,0,0,0,0,176,0,0,0,0,451,0,451
361070206003,36, New York,107, Tioga County,594,247,163,51,33,39,0,0,0,0,555,247,163,51,33,1524,269,1255
361070206004,36, New York,107, Tioga County,319,54,17,37,0,17,17,17,0,0,302,37,0,37,0,902,34,868
361070206005,36, New York,107, Tioga County,380,160,129,5,26,10,10,0,0,10,370,150,129,5,16,978,25,953
361070206006,36, New York,107, Tioga County,149,70,51,3,16,6,6,6,0,0,143,64,45,3,16,471,28,443
361070206007,36, New York,107, Tioga County,219,63,44,6,13,3,0,0,0,0,216,63,44,6,13,546,36,510
361070207011,36, New York,107, Tioga County,237,114,56,24,34,22,22,7,0,15,215,92,49,24,19,724,52,672
361070207012,36, New York,107, Tioga County,328,140,58,14,68,51,44,0,0,44,277,96,58,14,24,925,174,751
361070207013,36, New York,107, Tioga County,257,142,71,43,28,7,4,0,4,0,250,138,71,39,28,643,41,602
361070207021,36, New York,107, Tioga County,282,87,51,0,36,6,6,0,0,6,276,81,51,0,30,748,72,676
361070207022,36, New York,107, Tioga County,325,138,75,53,10,16,10,0,0,10,309,128,75,53,0,853,51,802
361070207023,36, New York,107, Tioga County,448,197,116,0,81,6,0,0,0,0,442,197,116,0,81,1158,107,1051
361070207024,36, New York,107, Tioga County,172,55,21,24,10,13,0,0,0,0,159,55,21,24,10,485,115,370
361070207031,36, New York,107, Tioga County,223,47,23,16,8,0,0,0,0,0,223,47,23,16,8,696,13,683
361070207032,36, New York,107, Tioga County,338,118,86,20,12,20,0,0,0,0,318,118,86,20,12,1007,153,854
361070207033,36, New York,107, Tioga County,304,181,79,73,29,27,10,0,0,10,277,171,79,73,19,771,74,697
361070207034,36, New York,107, Tioga County,200,128,45,65,18,0,0,0,0,0,200,128,45,65,18,737,85,652
360510301001,36, New York,051, Livingston County,120,83,77,0,6,0,0,0,0,0,120,83,77,0,6,393,31,362
360510301002,36, New York,051, Livingston County,633,284,234,0,50,26,26,4,0,22,607,258,230,0,28,1993,87,1906
360510301003,36, New York,051, Livingston County,354,50,40,0,10,18,10,0,0,10,336,40,40,0,0,1046,86,960
360510302011,36, New York,051, Livingston County,361,107,57,0,50,39,39,0,0,39,322,68,57,0,11,856,90,766
360510302012,36, New York,051, Livingston County,550,275,123,82,70,0,0,0,0,0,550,275,123,82,70,1478,38,1440
360510302013,36, New York,051, Livingston County,267,193,29,8,156,143,143,0,8,135,124,50,29,0,21,1495,936,559
360510302031,36, New York,051, Livingston County,351,76,76,0,0,0,0,0,0,0,351,76,76,0,0,1150,87,1063
360510302032,36, New York,051, Livingston County,185,95,58,37,0,13,13,13,0,0,172,82,45,37,0,694,75,619
360510302041,36, New York,051, Livingston County,128,79,38,20,21,0,0,0,0,0,128,79,38,20,21,359,7,352
360510302042,36, New York,051, Livingston County,646,230,186,0,44,26,0,0,0,0,620,230,186,0,44,1530,78,1452
360510302043,36, New York,051, Livingston County,269,67,33,0,34,0,0,0,0,0,269,67,33,0,34,899,50,849
360510303001,36, New York,051, Livingston County,567,233,142,53,38,21,10,0,10,0,546,223,142,43,38,1395,114,1281
360510303002,36, New York,051, Livingston County,343,121,59,26,36,90,36,0,0,36,253,85,59,26,0,1185,218,967
360510304001,36, New York,051, Livingston County,452,193,157,0,36,0,0,0,0,0,452,193,157,0,36,1162,99,1063
360510304002,36, New York,051, Livingston County,147,29,29,0,0,7,0,0,0,0,140,29,29,0,0,906,492,414
360510304003,36, New York,051, Livingston County,114,45,45,0,0,0,0,0,0,0,114,45,45,0,0,474,44,430
360510305001,36, New York,051, Livingston County,0,0,0,0,0,0,0,0,0,0,0,0,0,0,0,0,0,0
360510306001,36, New York,051, Livingston County,504,180,157,0,23,11,11,0,0,11,493,169,157,0,12,1548,152,1396
360510306002,36, New York,051, Livingston County,504,304,214,36,54,21,21,4,0,17,483,283,210,36,37,1461,80,1381
360510307011,36, New York,051, Livingston County,416,138,78,0,60,0,0,0,0,0,416,138,78,0,60,1185,0,1185
360510307012,36, New York,051, Livingston County,295,130,110,0,20,6,0,0,0,0,289,130,110,0,20,803,87,716
360510307021,36, New York,051, Livingston County,285,69,58,0,11,0,0,0,0,0,285,69,58,0,11,955,60,895
360510307022,36, New York,051, Livingston County,713,396,312,19,65,17,12,4,0,8,696,384,308,19,57,1893,90,1803
360510307023,36, New York,051, Livingston County,470,196,135,0,61,49,49,0,0,49,421,147,135,0,12,1216,75,1141
360510308001,36, New York,051, Livingston County,228,95,52,1,42,10,10,5,0,5,218,85,47,1,37,647,30,617
360510308002,36, New York,051, Livingston County,335,118,75,5,38,17,16,5,1,10,318,102,70,4,28,912,53,859
360510308003,36, New York,051, Livingston County,118,20,0,0,20,20,20,0,0,20,98,0,0,0,0,387,36,351
360510308004,36, New York,051, Livingston County,113,22,0,0,22,0,0,0,0,0,113,22,0,0,22,361,0,361
360510308005,36, New York,051, Livingston County,280,80,73,4,3,14,8,8,0,0,266,72,65,4,3,840,74,766
360510308006,36, New York,051, Livingston County,132,24,14,2,8,2,2,0,2,0,130,22,14,0,8,353,2,351
360510309001,36, New York,051, Livingston County,149,68,58,0,10,26,11,11,0,0,123,57,47,0,10,645,202,443
360510309002,36, New York,051, Livingston County,312,89,51,18,20,53,20,0,0,20,259,69,51,18,0,873,126,747
360510309003,36, New York,051, Livingston County,307,204,111,0,93,0,0,0,0,0,307,204,111,0,93,1014,68,946
360510310001,36, New York,051, Livingston County,0,0,0,0,0,0,0,0,0,0,0,0,0,0,0,13,6,7
360510311011,36, New York,051, Livingston County,350,101,96,5,0,44,37,37,0,0,306,64,59,5,0,927,163,764
360510311012,36, New York,051, Livingston County,203,30,30,0,0,5,5,5,0,0,198,25,25,0,0,616,14,602
360510311021,36, New York,051, Livingston County,346,86,78,0,8,9,0,0,0,0,337,86,78,0,8,1028,73,955
360510311022,36, New York,051, Livingston County,304,81,29,15,37,7,7,0,0,7,297,74,29,15,30,856,32,824
360510312001,36, New York,051, Livingston County,222,97,43,17,37,50,37,0,0,37,172,60,43,17,0,598,121,477
360510312002,36, New York,051, Livingston County,372,155,77,57,21,62,26,3,5,18,310,129,74,52,3,1196,222,974
360510312003,36, New York,051, Livingston County,143,85,61,10,14,20,20,8,0,12,123,65,53,10,2,469,91,378
360510312004,36, New York,051, Livingston County,211,70,56,0,14,3,3,0,0,3,208,67,56,0,11,724,58,666
360510313001,36, New York,051, Livingston County,478,138,94,21,23,31,17,6,0,11,447,121,88,21,12,1398,91,1307
360510313002,36, New York,051, Livingston County,387,107,55,38,14,27,6,4,2,0,360,101,51,36,14,1149,109,1040
360510313003,36, New York,051, Livingston County,233,60,22,9,29,9,4,4,0,0,224,56,18,9,29,637,48,589
360510314001,36, New York,051, Livingston County,338,106,50,43,13,0,0,0,0,0,338,106,50,43,13,1073,42,1031
360510314002,36, New York,051, Livingston County,393,204,83,65,56,0,0,0,0,0,393,204,83,65,56,1428,136,1292
360510314003,36, New York,051, Livingston County,137,28,16,0,12,0,0,0,0,0,137,28,16,0,12,420,0,420
360510314004,36, New York,051, Livingston County,311,123,90,0,33,27,16,16,0,0,284,107,74,0,33,989,73,916
360570702001,36, New York,057, Montgomery County,115,30,19,0,11,6,0,0,0,0,109,30,19,0,11,368,32,336
360570702002,36, New York,057, Montgomery County,133,133,45,49,39,77,77,0,49,28,56,56,45,0,11,576,289,287
360570702003,36, New York,057, Montgomery County,173,94,24,0,70,0,0,0,0,0,173,94,24,0,70,512,135,377
360570703001,36, New York,057, Montgomery County,159,101,46,0,55,44,23,9,0,14,115,78,37,0,41,577,175,402
360570703002,36, New York,057, Montgomery County,295,165,66,0,99,49,46,17,0,29,246,119,49,0,70,898,108,790
360570704001,36, New York,057, Montgomery County,141,52,19,0,33,24,17,0,0,17,117,35,19,0,16,385,71,314
360570704002,36, New York,057, Montgomery County,376,183,94,21,68,49,49,0,15,34,327,134,94,6,34,1132,114,1018
360570705001,36, New York,057, Montgomery County,378,211,78,0,133,67,51,0,0,51,311,160,78,0,82,1138,189,949
360570705002,36, New York,057, Montgomery County,316,112,94,0,18,0,0,0,0,0,316,112,94,0,18,845,46,799
360570706001,36, New York,057, Montgomery County,201,92,11,56,25,37,37,0,14,23,164,55,11,42,2,617,103,514
360570706002,36, New York,057, Montgomery County,298,187,32,40,115,49,44,0,0,44,249,143,32,40,71,1018,224,794
360570707001,36, New York,057, Montgomery County,251,94,45,9,40,40,40,0,0,40,211,54,45,9,0,951,116,835
360570707002,36, New York,057, Montgomery County,384,126,46,31,49,0,0,0,0,0,384,126,46,31,49,957,41,916
360570708001,36, New York,057, Montgomery County,328,169,18,43,108,108,47,0,35,12,220,122,18,8,96,898,211,687
360570708002,36, New York,057, Montgomery County,416,299,90,53,156,145,137,30,29,78,271,162,60,24,78,1317,471,846
360570709001,36, New York,057, Montgomery County,315,106,0,0,106,89,21,0,0,21,226,85,0,0,85,1138,315,823
360570721001,36, New York,057, Montgomery County,339,58,32,26,0,92,26,0,26,0,247,32,32,0,0,937,151,786
360570721002,36, New York,057, Montgomery County,474,130,79,24,27,19,3,0,3,0,455,127,79,21,27,1734,84,1650
360570721003,36, New York,057, Montgomery County,135,35,35,0,0,0,0,0,0,0,135,35,35,0,0,714,37,677
360570721004,36, New York,057, Montgomery County,304,93,88,5,0,10,1,0,1,0,294,92,88,4,0,1396,31,1365
360570722001,36, New York,057, Montgomery County,150,66,59,7,0,0,0,0,0,0,150,66,59,7,0,588,0,588
360570722002,36, New York,057, Montgomery County,237,135,97,18,20,6,0,0,0,0,231,135,97,18,20,713,33,680
360570722003,36, New York,057, Montgomery County,190,64,39,6,19,26,4,4,0,0,164,60,35,6,19,793,138,655
360570722004,36, New York,057, Montgomery County,156,104,79,3,22,10,10,0,0,10,146,94,79,3,12,479,46,433
360570723001,36, New York,057, Montgomery County,365,151,140,11,0,41,30,27,3,0,324,121,113,8,0,1135,143,992
360570723002,36, New York,057, Montgomery County,378,103,47,41,15,21,0,0,0,0,357,103,47,41,15,1489,219,1270
360570724001,36, New York,057, Montgomery County,209,122,65,10,47,29,29,0,0,29,180,93,65,10,18,607,89,518
360570724002,36, New York,057, Montgomery County,341,111,66,2,43,48,35,6,0,29,293,76,60,2,14,1268,188,1080
360570725001,36, New York,057, Montgomery County,113,62,52,10,0,9,0,0,0,0,104,62,52,10,0,487,61,426
360570725002,36, New York,057, Montgomery County,125,56,29,0,27,16,16,0,0,16,109,40,29,0,11,579,92,487
360570725003,36, New York,057, Montgomery County,196,127,119,8,0,7,0,0,0,0,189,127,119,8,0,671,14,657
360570725004,36, New York,057, Montgomery County,396,216,74,22,120,86,64,0,0,64,310,152,74,22,56,1235,218,1017
360570726001,36, New York,057, Montgomery County,322,108,93,0,15,12,1,0,0,1,310,107,93,0,14,1104,65,1039
360570726002,36, New York,057, Montgomery County,315,163,102,36,25,27,23,6,17,0,288,140,96,19,25,890,167,723
360570726003,36, New York,057, Montgomery County,200,81,81,0,0,0,0,0,0,0,200,81,81,0,0,498,9,489
360570727001,36, New York,057, Montgomery County,222,102,69,3,30,13,13,0,0,13,209,89,69,3,17,693,57,636
360570727002,36, New York,057, Montgomery County,255,137,131,0,6,24,19,19,0,0,231,118,112,0,6,836,129,707
360570727003,36, New York,057, Montgomery County,361,123,95,14,14,34,28,19,3,6,327,95,76,11,8,961,47,914
360570727004,36, New York,057, Montgomery County,253,128,119,4,5,8,8,3,0,5,245,120,116,4,0,656,27,629
360570728001,36, New York,057, Montgomery County,292,124,105,0,19,22,19,0,0,19,270,105,105,0,0,863,62,801
360570728002,36, New York,057, Montgomery County,219,45,26,19,0,0,0,0,0,0,219,45,26,19,0,851,49,802
360570728003,36, New York,057, Montgomery County,242,66,53,6,7,3,0,0,0,0,239,66,53,6,7,647,27,620
360570728004,36, New York,057, Montgomery County,284,111,72,11,28,13,0,0,0,0,271,111,72,11,28,893,71,822
360339400001,36, New York,033, Franklin County,420,248,89,0,159,189,140,0,0,140,231,108,89,0,19,1380,441,939
360339400002,36, New York,033, Franklin County,525,149,95,54,0,0,0,0,0,0,525,149,95,54,0,1332,59,1273
360339502001,36, New York,033, Franklin County,516,212,135,39,38,39,25,16,0,9,477,187,119,39,29,1363,175,1188
360339502002,36, New York,033, Franklin County,176,93,51,22,20,8,4,4,0,0,168,89,47,22,20,432,25,407
360339502003,36, New York,033, Franklin County,292,119,60,31,28,51,41,21,7,13,241,78,39,24,15,742,140,602
360339502004,36, New York,033, Franklin County,345,119,47,23,49,75,56,15,0,41,270,63,32,23,8,894,263,631
360339503011,36, New York,033, Franklin County,433,227,145,28,54,99,56,52,0,4,334,171,93,28,50,1317,279,1038
360339503012,36, New York,033, Franklin County,315,150,97,8,45,21,21,0,0,21,294,129,97,8,24,898,52,846
360339503013,36, New York,033, Franklin County,681,293,193,51,49,92,74,41,0,33,589,219,152,51,16,1740,241,1499
360339505011,36, New York,033, Franklin County,130,52,36,6,10,6,6,0,6,0,124,46,36,0,10,636,80,556
360339505012,36, New York,033, Franklin County,135,65,51,0,14,14,14,0,0,14,121,51,51,0,0,504,49,455
360339505013,36, New York,033, Franklin County,377,227,113,16,98,103,70,24,0,46,274,157,89,16,52,1070,331,739
360339505021,36, New York,033, Franklin County,358,124,60,6,58,15,15,8,0,7,343,109,52,6,51,839,54,785
360339505022,36, New York,033, Franklin County,197,43,42,0,1,0,0,0,0,0,197,43,42,0,1,630,25,605
360339506011,36, New York,033, Franklin County,209,42,18,11,13,20,6,0,6,0,189,36,18,5,13,484,43,441
360339506012,36, New York,033, Franklin County,138,29,27,2,0,8,2,2,0,0,130,27,25,2,0,380,45,335
360339507011,36, New York,033, Franklin County,149,33,14,4,15,18,7,0,2,5,131,26,14,2,10,450,101,349
360339507012,36, New York,033, Franklin County,207,40,22,11,7,12,4,2,2,0,195,36,20,9,7,655,69,586
360339508001,36, New York,033, Franklin County,169,29,27,0,2,8,0,0,0,0,161,29,27,0,2,518,34,484
360339508002,36, New York,033, Franklin County,394,134,66,16,52,54,46,0,0,46,340,88,66,16,6,939,101,838
360339509001,36, New York,033, Franklin County,192,48,34,14,0,14,14,0,14,0,178,34,34,0,0,737,32,705
360339509002,36, New York,033, Franklin County,141,105,36,69,0,31,22,13,9,0,110,83,23,60,0,500,81,419
360339509003,36, New York,033, Franklin County,150,46,26,0,20,0,0,0,0,0,150,46,26,0,20,478,8,470
360339509004,36, New York,033, Franklin County,262,73,42,18,13,31,31,0,18,13,231,42,42,0,0,882,228,654
360339510001,36, New York,033, Franklin County,77,40,40,0,0,0,0,0,0,0,77,40,40,0,0,586,115,471
360339510002,36, New York,033, Franklin County,205,54,22,12,20,21,13,0,0,13,184,41,22,12,7,446,26,420
360339510003,36, New York,033, Franklin County,244,100,78,0,22,10,10,0,0,10,234,90,78,0,12,642,48,594
360339511001,36, New York,033, Franklin County,273,112,102,0,10,0,0,0,0,0,273,112,102,0,10,1005,150,855
360339511002,36, New York,033, Franklin County,112,28,18,0,10,0,0,0,0,0,112,28,18,0,10,487,141,346
360339511003,36, New York,033, Franklin County,201,76,76,0,0,17,17,17,0,0,184,59,59,0,0,834,173,661
360339512001,36, New York,033, Franklin County,289,156,64,0,92,75,75,10,0,65,214,81,54,0,27,951,142,809
360339512002,36, New York,033, Franklin County,307,89,83,0,6,0,0,0,0,0,307,89,83,0,6,753,21,732
360339513001,36, New York,033, Franklin County,412,182,104,24,54,25,18,8,6,4,387,164,96,18,50,1142,122,1020
360339514001,36, New York,033, Franklin County,435,215,113,0,102,33,18,0,0,18,402,197,113,0,84,1134,82,1052
360339514002,36, New York,033, Franklin County,433,139,46,0,93,96,93,0,0,93,337,46,46,0,0,1133,347,786
360339514003,36, New York,033, Franklin County,86,40,19,0,21,33,21,0,0,21,53,19,19,0,0,370,83,287
360339514004,36, New York,033, Franklin County,186,15,0,0,15,0,0,0,0,0,186,15,0,0,15,553,146,407
360339514005,36, New York,033, Franklin County,146,0,0,0,0,19,0,0,0,0,127,0,0,0,0,388,58,330
360339520001,36, New York,033, Franklin County,520,237,147,46,44,91,72,11,24,37,429,165,136,22,7,1368,209,1159
360339520002,36, New York,033, Franklin County,443,245,197,18,30,67,64,55,9,0,376,181,142,9,30,1151,204,947
360339520003,36, New York,033, Franklin County,194,86,58,6,22,21,8,8,0,0,173,78,50,6,22,511,73,438
360339520004,36, New York,033, Franklin County,250,145,88,12,45,28,10,5,0,5,222,135,83,12,40,622,91,531
360830401001,36, New York,083, Rensselaer County,475,341,19,30,292,230,230,0,0,230,245,111,19,30,62,1043,375,668
360830401002,36, New York,083, Rensselaer County,317,169,41,0,128,190,146,38,0,108,127,23,3,0,20,918,393,525
360830401003,36, New York,083, Rensselaer County,47,0,0,0,0,13,0,0,0,0,34,0,0,0,0,332,57,275
360830401004,36, New York,083, Rensselaer County,109,56,56,0,0,13,0,0,0,0,96,56,56,0,0,392,56,336
360830401005,36, New York,083, Rensselaer County,96,16,0,0,16,0,0,0,0,0,96,16,0,0,16,479,50,429
360830402001,36, New York,083, Rensselaer County,173,114,15,0,99,112,90,0,0,90,61,24,15,0,9,747,267,480
360830402002,36, New York,083, Rensselaer County,256,170,120,50,0,120,120,120,0,0,136,50,0,50,0,892,341,551
360830402003,36, New York,083, Rensselaer County,360,237,55,0,182,22,22,0,0,22,338,215,55,0,160,750,64,686
360830402004,36, New York,083, Rensselaer County,317,226,111,62,53,74,62,0,62,0,243,164,111,0,53,924,155,769
360830403001,36, New York,083, Rensselaer County,302,136,68,14,54,10,10,0,0,10,292,126,68,14,44,1085,109,976
360830403002,36, New York,083, Rensselaer County,181,40,5,0,35,5,5,5,0,0,176,35,0,0,35,570,20,550
360830403003,36, New York,083, Rensselaer County,266,207,32,37,138,27,27,0,0,27,239,180,32,37,111,1000,193,807
360830404001,36, New York,083, Rensselaer County,182,132,45,0,87,124,91,20,0,71,58,41,25,0,16,806,386,420
360830404002,36, New York,083, Rensselaer County,168,107,37,0,70,13,10,7,0,3,155,97,30,0,67,876,200,676
360830405001,36, New York,083, Rensselaer County,173,85,39,6,40,42,31,0,6,25,131,54,39,0,15,679,153,526
360830405002,36, New York,083, Rensselaer County,307,214,16,30,168,172,172,10,17,145,135,42,6,13,23,737,331,406
360830406001,36, New York,083, Rensselaer County,83,49,37,5,7,2,2,0,0,2,81,47,37,5,5,583,167,416
360830406002,36, New York,083, Rensselaer County,83,34,27,7,0,0,0,0,0,0,83,34,27,7,0,697,286,411
360830407011,36, New York,083, Rensselaer County,53,36,0,0,36,36,36,0,0,36,17,0,0,0,0,927,183,744
360830407012,36, New York,083, Rensselaer County,305,54,54,0,0,54,54,54,0,0,251,0,0,0,0,1019,103,916
360830407013,36, New York,083, Rensselaer County,202,182,0,0,182,0,0,0,0,0,202,182,0,0,182,671,247,424
360830407021,36, New York,083, Rensselaer County,192,137,100,37,0,0,0,0,0,0,192,137,100,37,0,703,169,534
360830408001,36, New York,083, Rensselaer County,89,48,0,22,26,4,0,0,0,0,85,48,0,22,26,555,78,477
360830408002,36, New York,083, Rensselaer County,141,15,3,12,0,0,0,0,0,0,141,15,3,12,0,1151,172,979
360830409001,36, New York,083, Rensselaer County,173,56,0,0,56,0,0,0,0,0,173,56,0,0,56,732,101,631
360830409002,36, New York,083, Rensselaer County,142,115,51,0,64,19,19,0,0,19,123,96,51,0,45,541,81,460
360830409003,36, New York,083, Rensselaer County,137,34,9,0,25,8,8,0,0,8,129,26,9,0,17,662,87,575
360830409004,36, New York,083, Rensselaer County,120,50,8,0,42,42,16,0,0,16,78,34,8,0,26,442,189,253
360830410001,36, New York,083, Rensselaer County,204,120,30,0,90,12,12,0,0,12,192,108,30,0,78,658,102,556
360830410002,36, New York,083, Rensselaer County,215,93,36,10,47,48,48,1,0,47,167,45,35,10,0,732,169,563
360830410003,36, New York,083, Rensselaer County,447,299,133,88,78,16,0,0,0,0,431,299,133,88,78,1220,208,1012
360830411011,36, New York,083, Rensselaer County,359,102,30,39,33,16,16,0,0,16,343,86,30,39,17,1600,153,1447
360830411012,36, New York,083, Rensselaer County,266,100,29,12,59,9,0,0,0,0,257,100,29,12,59,1003,56,947
360830411021,36, New York,083, Rensselaer County,302,302,0,20,282,291,291,0,20,271,11,11,0,0,11,585,371,214
360830411022,36, New York,083, Rensselaer County,401,71,8,0,63,41,23,0,0,23,360,48,8,0,40,1192,137,1055
360830412001,36, New York,083, Rensselaer County,128,38,22,0,16,0,0,0,0,0,128,38,22,0,16,466,35,431
360830412002,36, New York,083, Rensselaer County,164,71,17,0,54,0,0,0,0,0,164,71,17,0,54,448,0,448
360830412003,36, New York,083, Rensselaer County,225,28,28,0,0,0,0,0,0,0,225,28,28,0,0,846,9,837
360830412004,36, New York,083, Rensselaer County,241,98,84,0,14,28,28,28,0,0,213,70,56,0,14,1098,325,773
360830413001,36, New York,083, Rensselaer County,144,99,53,0,46,0,0,0,0,0,144,99,53,0,46,417,8,409
360830413002,36, New York,083, Rensselaer County,255,73,17,0,56,9,0,0,0,0,246,73,17,0,56,550,27,523
360830413003,36, New York,083, Rensselaer County,45,12,3,9,0,0,0,0,0,0,45,12,3,9,0,402,168,234
360830413004,36, New York,083, Rensselaer County,19,9,9,0,0,0,0,0,0,0,19,9,9,0,0,220,18,202
360830413005,36, New York,083, Rensselaer County,185,125,12,0,113,97,97,0,0,97,88,28,12,0,16,506,225,281
360830414001,36, New York,083, Rensselaer County,507,238,191,21,26,9,9,9,0,0,498,229,182,21,26,1718,168,1550
360830414002,36, New York,083, Rensselaer County,355,87,41,29,17,0,0,0,0,0,355,87,41,29,17,1506,95,1411
360830515001,36, New York,083, Rensselaer County,245,236,124,56,56,50,50,0,50,0,195,186,124,6,56,645,121,524
360830515002,36, New York,083, Rensselaer County,303,117,45,13,59,96,62,3,0,59,207,55,42,13,0,1181,199,982
360830516011,36, New York,083, Rensselaer County,147,126,74,0,52,42,42,42,0,0,105,84,32,0,52,395,135,260
360830516012,36, New York,083, Rensselaer County,260,109,96,0,13,16,16,3,0,13,244,93,93,0,0,1152,181,971
360830516013,36, New York,083, Rensselaer County,78,44,0,0,44,13,0,0,0,0,65,44,0,0,44,492,192,300
360830516021,36, New York,083, Rensselaer County,479,133,66,0,67,26,26,0,0,26,453,107,66,0,41,1652,63,1589
360830516022,36, New York,083, Rensselaer County,314,34,34,0,0,0,0,0,0,0,314,34,34,0,0,912,47,865
360830516023,36, New York,083, Rensselaer County,248,100,33,42,25,42,42,0,42,0,206,58,33,0,25,757,81,676
360830517011,36, New York,083, Rensselaer County,406,127,52,40,35,0,0,0,0,0,406,127,52,40,35,1076,38,1038
360830517012,36, New York,083, Rensselaer County,519,166,110,35,21,44,21,0,0,21,475,145,110,35,0,1662,157,1505
360830517021,36, New York,083, Rensselaer County,353,228,99,14,115,76,67,0,0,67,277,161,99,14,48,1021,176,845
360830517022,36, New York,083, Rensselaer County,430,161,100,0,61,0,0,0,0,0,430,161,100,0,61,1353,55,1298
360830518001,36, New York,083, Rensselaer County,379,166,152,0,14,68,43,43,0,0,311,123,109,0,14,1075,160,915
360830518002,36, New York,083, Rensselaer County,137,74,62,5,7,13,13,13,0,0,124,61,49,5,7,417,30,387
360830518003,36, New York,083, Rensselaer County,338,167,106,14,47,0,0,0,0,0,338,167,106,14,47,913,0,913
360830518004,36, New York,083, Rensselaer County,706,337,232,47,58,74,74,16,0,58,632,263,216,47,0,1726,90,1636
360830519011,36, New York,083, Rensselaer County,461,129,114,4,11,16,8,0,0,8,445,121,114,4,3,1235,79,1156
360830519012,36, New York,083, Rensselaer County,543,236,209,11,16,21,21,12,0,9,522,215,197,11,7,1513,40,1473
360830519013,36, New York,083, Rensselaer County,303,73,64,0,9,0,0,0,0,0,303,73,64,0,9,932,37,895
360830519021,36, New York,083, Rensselaer County,463,106,80,9,17,10,0,0,0,0,453,106,80,9,17,1237,21,1216
360830519022,36, New York,083, Rensselaer County,391,117,68,21,28,10,0,0,0,0,381,117,68,21,28,1066,65,1001
360830520021,36, New York,083, Rensselaer County,564,272,229,12,31,33,33,23,0,10,531,239,206,12,21,1625,110,1515
360830520031,36, New York,083, Rensselaer County,421,125,89,23,13,0,0,0,0,0,421,125,89,23,13,1113,39,1074
360830520032,36, New York,083, Rensselaer County,172,75,53,0,22,0,0,0,0,0,172,75,53,0,22,434,0,434
360830520033,36, New York,083, Rensselaer County,337,88,18,42,28,19,0,0,0,0,318,88,18,42,28,884,96,788
360830520034,36, New York,083, Rensselaer County,302,93,82,0,11,0,0,0,0,0,302,93,82,0,11,887,39,848
360830520041,36, New York,083, Rensselaer County,386,164,139,0,25,15,0,0,0,0,371,164,139,0,25,1072,29,1043
360830520042,36, New York,083, Rensselaer County,312,168,97,0,71,0,0,0,0,0,312,168,97,0,71,978,100,878
360830520043,36, New York,083, Rensselaer County,516,262,161,101,0,0,0,0,0,0,516,262,161,101,0,1358,53,1305
360830520044,36, New York,083, Rensselaer County,289,48,48,0,0,0,0,0,0,0,289,48,48,0,0,850,25,825
360830520045,36, New York,083, Rensselaer County,157,10,10,0,0,0,0,0,0,0,157,10,10,0,0,740,0,740
360830521011,36, New York,083, Rensselaer County,207,83,76,7,0,24,15,15,0,0,183,68,61,7,0,537,58,479
360830521012,36, New York,083, Rensselaer County,318,99,87,0,12,34,12,6,0,6,284,87,81,0,6,999,132,867
360830521021,36, New York,083, Rensselaer County,377,111,82,3,26,9,0,0,0,0,368,111,82,3,26,1090,45,1045
360830521031,36, New York,083, Rensselaer County,265,88,71,7,10,37,19,13,0,6,228,69,58,7,4,879,117,762
360830521032,36, New York,083, Rensselaer County,236,146,96,20,30,10,10,0,0,10,226,136,96,20,20,716,60,656
360830522011,36, New York,083, Rensselaer County,381,154,107,12,35,9,9,0,0,9,372,145,107,12,26,1128,41,1087
360830522012,36, New York,083, Rensselaer County,453,228,191,0,37,0,0,0,0,0,453,228,191,0,37,1048,13,1035
360830522013,36, New York,083, Rensselaer County,428,177,97,0,80,18,9,0,0,9,410,168,97,0,71,1095,48,1047
360830522031,36, New York,083, Rensselaer County,565,125,91,34,0,52,34,0,34,0,513,91,91,0,0,1370,161,1209
360830522032,36, New York,083, Rensselaer County,256,54,54,0,0,0,0,0,0,0,256,54,54,0,0,824,45,779
360830522033,36, New York,083, Rensselaer County,175,9,9,0,0,0,0,0,0,0,175,9,9,0,0,504,15,489
360830522034,36, New York,083, Rensselaer County,601,221,206,0,15,0,0,0,0,0,601,221,206,0,15,1548,20,1528
360830522035,36, New York,083, Rensselaer County,270,137,34,0,103,22,22,0,0,22,248,115,34,0,81,469,40,429
360830522041,36, New York,083, Rensselaer County,378,155,124,10,21,0,0,0,0,0,378,155,124,10,21,931,0,931
360830522042,36, New York,083, Rensselaer County,281,105,72,33,0,13,13,0,13,0,268,92,72,20,0,754,27,727
360830523011,36, New York,083, Rensselaer County,524,281,104,5,172,0,0,0,0,0,524,281,104,5,172,1560,8,1552
360830523012,36, New York,083, Rensselaer County,240,105,98,7,0,21,0,0,0,0,219,105,98,7,0,676,52,624
360830523013,36, New York,083, Rensselaer County,734,355,312,0,43,0,0,0,0,0,734,355,312,0,43,2017,0,2017
360830523031,36, New York,083, Rensselaer County,306,169,133,28,8,32,32,4,28,0,274,137,129,0,8,960,90,870
360830523051,36, New York,083, Rensselaer County,176,101,10,16,75,0,0,0,0,0,176,101,10,16,75,464,71,393
360830523052,36, New York,083, Rensselaer County,271,96,21,0,75,8,8,0,0,8,263,88,21,0,67,678,24,654
360830523053,36, New York,083, Rensselaer County,363,118,66,29,23,0,0,0,0,0,363,118,66,29,23,961,15,946
360830523061,36, New York,083, Rensselaer County,674,346,307,36,3,3,0,0,0,0,671,346,307,36,3,1653,21,1632
360830523062,36, New York,083, Rensselaer County,125,34,18,5,11,25,0,0,0,0,100,34,18,5,11,399,71,328
360830523063,36, New York,083, Rensselaer County,214,81,77,0,4,0,0,0,0,0,214,81,77,0,4,808,26,782
360830524021,36, New York,083, Rensselaer County,716,381,355,26,0,0,0,0,0,0,716,381,355,26,0,1671,87,1584
360830524051,36, New York,083, Rensselaer County,134,27,8,0,19,0,0,0,0,0,134,27,8,0,19,513,0,513
360830524052,36, New York,083, Rensselaer County,634,187,139,25,23,0,0,0,0,0,634,187,139,25,23,1807,67,1740
360830524061,36, New York,083, Rensselaer County,170,53,37,0,16,27,16,0,0,16,143,37,37,0,0,830,41,789
360830524062,36, New York,083, Rensselaer County,218,69,60,9,0,0,0,0,0,0,218,69,60,9,0,603,24,579
360830524063,36, New York,083, Rensselaer County,570,190,177,0,13,34,34,34,0,0,536,156,143,0,13,1731,103,1628
360830524071,36, New York,083, Rensselaer County,838,304,229,21,54,0,0,0,0,0,838,304,229,21,54,2144,52,2092
360830524072,36, New York,083, Rensselaer County,650,351,333,0,18,0,0,0,0,0,650,351,333,0,18,1591,8,1583
360830524081,36, New York,083, Rensselaer County,316,162,110,0,52,23,11,0,0,11,293,151,110,0,41,1069,102,967
360830524082,36, New York,083, Rensselaer County,228,52,26,26,0,0,0,0,0,0,228,52,26,26,0,890,71,819
360830525011,36, New York,083, Rensselaer County,325,102,52,0,50,0,0,0,0,0,325,102,52,0,50,816,9,807
360830525012,36, New York,083, Rensselaer County,268,132,121,11,0,0,0,0,0,0,268,132,121,11,0,760,34,726
360830525013,36, New York,083, Rensselaer County,592,179,165,0,14,0,0,0,0,0,592,179,165,0,14,1740,44,1696
360830525014,36, New York,083, Rensselaer County,366,247,219,10,18,0,0,0,0,0,366,247,219,10,18,1150,33,1117
360830525021,36, New York,083, Rensselaer County,964,398,327,43,28,23,0,0,0,0,941,398,327,43,28,2409,111,2298
360830525022,36, New York,083, Rensselaer County,270,117,117,0,0,0,0,0,0,0,270,117,117,0,0,897,17,880
360830525023,36, New York,083, Rensselaer County,191,66,45,0,21,21,0,0,0,0,170,66,45,0,21,503,46,457
360830525024,36, New York,083, Rensselaer County,173,26,20,0,6,16,0,0,0,0,157,26,20,0,6,754,33,721
360830525031,36, New York,083, Rensselaer County,342,161,114,0,47,16,14,0,0,14,326,147,114,0,33,1109,127,982
360830526011,36, New York,083, Rensselaer County,514,236,184,48,4,3,3,0,3,0,511,233,184,45,4,1339,38,1301
360830526012,36, New York,083, Rensselaer County,474,168,149,2,17,3,2,0,0,2,471,166,149,2,15,1422,50,1372
360830526021,36, New York,083, Rensselaer County,299,131,77,8,46,20,18,6,0,12,279,113,71,8,34,945,70,875
360830526031,36, New York,083, Rensselaer County,342,127,102,14,11,15,0,0,0,0,327,127,102,14,11,1124,40,1084
360830526032,36, New York,083, Rensselaer County,345,80,52,0,28,0,0,0,0,0,345,80,52,0,28,1220,125,1095
360650201021,36, New York,065, Oneida County,196,92,52,10,30,62,44,44,0,0,134,48,8,10,30,1130,433,697
360650203001,36, New York,065, Oneida County,59,13,0,13,0,0,0,0,0,0,59,13,0,13,0,584,252,332
360650203002,36, New York,065, Oneida County,205,165,21,47,97,151,129,0,47,82,54,36,21,0,15,624,359,265
360650207051,36, New York,065, Oneida County,237,140,65,14,61,34,34,10,0,24,203,106,55,14,37,894,96,798
360650207052,36, New York,065, Oneida County,209,116,76,28,12,4,4,0,4,0,205,112,76,24,12,667,49,618
360650208021,36, New York,065, Oneida County,351,300,173,29,98,62,62,62,0,0,289,238,111,29,98,688,163,525
360650208022,36, New York,065, Oneida County,66,37,6,0,31,37,37,6,0,31,29,0,0,0,0,394,87,307
360650208023,36, New York,065, Oneida County,243,171,110,0,61,15,15,15,0,0,228,156,95,0,61,608,44,564
360650208024,36, New York,065, Oneida County,0,0,0,0,0,0,0,0,0,0,0,0,0,0,0,0,0,0
360650208025,36, New York,065, Oneida County,243,114,65,18,31,76,18,0,18,0,167,96,65,0,31,929,209,720
360650208031,36, New York,065, Oneida County,246,168,95,0,73,49,49,0,0,49,197,119,95,0,24,664,92,572
360650208032,36, New York,065, Oneida County,261,127,47,12,68,116,42,2,0,40,145,85,45,12,28,444,198,246
360650208033,36, New York,065, Oneida County,0,0,0,0,0,0,0,0,0,0,0,0,0,0,0,0,0,0
360650208034,36, New York,065, Oneida County,321,128,66,0,62,191,35,23,0,12,130,93,43,0,50,878,377,501
360650209001,36, New York,065, Oneida County,276,160,73,13,74,110,78,48,0,30,166,82,25,13,44,844,431,413
360650209002,36, New York,065, Oneida County,81,38,13,0,25,9,3,3,0,0,72,35,10,0,25,363,108,255
360650210001,36, New York,065, Oneida County,223,103,18,0,85,178,85,0,0,85,45,18,18,0,0,705,533,172
360650210002,36, New York,065, Oneida County,119,90,27,0,63,32,32,0,0,32,87,58,27,0,31,374,106,268
360650211031,36, New York,065, Oneida County,368,322,75,9,238,233,233,23,9,201,135,89,52,0,37,933,346,587
360650211041,36, New York,065, Oneida County,322,264,172,89,3,92,92,0,89,3,230,172,172,0,0,666,151,515
360650211042,36, New York,065, Oneida County,172,133,63,41,29,17,17,0,0,17,155,116,63,41,12,661,232,429
360650211043,36, New York,065, Oneida County,283,220,61,0,159,213,205,61,0,144,70,15,0,0,15,703,414,289
360650212011,36, New York,065, Oneida County,155,44,29,0,15,29,0,0,0,0,126,44,29,0,15,383,82,301
360650212012,36, New York,065, Oneida County,327,249,130,25,94,73,47,47,0,0,254,202,83,25,94,631,207,424
360650212021,36, New York,065, Oneida County,281,186,77,0,109,87,87,38,0,49,194,99,39,0,60,646,99,547
360650212022,36, New York,065, Oneida County,376,212,97,94,21,157,134,61,73,0,219,78,36,21,21,933,304,629
360650213011,36, New York,065, Oneida County,0,0,0,0,0,0,0,0,0,0,0,0,0,0,0,239,57,182
360650213012,36, New York,065, Oneida County,233,64,34,14,16,0,0,0,0,0,233,64,34,14,16,623,21,602
360650213021,36, New York,065, Oneida County,403,223,35,0,188,151,128,14,0,114,252,95,21,0,74,728,206,522
360650213022,36, New York,065, Oneida County,601,391,269,7,115,67,48,17,0,31,534,343,252,7,84,1617,177,1440
360650213023,36, New York,065, Oneida County,302,210,180,0,30,58,39,28,0,11,244,171,152,0,19,617,137,480
360650213031,36, New York,065, Oneida County,105,82,31,0,51,28,28,0,0,28,77,54,31,0,23,254,119,135
360650213032,36, New York,065, Oneida County,532,176,127,0,49,58,37,37,0,0,474,139,90,0,49,1357,136,1221
360650213033,36, New York,065, Oneida County,328,171,155,16,0,59,44,44,0,0,269,127,111,16,0,822,38,784
360650214011,36, New York,065, Oneida County,264,144,32,15,97,124,124,20,15,89,140,20,12,0,8,811,278,533
360650214012,36, New York,065, Oneida County,327,138,54,69,15,15,0,0,0,0,312,138,54,69,15,877,112,765
360650214013,36, New York,065, Oneida County,60,25,25,0,0,0,0,0,0,0,60,25,25,0,0,631,256,375
360650214021,36, New York,065, Oneida County,218,128,42,6,80,90,74,0,6,68,128,54,42,0,12,665,199,466
360650214022,36, New York,065, Oneida County,274,111,63,39,9,19,19,10,0,9,255,92,53,39,0,721,109,612
360650215001,36, New York,065, Oneida County,276,156,19,12,125,82,62,0,12,50,194,94,19,0,75,801,249,552
360650215002,36, New York,065, Oneida County,300,237,65,43,129,44,38,30,8,0,256,199,35,35,129,530,107,423
360650216011,36, New York,065, Oneida County,332,187,64,0,123,60,47,0,0,47,272,140,64,0,76,844,168,676
360650216012,36, New York,065, Oneida County,549,168,132,0,36,63,34,34,0,0,486,134,98,0,36,1577,208,1369
360650216013,36, New York,065, Oneida County,530,309,181,52,76,11,0,0,0,0,519,309,181,52,76,1592,132,1460
360650216021,36, New York,065, Oneida County,156,98,91,7,0,8,0,0,0,0,148,98,91,7,0,519,30,489
360650216022,36, New York,065, Oneida County,482,198,156,12,30,26,18,9,0,9,456,180,147,12,21,1496,114,1382
360650217011,36, New York,065, Oneida County,296,35,35,0,0,10,0,0,0,0,286,35,35,0,0,1031,119,912
360650217012,36, New York,065, Oneida County,177,93,73,13,7,7,7,0,0,7,170,86,73,13,0,482,21,461
360650217013,36, New York,065, Oneida County,339,176,112,0,64,19,19,0,0,19,320,157,112,0,45,876,87,789
360650217021,36, New York,065, Oneida County,343,229,109,72,48,0,0,0,0,0,343,229,109,72,48,1052,15,1037
360650217022,36, New York,065, Oneida County,174,31,31,0,0,0,0,0,0,0,174,31,31,0,0,619,28,591
360650217023,36, New York,065, Oneida County,117,38,0,0,38,47,38,0,0,38,70,0,0,0,0,421,97,324
360650219001,36, New York,065, Oneida County,202,123,72,1,50,8,8,8,0,0,194,115,64,1,50,789,163,626
360650219002,36, New York,065, Oneida County,123,94,57,0,37,0,0,0,0,0,123,94,57,0,37,333,59,274
360650220001,36, New York,065, Oneida County,266,114,0,57,57,71,48,0,38,10,195,66,0,19,47,831,143,688
360650220002,36, New York,065, Oneida County,266,183,46,59,78,82,45,0,10,35,184,138,46,49,43,732,168,564
360650220003,36, New York,065, Oneida County,271,140,9,85,46,0,0,0,0,0,271,140,9,85,46,775,209,566
360650221001,36, New York,065, Oneida County,351,170,93,54,23,0,0,0,0,0,351,170,93,54,23,1258,77,1181
360650221002,36, New York,065, Oneida County,295,176,68,64,44,4,0,0,0,0,291,176,68,64,44,815,115,700
360650222001,36, New York,065, Oneida County,142,34,34,0,0,0,0,0,0,0,142,34,34,0,0,512,7,505
360650222002,36, New York,065, Oneida County,314,87,51,12,24,13,13,0,0,13,301,74,51,12,11,948,77,871
360650222003,36, New York,065, Oneida County,215,108,51,0,57,0,0,0,0,0,215,108,51,0,57,582,12,570
360650224001,36, New York,065, Oneida County,291,157,57,0,100,90,90,0,0,90,201,67,57,0,10,738,92,646
360650224002,36, New York,065, Oneida County,274,157,98,0,59,28,28,0,0,28,246,129,98,0,31,598,103,495
360650224003,36, New York,065, Oneida County,364,85,30,26,29,20,18,0,18,0,344,67,30,8,29,981,81,900
360650225001,36, New York,065, Oneida County,293,116,51,0,65,21,21,0,0,21,272,95,51,0,44,799,108,691
360650225002,36, New York,065, Oneida County,227,168,0,51,117,70,51,0,51,0,157,117,0,0,117,795,250,545
360650225003,36, New York,065, Oneida County,367,308,183,61,64,61,61,0,61,0,306,247,183,0,64,1206,234,972
360650225004,36, New York,065, Oneida County,230,154,33,20,101,56,56,0,0,56,174,98,33,20,45,577,165,412
360650227011,36, New York,065, Oneida County,346,72,54,6,12,10,10,10,0,0,336,62,44,6,12,987,50,937
360650227012,36, New York,065, Oneida County,345,150,99,28,23,23,7,0,0,7,322,143,99,28,16,932,68,864
360650227021,36, New York,065, Oneida County,359,106,57,10,39,24,0,0,0,0,335,106,57,10,39,1210,120,1090
360650227022,36, New York,065, Oneida County,499,195,167,6,22,10,10,10,0,0,489,185,157,6,22,1288,65,1223
360650227023,36, New York,065, Oneida County,237,40,30,10,0,27,0,0,0,0,210,40,30,10,0,587,56,531
360650228001,36, New York,065, Oneida County,313,129,98,1,30,12,12,12,0,0,301,117,86,1,30,852,116,736
360650228002,36, New York,065, Oneida County,424,175,161,14,0,24,14,0,14,0,400,161,161,0,0,1434,110,1324
360650230001,36, New York,065, Oneida County,672,418,339,43,36,0,0,0,0,0,672,418,339,43,36,1724,14,1710
360650230002,36, New York,065, Oneida County,256,68,39,0,29,0,0,0,0,0,256,68,39,0,29,746,13,733
360650230003,36, New York,065, Oneida County,674,124,51,21,52,13,0,0,0,0,661,124,51,21,52,2023,64,1959
360650232001,36, New York,065, Oneida County,354,162,59,48,55,55,55,0,0,55,299,107,59,48,0,909,122,787
360650232002,36, New York,065, Oneida County,204,112,92,0,20,0,0,0,0,0,204,112,92,0,20,470,0,470
360650232003,36, New York,065, Oneida County,454,181,30,64,87,0,0,0,0,0,454,181,30,64,87,1398,25,1373
360650232004,36, New York,065, Oneida County,182,125,46,0,79,19,19,0,0,19,163,106,46,0,60,534,137,397
360650233001,36, New York,065, Oneida County,114,53,53,0,0,21,0,0,0,0,93,53,53,0,0,503,86,417
360650233002,36, New York,065, Oneida County,315,177,72,17,88,49,49,0,0,49,266,128,72,17,39,865,77,788
360650233003,36, New York,065, Oneida County,243,155,60,25,70,0,0,0,0,0,243,155,60,25,70,648,0,648
360650234001,36, New York,065, Oneida County,258,43,43,0,0,34,0,0,0,0,224,43,43,0,0,1190,170,1020
360650234002,36, New York,065, Oneida County,314,15,15,0,0,0,0,0,0,0,314,15,15,0,0,900,0,900
360650234003,36, New York,065, Oneida County,165,155,74,0,81,47,37,0,0,37,118,118,74,0,44,732,112,620
360650234004,36, New York,065, Oneida County,278,91,91,0,0,0,0,0,0,0,278,91,91,0,0,892,0,892
360650235011,36, New York,065, Oneida County,447,179,68,34,77,0,0,0,0,0,447,179,68,34,77,1179,20,1159
360650235012,36, New York,065, Oneida County,280,113,91,0,22,0,0,0,0,0,280,113,91,0,22,645,5,640
360650235021,36, New York,065, Oneida County,151,54,29,0,25,0,0,0,0,0,151,54,29,0,25,503,27,476
360650235022,36, New York,065, Oneida County,491,147,119,9,19,9,0,0,0,0,482,147,119,9,19,1426,50,1376
360650235023,36, New York,065, Oneida County,558,238,180,47,11,11,11,0,11,0,547,227,180,36,11,1592,53,1539
360650237021,36, New York,065, Oneida County,506,198,159,27,12,12,12,0,0,12,494,186,159,27,0,1345,19,1326
360650237022,36, New York,065, Oneida County,545,220,180,18,22,26,19,9,10,0,519,201,171,8,22,1581,153,1428
360650239011,36, New York,065, Oneida County,354,145,95,20,30,15,10,0,10,0,339,135,95,10,30,879,45,834
360650239012,36, New York,065, Oneida County,345,133,98,5,30,20,14,0,5,9,325,119,98,0,21,860,39,821
360650239021,36, New York,065, Oneida County,204,28,24,4,0,6,3,3,0,0,198,25,21,4,0,601,9,592
360650239022,36, New York,065, Oneida County,241,113,113,0,0,0,0,0,0,0,241,113,113,0,0,746,12,734
360650240001,36, New York,065, Oneida County,402,180,168,2,10,0,0,0,0,0,402,180,168,2,10,989,48,941
360650240002,36, New York,065, Oneida County,877,393,278,54,61,50,49,6,43,0,827,344,272,11,61,2158,117,2041
360650241011,36, New York,065, Oneida County,49,11,11,0,0,5,0,0,0,0,44,11,11,0,0,156,14,142
360650241012,36, New York,065, Oneida County,338,130,99,19,12,13,13,0,5,8,325,117,99,14,4,1040,64,976
360650241021,36, New York,065, Oneida County,247,88,83,3,2,10,7,5,0,2,237,81,78,3,0,696,35,661
360650241022,36, New York,065, Oneida County,250,106,57,32,17,21,7,0,7,0,229,99,57,25,17,663,122,541
360650241023,36, New York,065, Oneida County,222,55,45,6,4,0,0,0,0,0,222,55,45,6,4,625,29,596
360650242001,36, New York,065, Oneida County,390,178,99,36,43,0,0,0,0,0,390,178,99,36,43,987,36,951
360650242002,36, New York,065, Oneida County,533,250,141,11,98,37,37,0,0,37,496,213,141,11,61,1905,345,1560
360650242003,36, New York,065, Oneida County,236,61,51,0,10,0,0,0,0,0,236,61,51,0,10,710,0,710
360650243011,36, New York,065, Oneida County,281,60,60,0,0,0,0,0,0,0,281,60,60,0,0,686,35,651
360650243012,36, New York,065, Oneida County,227,88,74,5,9,0,0,0,0,0,227,88,74,5,9,556,27,529
360650243013,36, New York,065, Oneida County,422,198,92,98,8,0,0,0,0,0,422,198,92,98,8,1169,78,1091
360650243021,36, New York,065, Oneida County,364,150,113,7,30,0,0,0,0,0,364,150,113,7,30,1090,107,983
360650243022,36, New York,065, Oneida County,567,191,87,24,80,44,36,12,0,24,523,155,75,24,56,1389,101,1288
360650243031,36, New York,065, Oneida County,314,113,73,32,8,28,14,14,0,0,286,99,59,32,8,875,128,747
360650243032,36, New York,065, Oneida County,382,190,147,11,32,26,20,0,0,20,356,170,147,11,12,1102,68,1034
360650244001,36, New York,065, Oneida County,376,149,108,4,37,21,21,11,0,10,355,128,97,4,27,1050,123,927
360650244002,36, New York,065, Oneida County,400,194,132,12,50,35,25,0,0,25,365,169,132,12,25,839,55,784
360650244003,36, New York,065, Oneida County,322,146,118,8,20,19,19,14,0,5,303,127,104,8,15,893,88,805
360650245001,36, New York,065, Oneida County,407,91,0,0,91,100,60,0,0,60,307,31,0,0,31,1461,237,1224
360650245002,36, New York,065, Oneida County,201,0,0,0,0,46,0,0,0,0,155,0,0,0,0,534,93,441
360650245003,36, New York,065, Oneida County,625,368,189,4,175,23,23,0,0,23,602,345,189,4,152,1819,196,1623
360650247001,36, New York,065, Oneida County,507,235,61,151,23,16,16,16,0,0,491,219,45,151,23,1349,118,1231
360650247002,36, New York,065, Oneida County,431,143,97,41,5,46,3,0,0,3,385,140,97,41,2,1126,107,1019
360650247003,36, New York,065, Oneida County,412,223,151,3,69,0,0,0,0,0,412,223,151,3,69,1160,57,1103
360650247004,36, New York,065, Oneida County,420,163,110,17,36,44,44,4,4,36,376,119,106,13,0,1070,56,1014
360650248001,36, New York,065, Oneida County,207,58,7,30,21,4,4,4,0,0,203,54,3,30,21,769,50,719
360650248002,36, New York,065, Oneida County,625,247,183,0,64,22,11,0,0,11,603,236,183,0,53,1626,122,1504
360650249001,36, New York,065, Oneida County,573,194,122,42,30,21,17,0,0,17,552,177,122,42,13,1800,80,1720
360650249002,36, New York,065, Oneida County,323,90,56,4,30,25,16,5,0,11,298,74,51,4,19,1107,113,994
360650249003,36, New York,065, Oneida County,417,195,83,79,33,10,7,0,0,7,407,188,83,79,26,1416,124,1292
360650250011,36, New York,065, Oneida County,251,125,98,18,9,9,0,0,0,0,242,125,98,18,9,996,99,897
360650250012,36, New York,065, Oneida County,189,43,28,11,4,40,9,9,0,0,149,34,19,11,4,538,92,446
360650250013,36, New York,065, Oneida County,201,33,33,0,0,0,0,0,0,0,201,33,33,0,0,654,59,595
360650250021,36, New York,065, Oneida County,317,60,60,0,0,8,8,8,0,0,309,52,52,0,0,863,96,767
360650250022,36, New York,065, Oneida County,310,120,101,6,13,25,0,0,0,0,285,120,101,6,13,1010,163,847
360650250023,36, New York,065, Oneida County,203,49,24,6,19,0,0,0,0,0,203,49,24,6,19,547,26,521
360650250024,36, New York,065, Oneida County,433,206,201,0,5,12,0,0,0,0,421,206,201,0,5,909,38,871
360650250031,36, New York,065, Oneida County,37,4,0,0,4,0,0,0,0,0,37,4,0,0,4,116,0,116
360650250032,36, New York,065, Oneida County,300,182,160,0,22,24,24,14,0,10,276,158,146,0,12,849,91,758
360650251001,36, New York,065, Oneida County,173,74,40,0,34,16,3,3,0,0,157,71,37,0,34,668,72,596
360650251002,36, New York,065, Oneida County,282,137,70,33,34,9,9,9,0,0,273,128,61,33,34,831,48,783
360650252001,36, New York,065, Oneida County,605,126,111,0,15,42,0,0,0,0,563,126,111,0,15,2030,153,1877
360650252002,36, New York,065, Oneida County,476,154,142,0,12,16,0,0,0,0,460,154,142,0,12,1620,109,1511
360650253001,36, New York,065, Oneida County,303,202,177,0,25,0,0,0,0,0,303,202,177,0,25,912,14,898
360650253002,36, New York,065, Oneida County,664,306,293,0,13,0,0,0,0,0,664,306,293,0,13,1604,31,1573
360650253003,36, New York,065, Oneida County,181,66,20,0,46,0,0,0,0,0,181,66,20,0,46,512,0,512
360650253004,36, New York,065, Oneida County,402,116,82,0,34,0,0,0,0,0,402,116,82,0,34,978,1,977
360650253005,36, New York,065, Oneida County,502,102,84,0,18,0,0,0,0,0,502,102,84,0,18,1421,70,1351
360650254001,36, New York,065, Oneida County,231,91,91,0,0,0,0,0,0,0,231,91,91,0,0,719,21,698
360650254002,36, New York,065, Oneida County,360,130,130,0,0,0,0,0,0,0,360,130,130,0,0,840,17,823
360650254003,36, New York,065, Oneida County,547,349,302,0,47,14,0,0,0,0,533,349,302,0,47,1356,74,1282
360650254004,36, New York,065, Oneida County,436,26,26,0,0,1,0,0,0,0,435,26,26,0,0,1230,210,1020
360650255001,36, New York,065, Oneida County,440,267,195,56,16,10,0,0,0,0,430,267,195,56,16,1145,84,1061
360650255002,36, New York,065, Oneida County,292,139,105,34,0,0,0,0,0,0,292,139,105,34,0,647,9,638
360650255003,36, New York,065, Oneida County,499,245,213,21,11,16,16,16,0,0,483,229,197,21,11,1382,79,1303
360650256011,36, New York,065, Oneida County,412,163,153,0,10,19,19,16,0,3,393,144,137,0,7,1073,17,1056
360650256012,36, New York,065, Oneida County,204,85,78,0,7,0,0,0,0,0,204,85,78,0,7,586,6,580
360650256021,36, New York,065, Oneida County,375,150,108,15,27,48,21,6,15,0,327,129,102,0,27,1019,138,881
360650256022,36, New York,065, Oneida County,142,82,65,2,15,4,4,4,0,0,138,78,61,2,15,501,99,402
360650257001,36, New York,065, Oneida County,385,147,101,8,38,12,6,0,0,6,373,141,101,8,32,1161,72,1089
360650257002,36, New York,065, Oneida County,288,120,83,0,37,5,0,0,0,0,283,120,83,0,37,741,20,721
360650258001,36, New York,065, Oneida County,242,102,62,21,19,9,0,0,0,0,233,102,62,21,19,611,38,573
360650258002,36, New York,065, Oneida County,150,89,43,15,31,37,29,9,15,5,113,60,34,0,26,472,155,317
360650259001,36, New York,065, Oneida County,0,0,0,0,0,0,0,0,0,0,0,0,0,0,0,84,74,10
360650261001,36, New York,065, Oneida County,294,141,118,6,17,16,16,7,4,5,278,125,111,2,12,917,103,814
360650261002,36, New York,065, Oneida County,0,0,0,0,0,0,0,0,0,0,0,0,0,0,0,0,0,0
360650261003,36, New York,065, Oneida County,344,136,118,9,9,7,7,7,0,0,337,129,111,9,9,617,19,598
360650262001,36, New York,065, Oneida County,298,113,113,0,0,0,0,0,0,0,298,113,113,0,0,1001,49,952
360650262002,36, New York,065, Oneida County,293,179,179,0,0,0,0,0,0,0,293,179,179,0,0,804,18,786
360650262003,36, New York,065, Oneida County,382,156,143,13,0,0,0,0,0,0,382,156,143,13,0,1305,18,1287
360650262004,36, New York,065, Oneida County,591,225,173,36,16,16,16,0,0,16,575,209,173,36,0,1649,85,1564
360650263001,36, New York,065, Oneida County,333,249,67,0,182,179,154,67,0,87,154,95,0,0,95,933,533,400
360650263002,36, New York,065, Oneida County,239,85,69,0,16,20,0,0,0,0,219,85,69,0,16,887,138,749
360650263003,36, New York,065, Oneida County,175,21,0,0,21,30,9,0,0,9,145,12,0,0,12,885,247,638
360650264001,36, New York,065, Oneida County,197,128,0,0,128,128,128,0,0,128,69,0,0,0,0,581,167,414
360650264002,36, New York,065, Oneida County,191,107,15,53,39,92,92,0,53,39,99,15,15,0,0,644,221,423
360650264003,36, New York,065, Oneida County,314,234,61,0,173,173,173,0,0,173,141,61,61,0,0,1163,569,594
360650264004,36, New York,065, Oneida County,173,125,40,35,50,35,35,0,35,0,138,90,40,0,50,809,197,612
360650264005,36, New York,065, Oneida County,231,180,113,0,67,86,35,0,0,35,145,145,113,0,32,447,184,263
360650265011,36, New York,065, Oneida County,0,0,0,0,0,0,0,0,0,0,0,0,0,0,0,0,0,0
360650265021,36, New York,065, Oneida County,4,0,0,0,0,0,0,0,0,0,4,0,0,0,0,146,96,50
360650266001,36, New York,065, Oneida County,0,0,0,0,0,0,0,0,0,0,0,0,0,0,0,4,0,4
360650267000,36, New York,065, Oneida County,0,0,0,0,0,0,0,0,0,0,0,0,0,0,0,0,0,0
360650267001,36, New York,065, Oneida County,661,272,122,81,69,23,19,19,0,0,638,253,103,81,69,1714,244,1470
360650267002,36, New York,065, Oneida County,16,16,0,0,16,0,0,0,0,0,16,16,0,0,16,176,0,176
360650267003,36, New York,065, Oneida County,591,238,184,44,10,0,0,0,0,0,591,238,184,44,10,1621,47,1574
360650267004,36, New York,065, Oneida County,175,77,60,3,14,15,3,0,3,0,160,74,60,0,14,734,135,599
360659800021,36, New York,065, Oneida County,0,0,0,0,0,0,0,0,0,0,0,0,0,0,0,0,0,0
360659800031,36, New York,065, Oneida County,0,0,0,0,0,0,0,0,0,0,0,0,0,0,0,0,0,0
360659801001,36, New York,065, Oneida County,0,0,0,0,0,0,0,0,0,0,0,0,0,0,0,4,0,4
360979501001,36, New York,097, Schuyler County,494,399,278,0,121,86,86,24,0,62,408,313,254,0,59,1139,152,987
360979501002,36, New York,097, Schuyler County,131,49,49,0,0,0,0,0,0,0,131,49,49,0,0,391,20,371
360979501003,36, New York,097, Schuyler County,474,167,129,15,23,24,23,0,0,23,450,144,129,15,0,1189,70,1119
360979501004,36, New York,097, Schuyler County,439,116,21,95,0,68,53,0,53,0,371,63,21,42,0,1148,166,982
360979502001,36, New York,097, Schuyler County,218,100,93,0,7,16,8,8,0,0,202,92,85,0,7,750,69,681
360979502002,36, New York,097, Schuyler County,191,63,59,0,4,8,4,0,0,4,183,59,59,0,0,650,27,623
360979503001,36, New York,097, Schuyler County,176,93,34,40,19,43,33,9,9,15,133,60,25,31,4,590,144,446
360979503002,36, New York,097, Schuyler County,327,136,85,22,29,40,37,17,4,16,287,99,68,18,13,1092,148,944
360979503003,36, New York,097, Schuyler County,221,27,15,2,10,15,9,5,0,4,206,18,10,2,6,638,73,565
360979504001,36, New York,097, Schuyler County,219,67,60,0,7,0,0,0,0,0,219,67,60,0,7,943,185,758
360979504002,36, New York,097, Schuyler County,192,83,34,12,37,19,8,8,0,0,173,75,26,12,37,784,145,639
360979504003,36, New York,097, Schuyler County,285,108,95,0,13,12,12,10,0,2,273,96,85,0,11,970,167,803
360979504004,36, New York,097, Schuyler County,82,18,18,0,0,4,0,0,0,0,78,18,18,0,0,415,56,359
360979505001,36, New York,097, Schuyler County,201,106,64,34,8,35,35,0,32,3,166,71,64,2,5,688,110,578
360979505002,36, New York,097, Schuyler County,183,41,28,2,11,4,0,0,0,0,179,41,28,2,11,589,53,536
360979505003,36, New York,097, Schuyler County,246,107,82,0,25,24,18,0,0,18,222,89,82,0,7,657,59,598
360979505004,36, New York,097, Schuyler County,161,84,61,8,15,42,21,0,8,13,119,63,61,0,2,545,96,449
360979505005,36, New York,097, Schuyler County,116,18,11,0,7,32,7,0,0,7,84,11,11,0,0,456,106,350
360979505006,36, New York,097, Schuyler County,231,102,81,11,10,37,34,24,0,10,194,68,57,11,0,648,118,530
360419501001,36, New York,041, Hamilton County,174,63,47,1,15,10,10,0,0,10,164,53,47,1,5,679,106,573
360419501002,36, New York,041, Hamilton County,19,9,9,0,0,0,0,0,0,0,19,9,9,0,0,112,2,110
360419503001,36, New York,041, Hamilton County,151,26,26,0,0,0,0,0,0,0,151,26,26,0,0,674,16,658
360419503002,36, New York,041, Hamilton County,97,23,21,2,0,0,0,0,0,0,97,23,21,2,0,287,7,280
360419504001,36, New York,041, Hamilton County,175,81,47,14,20,0,0,0,0,0,175,81,47,14,20,488,31,457
360419504002,36, New York,041, Hamilton County,268,88,45,20,23,18,14,0,5,9,250,74,45,15,14,1047,189,858
360419505001,36, New York,041, Hamilton County,74,24,22,2,0,2,0,0,0,0,72,24,22,2,0,296,17,279
360419505002,36, New York,041, Hamilton County,200,26,18,0,8,17,4,1,0,3,183,22,17,0,5,795,95,700
360957401001,36, New York,095, Schoharie County,176,68,48,0,20,0,0,0,0,0,176,68,48,0,20,517,19,498
360957401002,36, New York,095, Schoharie County,305,126,87,27,12,6,4,0,0,4,299,122,87,27,8,945,57,888
360957401003,36, New York,095, Schoharie County,269,82,59,0,23,11,1,1,0,0,258,81,58,0,23,975,117,858
360957401004,36, New York,095, Schoharie County,178,93,42,0,51,19,19,0,0,19,159,74,42,0,32,572,144,428
360957401005,36, New York,095, Schoharie County,324,181,152,6,23,9,9,4,0,5,315,172,148,6,18,813,22,791
360957402001,36, New York,095, Schoharie County,340,129,109,0,20,0,0,0,0,0,340,129,109,0,20,1019,63,956
360957402002,36, New York,095, Schoharie County,294,105,105,0,0,0,0,0,0,0,294,105,105,0,0,736,12,724
360957402003,36, New York,095, Schoharie County,206,141,130,0,11,11,11,0,0,11,195,130,130,0,0,510,35,475
360957402004,36, New York,095, Schoharie County,375,86,49,20,17,20,20,0,20,0,355,66,49,0,17,1360,241,1119
360957402005,36, New York,095, Schoharie County,138,66,48,18,0,5,0,0,0,0,133,66,48,18,0,631,77,554
360957403001,36, New York,095, Schoharie County,0,0,0,0,0,0,0,0,0,0,0,0,0,0,0,0,0,0
360957404001,36, New York,095, Schoharie County,187,110,70,24,16,21,18,11,0,7,166,92,59,24,9,542,68,474
360957404002,36, New York,095, Schoharie County,307,79,60,8,11,12,4,0,0,4,295,75,60,8,7,897,49,848
360957404003,36, New York,095, Schoharie County,345,107,66,8,33,47,37,12,0,25,298,70,54,8,8,943,113,830
360957404004,36, New York,095, Schoharie County,308,117,81,13,23,30,23,9,6,8,278,94,72,7,15,893,185,708
360957404005,36, New York,095, Schoharie County,261,147,57,24,66,42,37,10,7,20,219,110,47,17,46,758,138,620
360957405001,36, New York,095, Schoharie County,253,109,95,2,12,8,0,0,0,0,245,109,95,2,12,795,60,735
360957405002,36, New York,095, Schoharie County,229,68,45,14,9,1,1,0,1,0,228,67,45,13,9,720,26,694
360957405003,36, New York,095, Schoharie County,162,75,20,34,21,6,0,0,0,0,156,75,20,34,21,529,20,509
360957405004,36, New York,095, Schoharie County,182,110,57,11,42,22,10,0,0,10,160,100,57,11,32,565,85,480
360957406001,36, New York,095, Schoharie County,248,65,51,6,8,26,3,0,3,0,222,62,51,3,8,697,97,600
360957406002,36, New York,095, Schoharie County,167,77,44,2,31,14,12,0,2,10,153,65,44,0,21,474,49,425
360957406003,36, New York,095, Schoharie County,176,50,45,5,0,3,3,3,0,0,173,47,42,5,0,537,34,503
360957406004,36, New York,095, Schoharie County,162,61,27,26,8,4,4,0,4,0,158,57,27,22,8,568,36,532
360957407001,36, New York,095, Schoharie County,330,115,84,5,26,11,6,6,0,0,319,109,78,5,26,992,73,919
360957407002,36, New York,095, Schoharie County,248,71,60,0,11,9,9,3,0,6,239,62,57,0,5,704,25,679
360957407003,36, New York,095, Schoharie County,284,86,86,0,0,31,31,31,0,0,253,55,55,0,0,868,81,787
360957407004,36, New York,095, Schoharie County,265,147,73,52,22,0,0,0,0,0,265,147,73,52,22,649,65,584
360957407005,36, New York,095, Schoharie County,180,52,22,1,29,5,5,4,1,0,175,47,18,0,29,836,155,681
360957408001,36, New York,095, Schoharie County,157,47,36,8,3,3,3,0,0,3,154,44,36,8,0,481,28,453
360957408002,36, New York,095, Schoharie County,131,33,31,0,2,3,0,0,0,0,128,33,31,0,2,466,30,436
360957408003,36, New York,095, Schoharie County,290,64,42,0,22,17,5,0,0,5,273,59,42,0,17,852,83,769
360957408004,36, New York,095, Schoharie County,204,81,61,0,20,9,7,2,0,5,195,74,59,0,15,525,40,485
361190001011,36, New York,119, Westchester County,497,235,52,0,183,116,73,0,0,73,381,162,52,0,110,1119,250,869
361190001012,36, New York,119, Westchester County,352,263,89,91,83,97,91,0,91,0,255,172,89,0,83,578,54,524
361190001013,36, New York,119, Westchester County,308,132,18,0,114,45,45,0,0,45,263,87,18,0,69,616,51,565
361190001031,36, New York,119, Westchester County,60,60,0,60,0,0,0,0,0,0,60,60,0,60,0,515,289,226
361190001032,36, New York,119, Westchester County,612,450,214,37,199,81,29,0,0,29,531,421,214,37,170,1627,402,1225
361190001033,36, New York,119, Westchester County,326,297,221,0,76,105,76,0,0,76,221,221,221,0,0,601,165,436
361190001034,36, New York,119, Westchester County,116,98,0,83,15,0,0,0,0,0,116,98,0,83,15,265,0,265
361190001041,36, New York,119, Westchester County,550,378,333,0,45,0,0,0,0,0,550,378,333,0,45,1086,0,1086
361190002021,36, New York,119, Westchester County,167,62,0,36,26,95,36,0,36,0,72,26,0,0,26,609,187,422
361190002022,36, New York,119, Westchester County,441,77,64,0,13,0,0,0,0,0,441,77,64,0,13,793,0,793
361190002023,36, New York,119, Westchester County,598,212,148,0,64,77,42,0,0,42,521,170,148,0,22,1763,191,1572
361190002031,36, New York,119, Westchester County,139,65,32,0,33,33,33,0,0,33,106,32,32,0,0,307,9,298
361190002032,36, New York,119, Westchester County,276,98,0,28,70,13,0,0,0,0,263,98,0,28,70,1400,97,1303
361190002033,36, New York,119, Westchester County,333,246,135,2,109,18,18,0,0,18,315,228,135,2,91,759,115,644
361190002041,36, New York,119, Westchester County,228,82,34,25,23,0,0,0,0,0,228,82,34,25,23,737,0,737
361190002042,36, New York,119, Westchester County,195,72,27,5,40,40,40,27,0,13,155,32,0,5,27,937,276,661
361190002051,36, New York,119, Westchester County,429,162,127,0,35,77,0,0,0,0,352,162,127,0,35,966,152,814
361190002052,36, New York,119, Westchester County,184,66,0,0,66,72,51,0,0,51,112,15,0,0,15,496,217,279
361190002053,36, New York,119, Westchester County,257,191,132,0,59,0,0,0,0,0,257,191,132,0,59,509,32,477
361190003001,36, New York,119, Westchester County,168,105,0,45,60,45,45,0,45,0,123,60,0,0,60,337,110,227
361190003002,36, New York,119, Westchester County,471,170,94,42,34,6,0,0,0,0,465,170,94,42,34,1393,229,1164
361190003003,36, New York,119, Westchester County,330,219,25,35,159,41,41,0,0,41,289,178,25,35,118,405,35,370
361190004011,36, New York,119, Westchester County,170,44,0,0,44,33,16,0,0,16,137,28,0,0,28,470,93,377
361190004012,36, New York,119, Westchester County,405,311,66,0,245,91,91,0,0,91,314,220,66,0,154,1254,212,1042
361190004013,36, New York,119, Westchester County,208,126,25,0,101,28,28,0,0,28,180,98,25,0,73,912,156,756
361190004014,36, New York,119, Westchester County,405,155,60,58,37,27,0,0,0,0,378,155,60,58,37,1107,206,901
361190004031,36, New York,119, Westchester County,390,271,46,86,139,68,68,0,0,68,322,203,46,86,71,1025,144,881
361190004032,36, New York,119, Westchester County,374,179,21,19,139,146,56,0,0,56,228,123,21,19,83,1077,503,574
361190004033,36, New York,119, Westchester County,0,0,0,0,0,0,0,0,0,0,0,0,0,0,0,0,0,0
361190004034,36, New York,119, Westchester County,239,231,0,151,80,0,0,0,0,0,239,231,0,151,80,462,0,462
361190004041,36, New York,119, Westchester County,191,117,0,117,0,0,0,0,0,0,191,117,0,117,0,604,4,600
361190004042,36, New York,119, Westchester County,381,272,191,0,81,125,81,0,0,81,256,191,191,0,0,980,351,629
361190005011,36, New York,119, Westchester County,45,12,12,0,0,0,0,0,0,0,45,12,12,0,0,179,0,179
361190005012,36, New York,119, Westchester County,602,437,98,73,266,146,99,17,45,37,456,338,81,28,229,1751,303,1448
361190005021,36, New York,119, Westchester County,89,0,0,0,0,36,0,0,0,0,53,0,0,0,0,337,174,163
361190005022,36, New York,119, Westchester County,356,282,7,44,231,190,167,0,0,167,166,115,7,44,64,822,475,347
361190006011,36, New York,119, Westchester County,63,0,0,0,0,8,0,0,0,0,55,0,0,0,0,286,75,211
361190006012,36, New York,119, Westchester County,423,336,193,143,0,0,0,0,0,0,423,336,193,143,0,1155,220,935
361190006021,36, New York,119, Westchester County,254,50,50,0,0,0,0,0,0,0,254,50,50,0,0,480,60,420
361190006022,36, New York,119, Westchester County,919,357,216,0,141,94,41,0,0,41,825,316,216,0,100,2386,191,2195
361190007011,36, New York,119, Westchester County,649,231,129,0,102,106,54,54,0,0,543,177,75,0,102,1945,195,1750
361190007012,36, New York,119, Westchester County,394,200,187,0,13,0,0,0,0,0,394,200,187,0,13,1171,40,1131
361190007021,36, New York,119, Westchester County,550,292,292,0,0,0,0,0,0,0,550,292,292,0,0,2203,83,2120
361190007022,36, New York,119, Westchester County,414,202,181,0,21,21,21,0,0,21,393,181,181,0,0,1069,64,1005
361190007023,36, New York,119, Westchester County,246,198,105,0,93,23,23,0,0,23,223,175,105,0,70,767,36,731
361190008011,36, New York,119, Westchester County,403,151,96,0,55,0,0,0,0,0,403,151,96,0,55,1361,0,1361
361190008012,36, New York,119, Westchester County,169,39,39,0,0,0,0,0,0,0,169,39,39,0,0,812,0,812
361190008013,36, New York,119, Westchester County,349,135,135,0,0,0,0,0,0,0,349,135,135,0,0,1032,0,1032
361190008014,36, New York,119, Westchester County,184,69,44,0,25,22,0,0,0,0,162,69,44,0,25,665,80,585
361190008015,36, New York,119, Westchester County,410,238,151,0,87,0,0,0,0,0,410,238,151,0,87,920,22,898
361190008021,36, New York,119, Westchester County,251,156,85,6,65,82,71,0,6,65,169,85,85,0,0,590,77,513
361190008022,36, New York,119, Westchester County,395,201,137,0,64,0,0,0,0,0,395,201,137,0,64,1098,0,1098
361190008031,36, New York,119, Westchester County,558,175,107,6,62,30,30,0,0,30,528,145,107,6,32,1544,112,1432
361190008032,36, New York,119, Westchester County,385,259,156,17,86,20,20,20,0,0,365,239,136,17,86,1305,85,1220
361190008033,36, New York,119, Westchester County,402,337,113,20,204,0,0,0,0,0,402,337,113,20,204,1077,55,1022
361190009001,36, New York,119, Westchester County,266,58,21,0,37,0,0,0,0,0,266,58,21,0,37,1042,27,1015
361190009002,36, New York,119, Westchester County,317,152,152,0,0,0,0,0,0,0,317,152,152,0,0,1028,51,977
361190009003,36, New York,119, Westchester County,118,19,19,0,0,0,0,0,0,0,118,19,19,0,0,458,0,458
361190010001,36, New York,119, Westchester County,116,62,13,0,49,53,49,0,0,49,63,13,13,0,0,408,209,199
361190010002,36, New York,119, Westchester County,232,141,34,0,107,91,68,15,0,53,141,73,19,0,54,880,354,526
361190011011,36, New York,119, Westchester County,489,431,210,0,221,144,144,30,0,114,345,287,180,0,107,649,201,448
361190011012,36, New York,119, Westchester County,410,327,212,0,115,79,51,51,0,0,331,276,161,0,115,597,37,560
361190011021,36, New York,119, Westchester County,376,191,191,0,0,59,0,0,0,0,317,191,191,0,0,793,85,708
361190011022,36, New York,119, Westchester County,726,258,157,0,101,58,39,0,0,39,668,219,157,0,62,1893,215,1678
361190011023,36, New York,119, Westchester County,309,113,52,0,61,39,39,0,0,39,270,74,52,0,22,832,15,817
361190012001,36, New York,119, Westchester County,269,194,14,0,180,109,109,0,0,109,160,85,14,0,71,356,118,238
361190012002,36, New York,119, Westchester County,354,168,17,16,135,82,81,11,0,70,272,87,6,16,65,1002,127,875
361190012003,36, New York,119, Westchester County,618,507,315,94,98,110,110,67,0,43,508,397,248,94,55,1021,102,919
361190013011,36, New York,119, Westchester County,663,524,512,0,12,6,0,0,0,0,657,524,512,0,12,1495,58,1437
361190013012,36, New York,119, Westchester County,192,120,120,0,0,0,0,0,0,0,192,120,120,0,0,498,16,482
361190013013,36, New York,119, Westchester County,397,216,122,55,39,63,63,0,43,20,334,153,122,12,19,963,189,774
361190013021,36, New York,119, Westchester County,299,160,81,8,71,71,71,0,0,71,228,89,81,8,0,694,47,647
361190013022,36, New York,119, Westchester County,326,222,165,17,40,52,52,52,0,0,274,170,113,17,40,716,97,619
361190013023,36, New York,119, Westchester County,142,66,32,0,34,12,0,0,0,0,130,66,32,0,34,660,47,613
361190013041,36, New York,119, Westchester County,491,302,226,0,76,147,147,147,0,0,344,155,79,0,76,2017,981,1036
361190013042,36, New York,119, Westchester County,302,170,84,44,42,59,42,0,0,42,243,128,84,44,0,652,203,449
361190013051,36, New York,119, Westchester County,401,91,0,0,91,53,0,0,0,0,348,91,0,0,91,1140,111,1029
361190013052,36, New York,119, Westchester County,484,336,169,41,126,143,143,44,0,99,341,193,125,41,27,1058,395,663
361190014011,36, New York,119, Westchester County,198,63,47,0,16,0,0,0,0,0,198,63,47,0,16,703,0,703
361190014012,36, New York,119, Westchester County,206,37,37,0,0,103,0,0,0,0,103,37,37,0,0,615,284,331
361190014013,36, New York,119, Westchester County,463,230,80,7,143,34,25,0,0,25,429,205,80,7,118,1282,34,1248
361190014014,36, New York,119, Westchester County,180,35,26,9,0,0,0,0,0,0,180,35,26,9,0,477,0,477
361190014021,36, New York,119, Westchester County,245,71,61,0,10,3,0,0,0,0,242,71,61,0,10,764,43,721
361190014022,36, New York,119, Westchester County,165,34,29,5,0,8,0,0,0,0,157,34,29,5,0,438,38,400
361190014031,36, New York,119, Westchester County,184,66,66,0,0,66,66,66,0,0,118,0,0,0,0,381,0,381
361190014032,36, New York,119, Westchester County,252,140,104,0,36,0,0,0,0,0,252,140,104,0,36,545,13,532
361190014033,36, New York,119, Westchester County,267,107,107,0,0,84,84,84,0,0,183,23,23,0,0,895,196,699
361190014034,36, New York,119, Westchester County,63,46,17,0,29,0,0,0,0,0,63,46,17,0,29,352,16,336
361190015021,36, New York,119, Westchester County,295,112,112,0,0,40,0,0,0,0,255,112,112,0,0,992,156,836
361190015022,36, New York,119, Westchester County,176,30,16,0,14,14,14,0,0,14,162,16,16,0,0,462,41,421
361190015023,36, New York,119, Westchester County,292,181,169,0,12,0,0,0,0,0,292,181,169,0,12,902,0,902
361190015031,36, New York,119, Westchester County,102,52,10,14,28,21,21,0,14,7,81,31,10,0,21,370,77,293
361190015032,36, New York,119, Westchester County,259,159,59,41,59,17,0,0,0,0,242,159,59,41,59,1178,122,1056
361190015033,36, New York,119, Westchester County,121,49,42,0,7,0,0,0,0,0,121,49,42,0,7,384,7,377
361190015034,36, New York,119, Westchester County,0,0,0,0,0,0,0,0,0,0,0,0,0,0,0,0,0,0
361190015041,36, New York,119, Westchester County,509,297,164,62,71,19,0,0,0,0,490,297,164,62,71,1515,214,1301
361190015042,36, New York,119, Westchester County,387,123,83,0,40,10,0,0,0,0,377,123,83,0,40,1017,385,632
361190015043,36, New York,119, Westchester County,269,157,102,0,55,57,12,12,0,0,212,145,90,0,55,634,129,505
361190015044,36, New York,119, Westchester County,289,43,36,0,7,0,0,0,0,0,289,43,36,0,7,949,0,949
361190015051,36, New York,119, Westchester County,494,153,148,5,0,13,5,0,5,0,481,148,148,0,0,1629,79,1550
361190016001,36, New York,119, Westchester County,170,72,11,48,13,32,32,0,19,13,138,40,11,29,0,491,88,403
361190016002,36, New York,119, Westchester County,92,36,17,0,19,0,0,0,0,0,92,36,17,0,19,288,0,288
361190016003,36, New York,119, Westchester County,688,175,48,34,93,33,33,0,0,33,655,142,48,34,60,957,57,900
361190016004,36, New York,119, Westchester County,300,148,80,37,31,31,31,31,0,0,269,117,49,37,31,857,121,736
361190017011,36, New York,119, Westchester County,215,87,21,48,18,0,0,0,0,0,215,87,21,48,18,498,38,460
361190017012,36, New York,119, Westchester County,122,110,63,10,37,0,0,0,0,0,122,110,63,10,37,432,36,396
361190017013,36, New York,119, Westchester County,206,60,17,43,0,0,0,0,0,0,206,60,17,43,0,548,0,548
361190017014,36, New York,119, Westchester County,374,101,53,48,0,27,0,0,0,0,347,101,53,48,0,952,0,952
361190017021,36, New York,119, Westchester County,258,145,88,0,57,74,38,0,0,38,184,107,88,0,19,650,122,528
361190017022,36, New York,119, Westchester County,465,162,162,0,0,14,0,0,0,0,451,162,162,0,0,1717,65,1652
361190018001,36, New York,119, Westchester County,313,88,88,0,0,21,0,0,0,0,292,88,88,0,0,1036,49,987
361190018002,36, New York,119, Westchester County,80,39,4,23,12,8,8,0,0,8,72,31,4,23,4,170,46,124
361190019001,36, New York,119, Westchester County,379,99,81,12,6,0,0,0,0,0,379,99,81,12,6,1248,63,1185
361190020001,36, New York,119, Westchester County,292,107,98,9,0,16,0,0,0,0,276,107,98,9,0,1158,42,1116
361190020002,36, New York,119, Westchester County,184,72,72,0,0,0,0,0,0,0,184,72,72,0,0,588,61,527
361190020003,36, New York,119, Westchester County,191,77,77,0,0,0,0,0,0,0,191,77,77,0,0,494,8,486
361190020004,36, New York,119, Westchester County,412,204,194,0,10,0,0,0,0,0,412,204,194,0,10,975,25,950
361190021011,36, New York,119, Westchester County,444,151,151,0,0,0,0,0,0,0,444,151,151,0,0,1139,37,1102
361190021012,36, New York,119, Westchester County,461,274,259,0,15,0,0,0,0,0,461,274,259,0,15,921,0,921
361190021013,36, New York,119, Westchester County,332,140,99,0,41,8,8,0,0,8,324,132,99,0,33,745,16,729
361190021031,36, New York,119, Westchester County,133,62,62,0,0,0,0,0,0,0,133,62,62,0,0,580,54,526
361190021032,36, New York,119, Westchester County,290,141,141,0,0,0,0,0,0,0,290,141,141,0,0,783,0,783
361190021033,36, New York,119, Westchester County,310,183,160,0,23,0,0,0,0,0,310,183,160,0,23,800,13,787
361190021041,36, New York,119, Westchester County,295,122,103,0,19,0,0,0,0,0,295,122,103,0,19,674,16,658
361190021042,36, New York,119, Westchester County,299,127,127,0,0,0,0,0,0,0,299,127,127,0,0,1072,20,1052
361190021043,36, New York,119, Westchester County,643,328,142,153,33,153,153,0,153,0,490,175,142,0,33,1722,371,1351
361190021044,36, New York,119, Westchester County,233,38,38,0,0,14,0,0,0,0,219,38,38,0,0,770,123,647
361190021051,36, New York,119, Westchester County,153,38,38,0,0,0,0,0,0,0,153,38,38,0,0,542,64,478
361190021052,36, New York,119, Westchester County,286,104,90,0,14,0,0,0,0,0,286,104,90,0,14,746,0,746
361190021061,36, New York,119, Westchester County,349,219,106,23,90,45,45,38,0,7,304,174,68,23,83,879,99,780
361190021062,36, New York,119, Westchester County,296,155,101,12,42,49,26,15,0,11,247,129,86,12,31,734,75,659
361190021071,36, New York,119, Westchester County,409,230,154,0,76,26,26,0,0,26,383,204,154,0,50,1196,66,1130
361190022011,36, New York,119, Westchester County,228,64,59,0,5,8,8,8,0,0,220,56,51,0,5,678,30,648
361190022012,36, New York,119, Westchester County,466,153,111,33,9,7,0,0,0,0,459,153,111,33,9,1387,50,1337
361190022021,36, New York,119, Westchester County,185,74,62,0,12,0,0,0,0,0,185,74,62,0,12,463,0,463
361190022022,36, New York,119, Westchester County,366,50,50,0,0,0,0,0,0,0,366,50,50,0,0,1361,45,1316
361190022023,36, New York,119, Westchester County,359,170,170,0,0,6,0,0,0,0,353,170,170,0,0,1036,31,1005
361190022024,36, New York,119, Westchester County,495,109,95,14,0,0,0,0,0,0,495,109,95,14,0,970,0,970
361190022031,36, New York,119, Westchester County,329,211,162,35,14,0,0,0,0,0,329,211,162,35,14,1316,175,1141
361190022041,36, New York,119, Westchester County,377,124,124,0,0,0,0,0,0,0,377,124,124,0,0,973,11,962
361190022042,36, New York,119, Westchester County,253,89,41,12,36,33,12,0,12,0,220,77,41,0,36,1134,94,1040
361190022043,36, New York,119, Westchester County,269,43,29,0,14,14,0,0,0,0,255,43,29,0,14,731,29,702
361190022044,36, New York,119, Westchester County,134,42,42,0,0,0,0,0,0,0,134,42,42,0,0,613,185,428
361190023001,36, New York,119, Westchester County,661,265,203,14,48,0,0,0,0,0,661,265,203,14,48,2128,43,2085
361190023002,36, New York,119, Westchester County,387,102,85,0,17,41,0,0,0,0,346,102,85,0,17,1109,102,1007
361190024011,36, New York,119, Westchester County,504,308,205,3,100,46,40,0,0,40,458,268,205,3,60,1574,210,1364
361190024021,36, New York,119, Westchester County,281,22,0,0,22,10,10,0,0,10,271,12,0,0,12,809,53,756
361190024022,36, New York,119, Westchester County,889,166,80,56,30,18,0,0,0,0,871,166,80,56,30,2447,87,2360
361190024031,36, New York,119, Westchester County,386,146,58,25,63,6,6,0,0,6,380,140,58,25,57,1187,148,1039
361190024032,36, New York,119, Westchester County,161,58,58,0,0,0,0,0,0,0,161,58,58,0,0,369,7,362
361190024033,36, New York,119, Westchester County,208,44,44,0,0,0,0,0,0,0,208,44,44,0,0,475,0,475
361190024034,36, New York,119, Westchester County,367,120,120,0,0,117,0,0,0,0,250,120,120,0,0,852,395,457
361190024035,36, New York,119, Westchester County,261,105,49,0,56,49,49,49,0,0,212,56,0,0,56,822,112,710
361190024041,36, New York,119, Westchester County,265,152,152,0,0,0,0,0,0,0,265,152,152,0,0,801,0,801
361190024042,36, New York,119, Westchester County,399,256,218,9,29,9,9,0,0,9,390,247,218,9,20,1052,18,1034
361190024043,36, New York,119, Westchester County,282,207,190,0,17,7,7,7,0,0,275,200,183,0,17,1093,94,999
361190024051,36, New York,119, Westchester County,298,223,223,0,0,0,0,0,0,0,298,223,223,0,0,626,0,626
361190024052,36, New York,119, Westchester County,306,145,94,0,51,47,47,21,0,26,259,98,73,0,25,869,115,754
361190024053,36, New York,119, Westchester County,257,123,91,24,8,32,32,32,0,0,225,91,59,24,8,676,128,548
361190026001,36, New York,119, Westchester County,239,136,31,0,105,54,54,0,0,54,185,82,31,0,51,752,169,583
361190026002,36, New York,119, Westchester County,621,346,226,0,120,33,33,0,0,33,588,313,226,0,87,2095,94,2001
361190026003,36, New York,119, Westchester County,124,58,58,0,0,0,0,0,0,0,124,58,58,0,0,344,0,344
361190027001,36, New York,119, Westchester County,396,280,61,56,163,38,38,0,0,38,358,242,61,56,125,1306,107,1199
361190027002,36, New York,119, Westchester County,516,239,117,26,96,53,53,0,26,27,463,186,117,0,69,2170,246,1924
361190028001,36, New York,119, Westchester County,230,150,63,0,87,65,25,25,0,0,165,125,38,0,87,731,181,550
361190028002,36, New York,119, Westchester County,372,167,99,0,68,54,39,12,0,27,318,128,87,0,41,1026,192,834
361190029001,36, New York,119, Westchester County,605,378,9,0,369,245,215,0,0,215,360,163,9,0,154,2067,882,1185
361190029002,36, New York,119, Westchester County,242,142,38,38,66,29,29,0,0,29,213,113,38,38,37,854,300,554
361190030001,36, New York,119, Westchester County,256,104,55,0,49,15,15,0,0,15,241,89,55,0,34,774,53,721
361190030002,36, New York,119, Westchester County,411,190,79,0,111,34,34,0,0,34,377,156,79,0,77,1136,65,1071
361190031001,36, New York,119, Westchester County,272,191,0,57,134,203,170,0,57,113,69,21,0,0,21,698,292,406
361190031002,36, New York,119, Westchester County,357,152,45,0,107,0,0,0,0,0,357,152,45,0,107,1200,200,1000
361190032001,36, New York,119, Westchester County,166,70,36,15,19,3,3,0,0,3,163,67,36,15,16,400,12,388
361190032002,36, New York,119, Westchester County,429,304,181,0,123,123,123,49,0,74,306,181,132,0,49,1207,287,920
361190033001,36, New York,119, Westchester County,145,69,34,0,35,35,35,0,0,35,110,34,34,0,0,377,66,311
361190033002,36, New York,119, Westchester County,283,74,39,0,35,0,0,0,0,0,283,74,39,0,35,745,0,745
361190033003,36, New York,119, Westchester County,380,68,9,59,0,0,0,0,0,0,380,68,9,59,0,939,0,939
361190033004,36, New York,119, Westchester County,201,23,23,0,0,0,0,0,0,0,201,23,23,0,0,609,0,609
361190034001,36, New York,119, Westchester County,274,141,127,0,14,0,0,0,0,0,274,141,127,0,14,642,31,611
361190034002,36, New York,119, Westchester County,256,190,0,33,157,0,0,0,0,0,256,190,0,33,157,671,38,633
361190034003,36, New York,119, Westchester County,291,44,19,0,25,0,0,0,0,0,291,44,19,0,25,881,0,881
361190034004,36, New York,119, Westchester County,320,123,79,15,29,60,15,0,15,0,260,108,79,0,29,913,147,766
361190035001,36, New York,119, Westchester County,172,68,19,0,49,24,24,0,0,24,148,44,19,0,25,286,47,239
361190035002,36, New York,119, Westchester County,270,174,53,24,97,73,73,14,0,59,197,101,39,24,38,828,145,683
361190036001,36, New York,119, Westchester County,497,226,148,0,78,53,53,0,0,53,444,173,148,0,25,1807,272,1535
361190036002,36, New York,119, Westchester County,206,59,24,0,35,0,0,0,0,0,206,59,24,0,35,770,151,619
361190036003,36, New York,119, Westchester County,119,46,11,0,35,28,11,11,0,0,91,35,0,0,35,363,125,238
361190037001,36, New York,119, Westchester County,764,346,117,0,229,75,46,0,0,46,689,300,117,0,183,1806,135,1671
361190037002,36, New York,119, Westchester County,133,63,25,38,0,38,38,0,38,0,95,25,25,0,0,223,32,191
361190037003,36, New York,119, Westchester County,132,0,0,0,0,0,0,0,0,0,132,0,0,0,0,414,0,414
361190038001,36, New York,119, Westchester County,108,50,50,0,0,0,0,0,0,0,108,50,50,0,0,570,21,549
361190038002,36, New York,119, Westchester County,527,65,31,0,34,9,0,0,0,0,518,65,31,0,34,1355,65,1290
361190038003,36, New York,119, Westchester County,409,178,146,32,0,0,0,0,0,0,409,178,146,32,0,1173,122,1051
361190039001,36, New York,119, Westchester County,165,62,46,0,16,0,0,0,0,0,165,62,46,0,16,506,0,506
361190039002,36, New York,119, Westchester County,328,135,75,29,31,43,43,0,29,14,285,92,75,0,17,891,43,848
361190039003,36, New York,119, Westchester County,425,157,106,20,31,52,0,0,0,0,373,157,106,20,31,1036,85,951
361190040011,36, New York,119, Westchester County,441,244,109,0,135,116,75,0,0,75,325,169,109,0,60,993,324,669
361190040012,36, New York,119, Westchester County,363,242,114,40,88,28,28,0,0,28,335,214,114,40,60,1532,174,1358
361190040021,36, New York,119, Westchester County,265,214,161,0,53,38,38,0,0,38,227,176,161,0,15,662,0,662
361190040022,36, New York,119, Westchester County,303,189,127,0,62,0,0,0,0,0,303,189,127,0,62,785,0,785
361190040023,36, New York,119, Westchester County,113,31,22,0,9,0,0,0,0,0,113,31,22,0,9,424,8,416
361190041001,36, New York,119, Westchester County,417,195,73,0,122,63,63,0,0,63,354,132,73,0,59,1316,169,1147
361190041002,36, New York,119, Westchester County,348,182,138,25,19,29,0,0,0,0,319,182,138,25,19,1037,121,916
361190041003,36, New York,119, Westchester County,164,85,51,0,34,7,7,7,0,0,157,78,44,0,34,557,22,535
361190042001,36, New York,119, Westchester County,459,200,175,0,25,0,0,0,0,0,459,200,175,0,25,1095,17,1078
361190042002,36, New York,119, Westchester County,232,130,53,54,23,24,24,24,0,0,208,106,29,54,23,788,24,764
361190042003,36, New York,119, Westchester County,165,20,0,0,20,22,0,0,0,0,143,20,0,0,20,704,130,574
361190042004,36, New York,119, Westchester County,485,49,49,0,0,0,0,0,0,0,485,49,49,0,0,1420,220,1200
361190045001,36, New York,119, Westchester County,481,234,191,0,43,0,0,0,0,0,481,234,191,0,43,1353,111,1242
361190046001,36, New York,119, Westchester County,296,152,101,34,17,11,11,5,0,6,285,141,96,34,11,664,18,646
361190046002,36, New York,119, Westchester County,326,126,117,9,0,121,0,0,0,0,205,126,117,9,0,892,244,648
361190046003,36, New York,119, Westchester County,217,63,47,0,16,0,0,0,0,0,217,63,47,0,16,769,33,736
361190047001,36, New York,119, Westchester County,402,256,228,11,17,13,13,13,0,0,389,243,215,11,17,959,25,934
361190047002,36, New York,119, Westchester County,405,297,292,5,0,0,0,0,0,0,405,297,292,5,0,871,11,860
361190048011,36, New York,119, Westchester County,333,43,43,0,0,0,0,0,0,0,333,43,43,0,0,1087,14,1073
361190048012,36, New York,119, Westchester County,183,85,57,0,28,0,0,0,0,0,183,85,57,0,28,498,24,474
361190048013,36, New York,119, Westchester County,198,158,155,0,3,0,0,0,0,0,198,158,155,0,3,720,75,645
361190048021,36, New York,119, Westchester County,257,144,122,22,0,39,39,39,0,0,218,105,83,22,0,469,53,416
361190048022,36, New York,119, Westchester County,420,274,255,0,19,0,0,0,0,0,420,274,255,0,19,999,13,986
361190048023,36, New York,119, Westchester County,262,121,41,0,80,19,0,0,0,0,243,121,41,0,80,1337,126,1211
361190049001,36, New York,119, Westchester County,429,119,119,0,0,6,6,6,0,0,423,113,113,0,0,1495,72,1423
361190049002,36, New York,119, Westchester County,286,170,160,0,10,19,19,9,0,10,267,151,151,0,0,768,6,762
361190050011,36, New York,119, Westchester County,582,269,236,6,27,23,0,0,0,0,559,269,236,6,27,1448,126,1322
361190050012,36, New York,119, Westchester County,519,203,165,21,17,0,0,0,0,0,519,203,165,21,17,1634,42,1592
361190050021,36, New York,119, Westchester County,257,169,169,0,0,0,0,0,0,0,257,169,169,0,0,575,0,575
361190050022,36, New York,119, Westchester County,460,182,182,0,0,21,21,21,0,0,439,161,161,0,0,1169,0,1169
361190050023,36, New York,119, Westchester County,353,117,117,0,0,9,0,0,0,0,344,117,117,0,0,1260,74,1186
361190051001,36, New York,119, Westchester County,250,161,118,27,16,8,0,0,0,0,242,161,118,27,16,591,20,571
361190051002,36, New York,119, Westchester County,331,177,177,0,0,9,9,9,0,0,322,168,168,0,0,795,0,795
361190051003,36, New York,119, Westchester County,320,123,123,0,0,13,0,0,0,0,307,123,123,0,0,987,64,923
361190051004,36, New York,119, Westchester County,166,110,53,32,25,0,0,0,0,0,166,110,53,32,25,612,66,546
361190052001,36, New York,119, Westchester County,282,154,154,0,0,11,0,0,0,0,271,154,154,0,0,620,21,599
361190052002,36, New York,119, Westchester County,407,154,144,0,10,0,0,0,0,0,407,154,144,0,10,1096,19,1077
361190052003,36, New York,119, Westchester County,380,167,118,14,35,32,10,10,0,0,348,157,108,14,35,932,76,856
361190052004,36, New York,119, Westchester County,275,184,184,0,0,0,0,0,0,0,275,184,184,0,0,805,0,805
361190053001,36, New York,119, Westchester County,422,266,234,0,32,2,2,0,0,2,420,264,234,0,30,1171,15,1156
361190053002,36, New York,119, Westchester County,589,342,207,67,68,49,49,0,0,49,540,293,207,67,19,1408,52,1356
361190053003,36, New York,119, Westchester County,376,189,175,14,0,0,0,0,0,0,376,189,175,14,0,866,4,862
361190054001,36, New York,119, Westchester County,254,161,161,0,0,0,0,0,0,0,254,161,161,0,0,583,2,581
361190054002,36, New York,119, Westchester County,227,147,133,0,14,5,0,0,0,0,222,147,133,0,14,534,18,516
361190055001,36, New York,119, Westchester County,256,104,104,0,0,0,0,0,0,0,256,104,104,0,0,653,8,645
361190055002,36, New York,119, Westchester County,294,165,132,0,33,10,0,0,0,0,284,165,132,0,33,918,52,866
361190055003,36, New York,119, Westchester County,403,184,176,0,8,0,0,0,0,0,403,184,176,0,8,956,0,956
361190055004,36, New York,119, Westchester County,549,357,286,23,48,8,0,0,0,0,541,357,286,23,48,1232,21,1211
361190056001,36, New York,119, Westchester County,0,0,0,0,0,0,0,0,0,0,0,0,0,0,0,0,0,0
361190057021,36, New York,119, Westchester County,709,431,201,77,153,69,69,0,44,25,640,362,201,33,128,1891,231,1660
361190057022,36, New York,119, Westchester County,95,10,10,0,0,11,0,0,0,0,84,10,10,0,0,362,118,244
361190057031,36, New York,119, Westchester County,302,101,81,0,20,0,0,0,0,0,302,101,81,0,20,1165,198,967
361190057032,36, New York,119, Westchester County,611,98,98,0,0,12,0,0,0,0,599,98,98,0,0,1696,94,1602
361190057041,36, New York,119, Westchester County,216,53,53,0,0,0,0,0,0,0,216,53,53,0,0,1008,95,913
361190057042,36, New York,119, Westchester County,305,198,0,0,198,0,0,0,0,0,305,198,0,0,198,931,22,909
361190058001,36, New York,119, Westchester County,418,208,195,0,13,20,20,20,0,0,398,188,175,0,13,769,48,721
361190058002,36, New York,119, Westchester County,255,118,70,0,48,10,10,0,0,10,245,108,70,0,38,777,226,551
361190058003,36, New York,119, Westchester County,525,179,147,0,32,58,46,46,0,0,467,133,101,0,32,962,96,866
361190059011,36, New York,119, Westchester County,269,82,72,0,10,29,29,29,0,0,240,53,43,0,10,378,0,378
361190059012,36, New York,119, Westchester County,541,200,167,8,25,25,25,0,0,25,516,175,167,8,0,1242,33,1209
361190059013,36, New York,119, Westchester County,405,206,112,0,94,62,62,17,0,45,343,144,95,0,49,979,164,815
361190059021,36, New York,119, Westchester County,690,273,223,10,40,0,0,0,0,0,690,273,223,10,40,1892,100,1792
361190059022,36, New York,119, Westchester County,346,125,125,0,0,0,0,0,0,0,346,125,125,0,0,1456,48,1408
361190059023,36, New York,119, Westchester County,528,141,141,0,0,0,0,0,0,0,528,141,141,0,0,1848,0,1848
361190060001,36, New York,119, Westchester County,319,185,106,0,79,0,0,0,0,0,319,185,106,0,79,776,2,774
361190060002,36, New York,119, Westchester County,139,18,18,0,0,0,0,0,0,0,139,18,18,0,0,287,0,287
361190060003,36, New York,119, Westchester County,416,203,184,0,19,0,0,0,0,0,416,203,184,0,19,1179,40,1139
361190060004,36, New York,119, Westchester County,275,196,63,0,133,44,30,30,0,0,231,166,33,0,133,414,45,369
361190061001,36, New York,119, Westchester County,545,173,116,0,57,63,45,45,0,0,482,128,71,0,57,1531,242,1289
361190061002,36, New York,119, Westchester County,158,57,0,37,20,37,37,0,37,0,121,20,0,0,20,253,27,226
361190061003,36, New York,119, Westchester County,544,426,230,0,196,164,164,0,0,164,380,262,230,0,32,1246,193,1053
361190062001,36, New York,119, Westchester County,393,218,201,0,17,17,17,0,0,17,376,201,201,0,0,1362,53,1309
361190062002,36, New York,119, Westchester County,256,114,83,0,31,37,37,18,0,19,219,77,65,0,12,450,19,431
361190062003,36, New York,119, Westchester County,361,184,87,0,97,75,41,0,0,41,286,143,87,0,56,781,72,709
361190062004,36, New York,119, Westchester County,239,133,116,0,17,77,54,37,0,17,162,79,79,0,0,458,140,318
361190063011,36, New York,119, Westchester County,263,149,93,0,56,56,56,0,0,56,207,93,93,0,0,543,86,457
361190063012,36, New York,119, Westchester County,180,54,54,0,0,0,0,0,0,0,180,54,54,0,0,476,45,431
361190063013,36, New York,119, Westchester County,119,77,45,0,32,0,0,0,0,0,119,77,45,0,32,1054,217,837
361190063021,36, New York,119, Westchester County,172,55,0,0,55,0,0,0,0,0,172,55,0,0,55,753,273,480
361190063022,36, New York,119, Westchester County,436,156,156,0,0,0,0,0,0,0,436,156,156,0,0,1344,190,1154
361190064001,36, New York,119, Westchester County,193,101,101,0,0,7,0,0,0,0,186,101,101,0,0,535,14,521
361190064002,36, New York,119, Westchester County,480,372,99,74,199,217,189,0,60,129,263,183,99,14,70,1046,410,636
361190064003,36, New York,119, Westchester County,313,196,108,0,88,0,0,0,0,0,313,196,108,0,88,977,67,910
361190064004,36, New York,119, Westchester County,580,194,148,0,46,14,14,0,0,14,566,180,148,0,32,1065,34,1031
361190065001,36, New York,119, Westchester County,259,117,117,0,0,0,0,0,0,0,259,117,117,0,0,816,0,816
361190065002,36, New York,119, Westchester County,162,76,72,0,4,11,11,11,0,0,151,65,61,0,4,638,150,488
361190065003,36, New York,119, Westchester County,227,161,126,0,35,31,31,31,0,0,196,130,95,0,35,629,0,629
361190065004,36, New York,119, Westchester County,389,232,134,0,98,50,50,0,0,50,339,182,134,0,48,735,148,587
361190066001,36, New York,119, Westchester County,299,164,164,0,0,0,0,0,0,0,299,164,164,0,0,614,0,614
361190066002,36, New York,119, Westchester County,153,100,83,0,17,21,0,0,0,0,132,100,83,0,17,569,177,392
361190066003,36, New York,119, Westchester County,238,82,53,0,29,0,0,0,0,0,238,82,53,0,29,610,8,602
361190066004,36, New York,119, Westchester County,257,47,33,0,14,0,0,0,0,0,257,47,33,0,14,847,37,810
361190066005,36, New York,119, Westchester County,261,155,82,0,73,52,52,0,0,52,209,103,82,0,21,756,128,628
361190066006,36, New York,119, Westchester County,194,60,60,0,0,32,32,32,0,0,162,28,28,0,0,714,104,610
361190067001,36, New York,119, Westchester County,368,155,155,0,0,0,0,0,0,0,368,155,155,0,0,874,9,865
361190067002,36, New York,119, Westchester County,337,172,163,0,9,0,0,0,0,0,337,172,163,0,9,785,0,785
361190067003,36, New York,119, Westchester County,395,243,182,36,25,20,10,0,10,0,375,233,182,26,25,962,30,932
361190067004,36, New York,119, Westchester County,416,202,202,0,0,0,0,0,0,0,416,202,202,0,0,1052,27,1025
361190068011,36, New York,119, Westchester County,140,67,34,4,29,0,0,0,0,0,140,67,34,4,29,378,0,378
361190068012,36, New York,119, Westchester County,256,130,119,0,11,0,0,0,0,0,256,130,119,0,11,620,0,620
361190068013,36, New York,119, Westchester County,572,346,346,0,0,0,0,0,0,0,572,346,346,0,0,1403,35,1368
361190068014,36, New York,119, Westchester County,456,206,191,0,15,21,21,21,0,0,435,185,170,0,15,1019,32,987
361190068021,36, New York,119, Westchester County,376,85,85,0,0,0,0,0,0,0,376,85,85,0,0,1171,54,1117
361190068022,36, New York,119, Westchester County,331,128,109,0,19,0,0,0,0,0,331,128,109,0,19,844,0,844
361190068023,36, New York,119, Westchester County,553,308,233,43,32,11,11,0,0,11,542,297,233,43,21,1312,36,1276
361190068024,36, New York,119, Westchester County,346,205,175,15,15,0,0,0,0,0,346,205,175,15,15,847,61,786
361190069001,36, New York,119, Westchester County,328,146,146,0,0,0,0,0,0,0,328,146,146,0,0,1022,0,1022
361190069002,36, New York,119, Westchester County,205,121,121,0,0,0,0,0,0,0,205,121,121,0,0,552,1,551
361190069003,36, New York,119, Westchester County,585,374,374,0,0,0,0,0,0,0,585,374,374,0,0,1238,0,1238
361190069004,36, New York,119, Westchester County,508,291,291,0,0,0,0,0,0,0,508,291,291,0,0,1132,20,1112
361190069005,36, New York,119, Westchester County,129,129,103,26,0,0,0,0,0,0,129,129,103,26,0,305,0,305
361190070001,36, New York,119, Westchester County,504,247,82,17,148,0,0,0,0,0,504,247,82,17,148,1156,179,977
361190070002,36, New York,119, Westchester County,286,44,44,0,0,0,0,0,0,0,286,44,44,0,0,780,17,763
361190070003,36, New York,119, Westchester County,320,233,174,59,0,0,0,0,0,0,320,233,174,59,0,675,0,675
361190070004,36, New York,119, Westchester County,464,298,298,0,0,0,0,0,0,0,464,298,298,0,0,949,0,949
361190070005,36, New York,119, Westchester County,238,118,82,0,36,0,0,0,0,0,238,118,82,0,36,666,22,644
361190071001,36, New York,119, Westchester County,197,171,158,0,13,13,13,0,0,13,184,158,158,0,0,391,13,378
361190071002,36, New York,119, Westchester County,386,273,273,0,0,0,0,0,0,0,386,273,273,0,0,983,22,961
361190071003,36, New York,119, Westchester County,441,110,96,0,14,0,0,0,0,0,441,110,96,0,14,1334,15,1319
361190071004,36, New York,119, Westchester County,372,211,196,15,0,0,0,0,0,0,372,211,196,15,0,780,13,767
361190071005,36, New York,119, Westchester County,258,218,178,0,40,0,0,0,0,0,258,218,178,0,40,679,0,679
361190072001,36, New York,119, Westchester County,314,233,124,0,109,31,31,0,0,31,283,202,124,0,78,936,306,630
361190072002,36, New York,119, Westchester County,323,176,143,33,0,0,0,0,0,0,323,176,143,33,0,757,18,739
361190072003,36, New York,119, Westchester County,703,246,224,18,4,4,4,0,0,4,699,242,224,18,0,1629,29,1600
361190072004,36, New York,119, Westchester County,172,15,15,0,0,0,0,0,0,0,172,15,15,0,0,510,20,490
361190072005,36, New York,119, Westchester County,272,122,100,0,22,17,17,17,0,0,255,105,83,0,22,709,66,643
361190073001,36, New York,119, Westchester County,452,248,172,0,76,0,0,0,0,0,452,248,172,0,76,684,9,675
361190073002,36, New York,119, Westchester County,476,133,54,66,13,0,0,0,0,0,476,133,54,66,13,1354,76,1278
361190073003,36, New York,119, Westchester County,384,138,138,0,0,0,0,0,0,0,384,138,138,0,0,1053,0,1053
361190074011,36, New York,119, Westchester County,282,79,79,0,0,0,0,0,0,0,282,79,79,0,0,683,8,675
361190074012,36, New York,119, Westchester County,398,215,130,6,79,0,0,0,0,0,398,215,130,6,79,776,0,776
361190074013,36, New York,119, Westchester County,601,366,346,0,20,37,37,37,0,0,564,329,309,0,20,1254,84,1170
361190074021,36, New York,119, Westchester County,154,67,67,0,0,5,0,0,0,0,149,67,67,0,0,398,47,351
361190074022,36, New York,119, Westchester County,427,264,264,0,0,0,0,0,0,0,427,264,264,0,0,877,0,877
361190074023,36, New York,119, Westchester County,255,117,102,6,9,9,9,0,0,9,246,108,102,6,0,647,32,615
361190075001,36, New York,119, Westchester County,557,345,306,31,8,0,0,0,0,0,557,345,306,31,8,1358,56,1302
361190075002,36, New York,119, Westchester County,575,459,459,0,0,0,0,0,0,0,575,459,459,0,0,1013,19,994
361190075003,36, New York,119, Westchester County,273,159,135,9,15,0,0,0,0,0,273,159,135,9,15,623,11,612
361190076001,36, New York,119, Westchester County,273,176,125,17,34,19,10,10,0,0,254,166,115,17,34,639,66,573
361190076002,36, New York,119, Westchester County,128,86,86,0,0,17,0,0,0,0,111,86,86,0,0,435,61,374
361190076003,36, New York,119, Westchester County,241,153,153,0,0,0,0,0,0,0,241,153,153,0,0,516,0,516
361190076004,36, New York,119, Westchester County,224,186,181,0,5,0,0,0,0,0,224,186,181,0,5,500,0,500
361190076005,36, New York,119, Westchester County,361,209,189,0,20,0,0,0,0,0,361,209,189,0,20,886,0,886
361190076006,36, New York,119, Westchester County,309,202,186,10,6,23,23,23,0,0,286,179,163,10,6,859,51,808
361190077001,36, New York,119, Westchester County,231,40,40,0,0,25,0,0,0,0,206,40,40,0,0,675,49,626
361190077002,36, New York,119, Westchester County,303,108,95,3,10,0,0,0,0,0,303,108,95,3,10,941,26,915
361190077003,36, New York,119, Westchester County,396,310,231,24,55,0,0,0,0,0,396,310,231,24,55,791,10,781
361190077004,36, New York,119, Westchester County,488,318,258,13,47,0,0,0,0,0,488,318,258,13,47,1268,32,1236
361190078001,36, New York,119, Westchester County,639,472,151,14,307,297,278,53,0,225,342,194,98,14,82,758,188,570
361190078002,36, New York,119, Westchester County,456,227,200,0,27,51,51,24,0,27,405,176,176,0,0,1406,138,1268
361190079011,36, New York,119, Westchester County,340,184,127,0,57,58,58,58,0,0,282,126,69,0,57,683,100,583
361190079012,36, New York,119, Westchester County,284,262,243,0,19,0,0,0,0,0,284,262,243,0,19,534,26,508
361190079013,36, New York,119, Westchester County,180,56,56,0,0,0,0,0,0,0,180,56,56,0,0,388,0,388
361190079021,36, New York,119, Westchester County,450,277,130,89,58,65,65,0,37,28,385,212,130,52,30,1051,69,982
361190079022,36, New York,119, Westchester County,520,171,130,41,0,20,0,0,0,0,500,171,130,41,0,1161,99,1062
361190079023,36, New York,119, Westchester County,305,39,0,39,0,0,0,0,0,0,305,39,0,39,0,574,5,569
361190080001,36, New York,119, Westchester County,556,294,147,106,41,92,92,58,34,0,464,202,89,72,41,1084,186,898
361190080002,36, New York,119, Westchester County,243,144,36,19,89,125,125,36,0,89,118,19,0,19,0,570,99,471
361190080003,36, New York,119, Westchester County,373,175,89,0,86,54,0,0,0,0,319,175,89,0,86,1085,188,897
361190081001,36, New York,119, Westchester County,230,108,108,0,0,0,0,0,0,0,230,108,108,0,0,708,30,678
361190081002,36, New York,119, Westchester County,219,151,0,0,151,0,0,0,0,0,219,151,0,0,151,175,0,175
361190081003,36, New York,119, Westchester County,270,49,19,0,30,5,0,0,0,0,265,49,19,0,30,1119,19,1100
361190081004,36, New York,119, Westchester County,402,170,88,0,82,34,34,34,0,0,368,136,54,0,82,1095,171,924
361190082001,36, New York,119, Westchester County,371,85,85,0,0,0,0,0,0,0,371,85,85,0,0,1094,0,1094
361190082002,36, New York,119, Westchester County,475,255,237,0,18,0,0,0,0,0,475,255,237,0,18,1657,9,1648
361190082003,36, New York,119, Westchester County,301,157,131,0,26,0,0,0,0,0,301,157,131,0,26,843,87,756
361190082004,36, New York,119, Westchester County,654,73,73,0,0,25,0,0,0,0,629,73,73,0,0,1573,14,1559
361190082005,36, New York,119, Westchester County,188,135,113,0,22,0,0,0,0,0,188,135,113,0,22,707,106,601
361190083011,36, New York,119, Westchester County,288,52,46,6,0,7,7,7,0,0,281,45,39,6,0,725,18,707
361190083012,36, New York,119, Westchester County,383,238,226,12,0,14,14,14,0,0,369,224,212,12,0,947,35,912
361190083021,36, New York,119, Westchester County,723,487,334,0,153,0,0,0,0,0,723,487,334,0,153,1769,0,1769
361190083022,36, New York,119, Westchester County,218,113,113,0,0,0,0,0,0,0,218,113,113,0,0,520,0,520
361190083023,36, New York,119, Westchester County,612,302,179,0,123,126,126,18,0,108,486,176,161,0,15,1520,142,1378
361190083024,36, New York,119, Westchester County,560,156,144,0,12,0,0,0,0,0,560,156,144,0,12,1601,18,1583
361190084011,36, New York,119, Westchester County,310,202,189,0,13,0,0,0,0,0,310,202,189,0,13,768,0,768
361190084012,36, New York,119, Westchester County,295,100,100,0,0,26,0,0,0,0,269,100,100,0,0,718,57,661
361190084031,36, New York,119, Westchester County,346,223,177,38,8,8,8,0,0,8,338,215,177,38,0,646,24,622
361190084032,36, New York,119, Westchester County,637,446,336,33,77,38,38,0,0,38,599,408,336,33,39,1380,165,1215
361190084041,36, New York,119, Westchester County,192,85,85,0,0,0,0,0,0,0,192,85,85,0,0,774,3,771
361190084042,36, New York,119, Westchester County,310,134,134,0,0,5,0,0,0,0,305,134,134,0,0,1162,10,1152
361190084043,36, New York,119, Westchester County,256,179,70,0,109,54,54,0,0,54,202,125,70,0,55,298,0,298
361190084044,36, New York,119, Westchester County,447,322,322,0,0,20,20,20,0,0,427,302,302,0,0,1120,43,1077
361190084045,36, New York,119, Westchester County,157,32,32,0,0,0,0,0,0,0,157,32,32,0,0,526,20,506
361190085001,36, New York,119, Westchester County,478,265,250,7,8,0,0,0,0,0,478,265,250,7,8,1065,38,1027
361190085002,36, New York,119, Westchester County,194,127,118,0,9,0,0,0,0,0,194,127,118,0,9,521,0,521
361190085003,36, New York,119, Westchester County,237,165,153,12,0,0,0,0,0,0,237,165,153,12,0,634,19,615
361190086021,36, New York,119, Westchester County,247,138,138,0,0,0,0,0,0,0,247,138,138,0,0,701,0,701
361190086022,36, New York,119, Westchester County,431,276,264,0,12,0,0,0,0,0,431,276,264,0,12,1022,0,1022
361190086023,36, New York,119, Westchester County,37,27,27,0,0,0,0,0,0,0,37,27,27,0,0,109,0,109
361190086024,36, New York,119, Westchester County,376,220,212,0,8,0,0,0,0,0,376,220,212,0,8,1020,27,993
361190087001,36, New York,119, Westchester County,208,120,118,0,2,0,0,0,0,0,208,120,118,0,2,617,0,617
361190087002,36, New York,119, Westchester County,365,209,179,0,30,17,0,0,0,0,348,209,179,0,30,737,57,680
361190087003,36, New York,119, Westchester County,276,162,89,48,25,0,0,0,0,0,276,162,89,48,25,791,1,790
361190087004,36, New York,119, Westchester County,485,358,252,74,32,32,32,0,0,32,453,326,252,74,0,750,15,735
361190087005,36, New York,119, Westchester County,173,95,61,34,0,0,0,0,0,0,173,95,61,34,0,544,4,540
361190088011,36, New York,119, Westchester County,329,116,100,4,12,69,57,53,4,0,260,59,47,0,12,944,30,914
361190088021,36, New York,119, Westchester County,227,14,14,0,0,8,0,0,0,0,219,14,14,0,0,846,16,830
361190088022,36, New York,119, Westchester County,104,20,20,0,0,9,9,9,0,0,95,11,11,0,0,687,107,580
361190088023,36, New York,119, Westchester County,136,97,58,0,39,0,0,0,0,0,136,97,58,0,39,634,58,576
361190089011,36, New York,119, Westchester County,455,241,166,9,66,79,66,0,0,66,376,175,166,9,0,1354,288,1066
361190089012,36, New York,119, Westchester County,203,100,89,0,11,0,0,0,0,0,203,100,89,0,11,489,51,438
361190089013,36, New York,119, Westchester County,191,10,8,0,2,4,0,0,0,0,187,10,8,0,2,741,154,587
361190089014,36, New York,119, Westchester County,439,321,321,0,0,0,0,0,0,0,439,321,321,0,0,1105,54,1051
361190089015,36, New York,119, Westchester County,189,96,96,0,0,0,0,0,0,0,189,96,96,0,0,874,43,831
361190089021,36, New York,119, Westchester County,371,236,98,0,138,13,13,0,0,13,358,223,98,0,125,1016,77,939
361190089022,36, New York,119, Westchester County,308,109,63,19,27,0,0,0,0,0,308,109,63,19,27,954,15,939
361190089023,36, New York,119, Westchester County,230,80,80,0,0,0,0,0,0,0,230,80,80,0,0,627,0,627
361190090001,36, New York,119, Westchester County,273,70,50,15,5,0,0,0,0,0,273,70,50,15,5,961,39,922
361190090002,36, New York,119, Westchester County,762,307,184,20,103,56,56,0,0,56,706,251,184,20,47,1967,121,1846
361190091001,36, New York,119, Westchester County,408,209,183,0,26,20,20,20,0,0,388,189,163,0,26,1041,180,861
361190091002,36, New York,119, Westchester County,611,214,134,27,53,71,47,47,0,0,540,167,87,27,53,1517,130,1387
361190091003,36, New York,119, Westchester County,352,125,58,11,56,41,41,0,0,41,311,84,58,11,15,701,60,641
361190092011,36, New York,119, Westchester County,299,141,123,6,12,0,0,0,0,0,299,141,123,6,12,684,43,641
361190092012,36, New York,119, Westchester County,266,88,42,13,33,13,13,0,13,0,253,75,42,0,33,909,73,836
361190092013,36, New York,119, Westchester County,351,204,67,102,35,35,35,0,0,35,316,169,67,102,0,881,83,798
361190092021,36, New York,119, Westchester County,179,96,87,0,9,64,50,50,0,0,115,46,37,0,9,400,43,357
361190092022,36, New York,119, Westchester County,381,222,184,0,38,2,0,0,0,0,379,222,184,0,38,1110,7,1103
361190093001,36, New York,119, Westchester County,271,20,0,0,20,46,0,0,0,0,225,20,0,0,20,843,131,712
361190093002,36, New York,119, Westchester County,286,92,87,5,0,23,0,0,0,0,263,92,87,5,0,917,170,747
361190093003,36, New York,119, Westchester County,357,322,156,57,109,162,162,121,0,41,195,160,35,57,68,564,209,355
361190094001,36, New York,119, Westchester County,226,99,62,0,37,0,0,0,0,0,226,99,62,0,37,663,0,663
361190094002,36, New York,119, Westchester County,230,57,12,15,30,57,24,12,0,12,173,33,0,15,18,699,213,486
361190094003,36, New York,119, Westchester County,372,188,122,52,14,25,0,0,0,0,347,188,122,52,14,939,146,793
361190095001,36, New York,119, Westchester County,510,192,192,0,0,0,0,0,0,0,510,192,192,0,0,1585,32,1553
361190095002,36, New York,119, Westchester County,607,206,68,90,48,45,13,0,0,13,562,193,68,90,35,1851,143,1708
361190095003,36, New York,119, Westchester County,528,229,98,0,131,0,0,0,0,0,528,229,98,0,131,1457,66,1391
361190096001,36, New York,119, Westchester County,376,119,54,33,32,0,0,0,0,0,376,119,54,33,32,1136,11,1125
361190096002,36, New York,119, Westchester County,325,179,168,0,11,0,0,0,0,0,325,179,168,0,11,752,27,725
361190096003,36, New York,119, Westchester County,288,147,93,54,0,0,0,0,0,0,288,147,93,54,0,701,9,692
361190096004,36, New York,119, Westchester County,418,230,211,8,11,0,0,0,0,0,418,230,211,8,11,923,4,919
361190097011,36, New York,119, Westchester County,347,76,48,0,28,0,0,0,0,0,347,76,48,0,28,788,37,751
361190097012,36, New York,119, Westchester County,170,80,72,8,0,0,0,0,0,0,170,80,72,8,0,825,5,820
361190097013,36, New York,119, Westchester County,326,119,110,9,0,0,0,0,0,0,326,119,110,9,0,845,10,835
361190097021,36, New York,119, Westchester County,87,13,0,0,13,0,0,0,0,0,87,13,0,0,13,719,37,682
361190097022,36, New York,119, Westchester County,140,56,56,0,0,13,13,13,0,0,127,43,43,0,0,506,135,371
361190097023,36, New York,119, Westchester County,378,177,169,0,8,51,0,0,0,0,327,177,169,0,8,818,139,679
361190097031,36, New York,119, Westchester County,315,127,127,0,0,22,0,0,0,0,293,127,127,0,0,824,44,780
361190097032,36, New York,119, Westchester County,265,108,108,0,0,20,10,10,0,0,245,98,98,0,0,772,72,700
361190097033,36, New York,119, Westchester County,551,192,162,0,30,0,0,0,0,0,551,192,162,0,30,1552,23,1529
361190098001,36, New York,119, Westchester County,372,251,251,0,0,0,0,0,0,0,372,251,251,0,0,831,2,829
361190098002,36, New York,119, Westchester County,342,175,141,0,34,9,9,9,0,0,333,166,132,0,34,729,31,698
361190098003,36, New York,119, Westchester County,420,308,298,0,10,0,0,0,0,0,420,308,298,0,10,653,0,653
361190098004,36, New York,119, Westchester County,294,140,131,0,9,0,0,0,0,0,294,140,131,0,9,714,27,687
361190099001,36, New York,119, Westchester County,256,142,131,0,11,6,6,6,0,0,250,136,125,0,11,541,6,535
361190099002,36, New York,119, Westchester County,235,133,122,7,4,4,4,0,0,4,231,129,122,7,0,514,15,499
361190099003,36, New York,119, Westchester County,271,188,168,8,12,0,0,0,0,0,271,188,168,8,12,691,6,685
361190100001,36, New York,119, Westchester County,464,304,304,0,0,31,31,31,0,0,433,273,273,0,0,931,64,867
361190100002,36, New York,119, Westchester County,176,131,131,0,0,0,0,0,0,0,176,131,131,0,0,364,0,364
361190100003,36, New York,119, Westchester County,239,166,148,0,18,0,0,0,0,0,239,166,148,0,18,560,0,560
361190100004,36, New York,119, Westchester County,631,318,318,0,0,24,24,24,0,0,607,294,294,0,0,1515,34,1481
361190101001,36, New York,119, Westchester County,369,194,194,0,0,0,0,0,0,0,369,194,194,0,0,768,0,768
361190101002,36, New York,119, Westchester County,403,264,210,54,0,0,0,0,0,0,403,264,210,54,0,923,12,911
361190101003,36, New York,119, Westchester County,532,318,227,42,49,0,0,0,0,0,532,318,227,42,49,1051,0,1051
361190102001,36, New York,119, Westchester County,191,37,29,0,8,0,0,0,0,0,191,37,29,0,8,503,2,501
361190102002,36, New York,119, Westchester County,272,106,106,0,0,0,0,0,0,0,272,106,106,0,0,763,0,763
361190102003,36, New York,119, Westchester County,231,125,125,0,0,0,0,0,0,0,231,125,125,0,0,628,9,619
361190102004,36, New York,119, Westchester County,328,136,108,16,12,12,12,12,0,0,316,124,96,16,12,781,47,734
361190102005,36, New York,119, Westchester County,411,196,196,0,0,7,7,7,0,0,404,189,189,0,0,979,43,936
361190103001,36, New York,119, Westchester County,165,69,69,0,0,0,0,0,0,0,165,69,69,0,0,587,22,565
361190103002,36, New York,119, Westchester County,253,112,112,0,0,0,0,0,0,0,253,112,112,0,0,608,2,606
361190103003,36, New York,119, Westchester County,365,178,103,0,75,0,0,0,0,0,365,178,103,0,75,1250,10,1240
361190104001,36, New York,119, Westchester County,313,207,207,0,0,11,0,0,0,0,302,207,207,0,0,827,113,714
361190104002,36, New York,119, Westchester County,230,115,89,12,14,0,0,0,0,0,230,115,89,12,14,629,20,609
361190104003,36, New York,119, Westchester County,389,257,212,0,45,0,0,0,0,0,389,257,212,0,45,1060,135,925
361190105001,36, New York,119, Westchester County,512,285,190,21,74,0,0,0,0,0,512,285,190,21,74,1118,0,1118
361190105002,36, New York,119, Westchester County,304,108,74,0,34,0,0,0,0,0,304,108,74,0,34,700,0,700
361190105003,36, New York,119, Westchester County,296,180,79,0,101,15,0,0,0,0,281,180,79,0,101,806,101,705
361190105004,36, New York,119, Westchester County,451,273,187,0,86,0,0,0,0,0,451,273,187,0,86,1039,0,1039
361190105005,36, New York,119, Westchester County,403,157,142,0,15,18,18,18,0,0,385,139,124,0,15,1073,62,1011
361190106001,36, New York,119, Westchester County,567,393,378,0,15,8,0,0,0,0,559,393,378,0,15,1304,61,1243
361190106002,36, New York,119, Westchester County,374,249,232,0,17,0,0,0,0,0,374,249,232,0,17,831,3,828
361190106003,36, New York,119, Westchester County,463,180,150,0,30,0,0,0,0,0,463,180,150,0,30,1372,23,1349
361190107011,36, New York,119, Westchester County,478,264,234,11,19,7,7,0,0,7,471,257,234,11,12,1316,37,1279
361190107012,36, New York,119, Westchester County,331,195,195,0,0,0,0,0,0,0,331,195,195,0,0,885,13,872
361190107013,36, New York,119, Westchester County,369,258,249,9,0,0,0,0,0,0,369,258,249,9,0,858,0,858
361190107014,36, New York,119, Westchester County,341,153,141,0,12,12,12,0,0,12,329,141,141,0,0,714,25,689
361190107021,36, New York,119, Westchester County,332,143,143,0,0,0,0,0,0,0,332,143,143,0,0,815,0,815
361190107022,36, New York,119, Westchester County,382,264,263,1,0,0,0,0,0,0,382,264,263,1,0,594,26,568
361190107023,36, New York,119, Westchester County,159,96,96,0,0,0,0,0,0,0,159,96,96,0,0,341,6,335
361190107024,36, New York,119, Westchester County,480,49,49,0,0,29,0,0,0,0,451,49,49,0,0,1363,69,1294
361190107025,36, New York,119, Westchester County,384,138,75,0,63,40,0,0,0,0,344,138,75,0,63,1220,78,1142
361190108011,36, New York,119, Westchester County,468,131,131,0,0,0,0,0,0,0,468,131,131,0,0,1186,9,1177
361190108012,36, New York,119, Westchester County,616,317,270,19,28,37,37,37,0,0,579,280,233,19,28,1391,143,1248
361190108031,36, New York,119, Westchester County,619,172,145,12,15,13,0,0,0,0,606,172,145,12,15,2016,111,1905
361190108032,36, New York,119, Westchester County,370,127,56,30,41,37,0,0,0,0,333,127,56,30,41,1225,199,1026
361190108041,36, New York,119, Westchester County,501,134,112,0,22,0,0,0,0,0,501,134,112,0,22,1332,31,1301
361190108042,36, New York,119, Westchester County,172,42,34,0,8,0,0,0,0,0,172,42,34,0,8,438,26,412
361190109011,36, New York,119, Westchester County,446,223,187,22,14,58,49,38,11,0,388,174,149,11,14,1393,100,1293
361190109021,36, New York,119, Westchester County,656,302,218,0,84,0,0,0,0,0,656,302,218,0,84,1336,13,1323
361190109022,36, New York,119, Westchester County,345,137,132,5,0,0,0,0,0,0,345,137,132,5,0,754,0,754
361190109023,36, New York,119, Westchester County,462,155,83,22,50,22,22,0,22,0,440,133,83,0,50,1021,41,980
361190109024,36, New York,119, Westchester County,425,269,186,0,83,0,0,0,0,0,425,269,186,0,83,999,32,967
361190109031,36, New York,119, Westchester County,492,283,133,32,118,46,0,0,0,0,446,283,133,32,118,1044,139,905
361190109032,36, New York,119, Westchester County,137,47,11,0,36,0,0,0,0,0,137,47,11,0,36,528,119,409
361190109033,36, New York,119, Westchester County,240,105,105,0,0,0,0,0,0,0,240,105,105,0,0,701,0,701
361190109034,36, New York,119, Westchester County,374,122,80,15,27,9,0,0,0,0,365,122,80,15,27,1226,37,1189
361190110001,36, New York,119, Westchester County,193,53,28,10,15,4,0,0,0,0,189,53,28,10,15,678,15,663
361190110002,36, New York,119, Westchester County,425,263,124,29,110,25,25,0,0,25,400,238,124,29,85,1274,78,1196
361190111011,36, New York,119, Westchester County,912,518,366,28,124,10,10,0,0,10,902,508,366,28,114,2709,104,2605
361190111012,36, New York,119, Westchester County,113,44,44,0,0,0,0,0,0,0,113,44,44,0,0,337,0,337
361190111013,36, New York,119, Westchester County,362,165,165,0,0,0,0,0,0,0,362,165,165,0,0,872,0,872
361190111014,36, New York,119, Westchester County,153,47,33,0,14,14,14,0,0,14,139,33,33,0,0,434,14,420
361190111021,36, New York,119, Westchester County,310,192,179,6,7,7,0,0,0,0,303,192,179,6,7,862,31,831
361190111022,36, New York,119, Westchester County,445,252,241,3,8,0,0,0,0,0,445,252,241,3,8,1172,6,1166
361190112001,36, New York,119, Westchester County,298,198,48,49,101,22,22,0,0,22,276,176,48,49,79,965,172,793
361190112002,36, New York,119, Westchester County,231,74,74,0,0,0,0,0,0,0,231,74,74,0,0,637,8,629
361190112003,36, New York,119, Westchester County,399,254,173,0,81,21,21,0,0,21,378,233,173,0,60,940,46,894
361190112004,36, New York,119, Westchester County,214,70,27,13,30,14,14,0,0,14,200,56,27,13,16,434,85,349
361190113001,36, New York,119, Westchester County,498,292,255,18,19,0,0,0,0,0,498,292,255,18,19,1269,6,1263
361190113002,36, New York,119, Westchester County,546,234,168,0,66,0,0,0,0,0,546,234,168,0,66,1286,0,1286
361190113003,36, New York,119, Westchester County,304,119,107,0,12,0,0,0,0,0,304,119,107,0,12,731,17,714
361190113004,36, New York,119, Westchester County,223,188,133,15,40,0,0,0,0,0,223,188,133,15,40,233,8,225
361190113005,36, New York,119, Westchester County,299,222,222,0,0,0,0,0,0,0,299,222,222,0,0,713,70,643
361190114011,36, New York,119, Westchester County,373,187,187,0,0,0,0,0,0,0,373,187,187,0,0,999,18,981
361190114012,36, New York,119, Westchester County,152,13,13,0,0,0,0,0,0,0,152,13,13,0,0,296,0,296
361190114013,36, New York,119, Westchester County,173,25,25,0,0,12,0,0,0,0,161,25,25,0,0,549,35,514
361190114014,36, New York,119, Westchester County,354,59,23,0,36,0,0,0,0,0,354,59,23,0,36,1271,31,1240
361190114021,36, New York,119, Westchester County,345,198,192,0,6,0,0,0,0,0,345,198,192,0,6,884,49,835
361190114022,36, New York,119, Westchester County,108,32,32,0,0,15,0,0,0,0,93,32,32,0,0,338,78,260
361190115001,36, New York,119, Westchester County,661,130,130,0,0,0,0,0,0,0,661,130,130,0,0,1633,0,1633
361190115002,36, New York,119, Westchester County,398,286,236,27,23,0,0,0,0,0,398,286,236,27,23,1224,36,1188
361190115003,36, New York,119, Westchester County,194,34,34,0,0,48,0,0,0,0,146,34,34,0,0,1169,309,860
361190115004,36, New York,119, Westchester County,138,20,20,0,0,0,0,0,0,0,138,20,20,0,0,459,27,432
361190116011,36, New York,119, Westchester County,433,352,271,0,81,26,0,0,0,0,407,352,271,0,81,703,78,625
361190116012,36, New York,119, Westchester County,423,268,20,81,167,116,81,0,47,34,307,187,20,34,133,916,422,494
361190116021,36, New York,119, Westchester County,642,381,251,53,77,65,65,41,24,0,577,316,210,29,77,1553,44,1509
361190116022,36, New York,119, Westchester County,345,231,70,19,142,20,0,0,0,0,325,231,70,19,142,616,53,563
361190117001,36, New York,119, Westchester County,405,152,127,25,0,0,0,0,0,0,405,152,127,25,0,1203,0,1203
361190117002,36, New York,119, Westchester County,422,235,204,31,0,0,0,0,0,0,422,235,204,31,0,1109,21,1088
361190118001,36, New York,119, Westchester County,171,71,71,0,0,0,0,0,0,0,171,71,71,0,0,419,0,419
361190118002,36, New York,119, Westchester County,420,210,210,0,0,0,0,0,0,0,420,210,210,0,0,1078,0,1078
361190118003,36, New York,119, Westchester County,256,111,102,0,9,0,0,0,0,0,256,111,102,0,9,898,23,875
361190118004,36, New York,119, Westchester County,340,164,146,18,0,0,0,0,0,0,340,164,146,18,0,831,1,830
361190118005,36, New York,119, Westchester County,265,167,155,0,12,0,0,0,0,0,265,167,155,0,12,632,22,610
361190119021,36, New York,119, Westchester County,555,241,159,7,75,11,11,11,0,0,544,230,148,7,75,1500,16,1484
361190119022,36, New York,119, Westchester County,314,85,73,12,0,26,0,0,0,0,288,85,73,12,0,1118,117,1001
361190119023,36, New York,119, Westchester County,273,95,63,9,23,8,0,0,0,0,265,95,63,9,23,691,90,601
361190120001,36, New York,119, Westchester County,460,221,221,0,0,10,0,0,0,0,450,221,221,0,0,1256,118,1138
361190120002,36, New York,119, Westchester County,497,166,166,0,0,0,0,0,0,0,497,166,166,0,0,1689,47,1642
361190120003,36, New York,119, Westchester County,254,72,58,0,14,0,0,0,0,0,254,72,58,0,14,682,0,682
361190121011,36, New York,119, Westchester County,382,152,152,0,0,0,0,0,0,0,382,152,152,0,0,1033,21,1012
361190121012,36, New York,119, Westchester County,571,334,303,18,13,0,0,0,0,0,571,334,303,18,13,1373,27,1346
361190121013,36, New York,119, Westchester County,536,219,199,0,20,0,0,0,0,0,536,219,199,0,20,1557,73,1484
361190121021,36, New York,119, Westchester County,332,145,135,0,10,20,0,0,0,0,312,145,135,0,10,990,92,898
361190121022,36, New York,119, Westchester County,508,288,279,0,9,6,0,0,0,0,502,288,279,0,9,1520,73,1447
361190121023,36, New York,119, Westchester County,374,124,124,0,0,0,0,0,0,0,374,124,124,0,0,1086,48,1038
361190122011,36, New York,119, Westchester County,217,142,124,0,18,0,0,0,0,0,217,142,124,0,18,721,0,721
361190122012,36, New York,119, Westchester County,275,46,46,0,0,0,0,0,0,0,275,46,46,0,0,900,13,887
361190122013,36, New York,119, Westchester County,294,222,195,0,27,0,0,0,0,0,294,222,195,0,27,704,30,674
361190122021,36, New York,119, Westchester County,294,136,126,0,10,0,0,0,0,0,294,136,126,0,10,692,0,692
361190122022,36, New York,119, Westchester County,187,138,79,0,59,69,50,0,0,50,118,88,79,0,9,426,99,327
361190122023,36, New York,119, Westchester County,329,141,121,0,20,0,0,0,0,0,329,141,121,0,20,924,21,903
361190122024,36, New York,119, Westchester County,242,190,168,0,22,0,0,0,0,0,242,190,168,0,22,841,75,766
361190123011,36, New York,119, Westchester County,359,193,167,5,21,0,0,0,0,0,359,193,167,5,21,781,36,745
361190123012,36, New York,119, Westchester County,335,135,102,6,27,0,0,0,0,0,335,135,102,6,27,877,16,861
361190123031,36, New York,119, Westchester County,507,214,189,0,25,12,12,0,0,12,495,202,189,0,13,1417,14,1403
361190123032,36, New York,119, Westchester County,399,241,192,20,29,27,4,0,0,4,372,237,192,20,25,871,61,810
361190123033,36, New York,119, Westchester County,498,253,223,0,30,20,20,0,0,20,478,233,223,0,10,1121,28,1093
361190123041,36, New York,119, Westchester County,252,115,115,0,0,0,0,0,0,0,252,115,115,0,0,840,0,840
361190123042,36, New York,119, Westchester County,414,214,214,0,0,0,0,0,0,0,414,214,214,0,0,988,2,986
361190123043,36, New York,119, Westchester County,587,315,308,7,0,0,0,0,0,0,587,315,308,7,0,1554,16,1538
361190124001,36, New York,119, Westchester County,408,127,115,0,12,12,0,0,0,0,396,127,115,0,12,1187,32,1155
361190124002,36, New York,119, Westchester County,395,169,169,0,0,10,0,0,0,0,385,169,169,0,0,1031,73,958
361190124003,36, New York,119, Westchester County,752,208,185,0,23,0,0,0,0,0,752,208,185,0,23,1761,0,1761
361190125011,36, New York,119, Westchester County,569,320,302,0,18,10,10,10,0,0,559,310,292,0,18,1368,36,1332
361190125012,36, New York,119, Westchester County,332,81,66,0,15,0,0,0,0,0,332,81,66,0,15,816,25,791
361190125021,36, New York,119, Westchester County,340,181,181,0,0,26,26,26,0,0,314,155,155,0,0,765,51,714
361190125022,36, New York,119, Westchester County,624,176,154,0,22,0,0,0,0,0,624,176,154,0,22,1451,10,1441
361190125023,36, New York,119, Westchester County,712,361,307,14,40,0,0,0,0,0,712,361,307,14,40,1755,76,1679
361190125031,36, New York,119, Westchester County,575,242,193,0,49,25,14,0,0,14,550,228,193,0,35,1499,76,1423
361190125032,36, New York,119, Westchester County,512,281,281,0,0,11,0,0,0,0,501,281,281,0,0,1399,33,1366
361190126001,36, New York,119, Westchester County,154,100,100,0,0,11,0,0,0,0,143,100,100,0,0,573,93,480
361190126002,36, New York,119, Westchester County,291,157,130,0,27,32,27,0,0,27,259,130,130,0,0,732,45,687
361190126003,36, New York,119, Westchester County,480,249,146,0,103,94,94,0,0,94,386,155,146,0,9,1121,94,1027
361190126004,36, New York,119, Westchester County,266,155,147,8,0,16,16,16,0,0,250,139,131,8,0,581,32,549
361190126005,36, New York,119, Westchester County,44,17,17,0,0,0,0,0,0,0,44,17,17,0,0,118,0,118
361190127001,36, New York,119, Westchester County,294,177,177,0,0,0,0,0,0,0,294,177,177,0,0,797,24,773
361190127002,36, New York,119, Westchester County,413,181,171,0,10,37,0,0,0,0,376,181,171,0,10,1289,116,1173
361190127003,36, New York,119, Westchester County,261,145,99,0,46,12,12,0,0,12,249,133,99,0,34,767,59,708
361190127004,36, New York,119, Westchester County,238,111,111,0,0,0,0,0,0,0,238,111,111,0,0,674,0,674
361190128031,36, New York,119, Westchester County,291,184,145,39,0,22,22,22,0,0,269,162,123,39,0,974,155,819
361190128032,36, New York,119, Westchester County,310,127,127,0,0,15,0,0,0,0,295,127,127,0,0,819,30,789
361190128033,36, New York,119, Westchester County,127,68,68,0,0,0,0,0,0,0,127,68,68,0,0,367,0,367
361190128041,36, New York,119, Westchester County,498,298,158,0,140,87,87,0,0,87,411,211,158,0,53,930,87,843
361190128042,36, New York,119, Westchester County,290,125,125,0,0,8,0,0,0,0,282,125,125,0,0,614,17,597
361190128043,36, New York,119, Westchester County,257,115,31,38,46,46,46,0,0,46,211,69,31,38,0,852,180,672
361190129001,36, New York,119, Westchester County,245,154,78,26,50,0,0,0,0,0,245,154,78,26,50,965,103,862
361190129002,36, New York,119, Westchester County,550,298,277,0,21,16,16,16,0,0,534,282,261,0,21,1429,127,1302
361190129003,36, New York,119, Westchester County,149,104,38,52,14,5,0,0,0,0,144,104,38,52,14,435,26,409
361190130001,36, New York,119, Westchester County,155,94,94,0,0,0,0,0,0,0,155,94,94,0,0,517,3,514
361190130002,36, New York,119, Westchester County,347,129,129,0,0,52,0,0,0,0,295,129,129,0,0,1117,220,897
361190130003,36, New York,119, Westchester County,437,337,337,0,0,0,0,0,0,0,437,337,337,0,0,1143,0,1143
361190130004,36, New York,119, Westchester County,310,115,115,0,0,0,0,0,0,0,310,115,115,0,0,958,50,908
361190130005,36, New York,119, Westchester County,182,101,35,0,66,0,0,0,0,0,182,101,35,0,66,375,32,343
361190131021,36, New York,119, Westchester County,252,188,116,17,55,38,38,0,0,38,214,150,116,17,17,565,38,527
361190131022,36, New York,119, Westchester County,443,177,147,0,30,0,0,0,0,0,443,177,147,0,30,1245,3,1242
361190131023,36, New York,119, Westchester County,708,348,331,0,17,18,18,18,0,0,690,330,313,0,17,1533,53,1480
361190131024,36, New York,119, Westchester County,651,339,226,83,30,0,0,0,0,0,651,339,226,83,30,1446,0,1446
361190131031,36, New York,119, Westchester County,793,501,442,0,59,30,0,0,0,0,763,501,442,0,59,1952,61,1891
361190131032,36, New York,119, Westchester County,771,323,302,10,11,0,0,0,0,0,771,323,302,10,11,2150,7,2143
361190131041,36, New York,119, Westchester County,369,169,151,18,0,10,0,0,0,0,359,169,151,18,0,934,21,913
361190131042,36, New York,119, Westchester County,184,87,87,0,0,15,0,0,0,0,169,87,87,0,0,447,30,417
361190131043,36, New York,119, Westchester County,493,265,242,0,23,0,0,0,0,0,493,265,242,0,23,1157,0,1157
361190131044,36, New York,119, Westchester County,624,397,373,24,0,0,0,0,0,0,624,397,373,24,0,1285,0,1285
361190132011,36, New York,119, Westchester County,447,153,145,8,0,10,10,10,0,0,437,143,135,8,0,961,49,912
361190132012,36, New York,119, Westchester County,626,277,277,0,0,33,33,33,0,0,593,244,244,0,0,1647,156,1491
361190132021,36, New York,119, Westchester County,551,332,251,0,81,11,0,0,0,0,540,332,251,0,81,1393,94,1299
361190132022,36, New York,119, Westchester County,348,82,65,17,0,9,0,0,0,0,339,82,65,17,0,890,50,840
361190133011,36, New York,119, Westchester County,707,363,197,38,128,24,24,0,0,24,683,339,197,38,104,1049,19,1030
361190133012,36, New York,119, Westchester County,290,165,56,54,55,32,32,0,0,32,258,133,56,54,23,1014,200,814
361190133041,36, New York,119, Westchester County,189,92,80,12,0,0,0,0,0,0,189,92,80,12,0,590,18,572
361190133042,36, New York,119, Westchester County,473,289,216,27,46,54,54,32,0,22,419,235,184,27,24,755,56,699
361190133043,36, New York,119, Westchester County,572,196,182,0,14,0,0,0,0,0,572,196,182,0,14,1433,12,1421
361190134011,36, New York,119, Westchester County,135,67,67,0,0,0,0,0,0,0,135,67,67,0,0,431,46,385
361190134012,36, New York,119, Westchester County,319,171,141,0,30,12,12,12,0,0,307,159,129,0,30,936,76,860
361190134013,36, New York,119, Westchester County,136,89,56,0,33,33,33,0,0,33,103,56,56,0,0,520,98,422
361190134021,36, New York,119, Westchester County,472,197,173,0,24,0,0,0,0,0,472,197,173,0,24,921,33,888
361190134022,36, New York,119, Westchester County,207,98,98,0,0,0,0,0,0,0,207,98,98,0,0,295,19,276
361190134023,36, New York,119, Westchester County,724,277,197,0,80,89,28,28,0,0,635,249,169,0,80,1363,103,1260
361190135001,36, New York,119, Westchester County,589,282,214,20,48,0,0,0,0,0,589,282,214,20,48,1548,4,1544
361190135002,36, New York,119, Westchester County,296,59,59,0,0,0,0,0,0,0,296,59,59,0,0,880,20,860
361190135003,36, New York,119, Westchester County,276,57,45,0,12,14,0,0,0,0,262,57,45,0,12,852,51,801
361190136001,36, New York,119, Westchester County,187,99,79,0,20,23,0,0,0,0,164,99,79,0,20,621,49,572
361190136002,36, New York,119, Westchester County,417,141,83,0,58,0,0,0,0,0,417,141,83,0,58,1242,0,1242
361190136003,36, New York,119, Westchester County,602,198,131,11,56,50,19,0,0,19,552,179,131,11,37,1605,127,1478
361190137001,36, New York,119, Westchester County,571,179,147,0,32,0,0,0,0,0,571,179,147,0,32,1397,6,1391
361190137002,36, New York,119, Westchester County,550,212,184,28,0,38,13,0,13,0,512,199,184,15,0,1638,346,1292
361190137003,36, New York,119, Westchester County,423,89,54,35,0,0,0,0,0,0,423,89,54,35,0,1392,107,1285
361190138001,36, New York,119, Westchester County,312,137,115,16,6,0,0,0,0,0,312,137,115,16,6,840,8,832
361190138002,36, New York,119, Westchester County,304,152,147,0,5,0,0,0,0,0,304,152,147,0,5,702,0,702
361190138003,36, New York,119, Westchester County,352,130,130,0,0,23,0,0,0,0,329,130,130,0,0,1010,99,911
361190139001,36, New York,119, Westchester County,185,83,61,15,7,0,0,0,0,0,185,83,61,15,7,429,0,429
361190139002,36, New York,119, Westchester County,211,136,88,18,30,17,10,0,10,0,194,126,88,8,30,482,29,453
361190139003,36, New York,119, Westchester County,200,109,97,12,0,0,0,0,0,0,200,109,97,12,0,644,24,620
361190139004,36, New York,119, Westchester County,694,394,267,49,78,0,0,0,0,0,694,394,267,49,78,1823,46,1777
361190140001,36, New York,119, Westchester County,408,154,124,0,30,11,6,0,0,6,397,148,124,0,24,1073,39,1034
361190140002,36, New York,119, Westchester County,207,125,116,9,0,0,0,0,0,0,207,125,116,9,0,667,25,642
361190141001,36, New York,119, Westchester County,451,171,148,0,23,20,0,0,0,0,431,171,148,0,23,1408,137,1271
361190141002,36, New York,119, Westchester County,158,56,27,29,0,29,29,0,29,0,129,27,27,0,0,606,219,387
361190141003,36, New York,119, Westchester County,621,183,119,0,64,0,0,0,0,0,621,183,119,0,64,1332,37,1295
361190141004,36, New York,119, Westchester County,0,0,0,0,0,0,0,0,0,0,0,0,0,0,0,216,86,130
361190141005,36, New York,119, Westchester County,445,265,246,0,19,19,19,0,0,19,426,246,246,0,0,1418,79,1339
361190142001,36, New York,119, Westchester County,98,53,53,0,0,20,20,20,0,0,78,33,33,0,0,209,36,173
361190142002,36, New York,119, Westchester County,462,182,106,0,76,45,45,0,0,45,417,137,106,0,31,1496,250,1246
361190142003,36, New York,119, Westchester County,347,182,143,0,39,0,0,0,0,0,347,182,143,0,39,731,0,731
361190143001,36, New York,119, Westchester County,261,94,70,24,0,0,0,0,0,0,261,94,70,24,0,726,51,675
361190143002,36, New York,119, Westchester County,406,261,187,22,52,19,19,19,0,0,387,242,168,22,52,889,61,828
361190143003,36, New York,119, Westchester County,266,118,26,19,73,0,0,0,0,0,266,118,26,19,73,724,232,492
361190144001,36, New York,119, Westchester County,328,134,103,0,31,32,32,9,0,23,296,102,94,0,8,1023,115,908
361190144002,36, New York,119, Westchester County,800,184,149,0,35,75,0,0,0,0,725,184,149,0,35,1820,266,1554
361190144003,36, New York,119, Westchester County,605,232,206,26,0,0,0,0,0,0,605,232,206,26,0,1701,57,1644
361190145001,36, New York,119, Westchester County,257,137,55,20,62,6,6,0,0,6,251,131,55,20,56,529,0,529
361190145002,36, New York,119, Westchester County,183,51,27,0,24,0,0,0,0,0,183,51,27,0,24,425,0,425
361190145003,36, New York,119, Westchester County,419,114,82,0,32,27,0,0,0,0,392,114,82,0,32,1263,139,1124
361190145004,36, New York,119, Westchester County,224,14,14,0,0,0,0,0,0,0,224,14,14,0,0,719,53,666
361190145005,36, New York,119, Westchester County,79,19,0,0,19,0,0,0,0,0,79,19,0,0,19,748,46,702
361190146041,36, New York,119, Westchester County,658,312,259,11,42,30,20,9,11,0,628,292,250,0,42,2141,200,1941
361190146042,36, New York,119, Westchester County,235,103,58,0,45,22,22,22,0,0,213,81,36,0,45,754,114,640
361190146043,36, New York,119, Westchester County,167,43,43,0,0,0,0,0,0,0,167,43,43,0,0,703,52,651
361190146051,36, New York,119, Westchester County,203,148,127,0,21,41,25,25,0,0,162,123,102,0,21,681,107,574
361190146052,36, New York,119, Westchester County,294,131,94,19,18,19,10,0,0,10,275,121,94,19,8,1184,181,1003
361190146053,36, New York,119, Westchester County,70,39,39,0,0,7,0,0,0,0,63,39,39,0,0,383,33,350
361190146061,36, New York,119, Westchester County,493,237,146,57,34,0,0,0,0,0,493,237,146,57,34,1288,0,1288
361190146062,36, New York,119, Westchester County,493,121,112,9,0,0,0,0,0,0,493,121,112,9,0,1302,113,1189
361190146063,36, New York,119, Westchester County,413,80,80,0,0,0,0,0,0,0,413,80,80,0,0,1028,0,1028
361190146064,36, New York,119, Westchester County,270,102,102,0,0,0,0,0,0,0,270,102,102,0,0,699,28,671
361190146071,36, New York,119, Westchester County,458,209,199,0,10,0,0,0,0,0,458,209,199,0,10,1308,12,1296
361190146072,36, New York,119, Westchester County,429,225,215,0,10,0,0,0,0,0,429,225,215,0,10,1199,15,1184
361190146073,36, New York,119, Westchester County,307,172,142,14,16,0,0,0,0,0,307,172,142,14,16,894,8,886
361190147011,36, New York,119, Westchester County,190,85,27,0,58,0,0,0,0,0,190,85,27,0,58,534,54,480
361190147012,36, New York,119, Westchester County,311,82,77,5,0,12,0,0,0,0,299,82,77,5,0,1097,29,1068
361190147013,36, New York,119, Westchester County,475,208,163,0,45,34,34,0,0,34,441,174,163,0,11,1253,111,1142
361190147014,36, New York,119, Westchester County,242,75,75,0,0,0,0,0,0,0,242,75,75,0,0,760,35,725
361190147031,36, New York,119, Westchester County,487,299,150,0,149,0,0,0,0,0,487,299,150,0,149,1407,14,1393
361190147032,36, New York,119, Westchester County,294,141,40,61,40,39,24,24,0,0,255,117,16,61,40,921,107,814
361190147033,36, New York,119, Westchester County,458,185,139,25,21,0,0,0,0,0,458,185,139,25,21,1190,5,1185
361190147034,36, New York,119, Westchester County,248,162,100,0,62,62,62,0,0,62,186,100,100,0,0,689,127,562
361190147041,36, New York,119, Westchester County,510,261,192,23,46,0,0,0,0,0,510,261,192,23,46,1537,105,1432
361190148051,36, New York,119, Westchester County,607,250,200,29,21,8,0,0,0,0,599,250,200,29,21,1648,43,1605
361190148052,36, New York,119, Westchester County,536,153,153,0,0,12,0,0,0,0,524,153,153,0,0,1329,36,1293
361190148061,36, New York,119, Westchester County,617,309,255,19,35,35,35,0,0,35,582,274,255,19,0,1531,35,1496
361190148062,36, New York,119, Westchester County,254,57,57,0,0,0,0,0,0,0,254,57,57,0,0,673,14,659
361190148063,36, New York,119, Westchester County,447,257,125,95,37,109,109,14,95,0,338,148,111,0,37,1046,128,918
361190148064,36, New York,119, Westchester County,423,172,147,0,25,0,0,0,0,0,423,172,147,0,25,1177,0,1177
361190148065,36, New York,119, Westchester County,80,27,22,0,5,5,5,0,0,5,75,22,22,0,0,298,0,298
361190148081,36, New York,119, Westchester County,314,133,133,0,0,0,0,0,0,0,314,133,133,0,0,813,8,805
361190148082,36, New York,119, Westchester County,641,204,173,31,0,0,0,0,0,0,641,204,173,31,0,1953,65,1888
361190148091,36, New York,119, Westchester County,313,134,101,0,33,0,0,0,0,0,313,134,101,0,33,1060,68,992
361190148092,36, New York,119, Westchester County,99,0,0,0,0,0,0,0,0,0,99,0,0,0,0,482,101,381
361190148093,36, New York,119, Westchester County,295,109,109,0,0,0,0,0,0,0,295,109,109,0,0,842,12,830
361190148094,36, New York,119, Westchester County,928,316,289,0,27,40,40,40,0,0,888,276,249,0,27,2156,106,2050
361190148101,36, New York,119, Westchester County,395,114,102,8,4,10,0,0,0,0,385,114,102,8,4,1302,90,1212
361190148102,36, New York,119, Westchester County,48,0,0,0,0,0,0,0,0,0,48,0,0,0,0,342,15,327
361190148111,36, New York,119, Westchester County,366,111,105,6,0,0,0,0,0,0,366,111,105,6,0,1017,7,1010
361190148112,36, New York,119, Westchester County,419,229,198,7,24,18,0,0,0,0,401,229,198,7,24,897,79,818
361190148113,36, New York,119, Westchester County,294,166,147,0,19,0,0,0,0,0,294,166,147,0,19,730,0,730
361190148114,36, New York,119, Westchester County,547,172,172,0,0,0,0,0,0,0,547,172,172,0,0,1450,28,1422
361190148121,36, New York,119, Westchester County,404,212,162,0,50,0,0,0,0,0,404,212,162,0,50,971,6,965
361190148122,36, New York,119, Westchester County,368,121,121,0,0,0,0,0,0,0,368,121,121,0,0,865,14,851
361190148123,36, New York,119, Westchester County,477,252,235,0,17,49,38,38,0,0,428,214,197,0,17,1284,98,1186
361190148131,36, New York,119, Westchester County,612,230,115,0,115,41,41,0,0,41,571,189,115,0,74,1933,87,1846
361190148132,36, New York,119, Westchester County,486,342,173,0,169,19,19,0,0,19,467,323,173,0,150,1250,48,1202
361190149011,36, New York,119, Westchester County,724,378,365,0,13,12,0,0,0,0,712,378,365,0,13,1676,39,1637
361190149012,36, New York,119, Westchester County,325,125,125,0,0,0,0,0,0,0,325,125,125,0,0,1024,14,1010
361190149013,36, New York,119, Westchester County,428,158,158,0,0,0,0,0,0,0,428,158,158,0,0,1137,15,1122
361190149014,36, New York,119, Westchester County,421,207,202,0,5,28,0,0,0,0,393,207,202,0,5,963,43,920
361190149031,36, New York,119, Westchester County,468,169,133,22,14,14,14,0,0,14,454,155,133,22,0,1670,35,1635
361190149032,36, New York,119, Westchester County,329,24,0,0,24,0,0,0,0,0,329,24,0,0,24,1702,126,1576
361190149071,36, New York,119, Westchester County,302,134,134,0,0,0,0,0,0,0,302,134,134,0,0,859,9,850
361190149072,36, New York,119, Westchester County,448,165,152,0,13,0,0,0,0,0,448,165,152,0,13,1274,20,1254
361190149073,36, New York,119, Westchester County,371,162,146,0,16,0,0,0,0,0,371,162,146,0,16,943,0,943
361190149081,36, New York,119, Westchester County,580,217,183,25,9,25,25,0,25,0,555,192,183,0,9,1637,86,1551
361190149082,36, New York,119, Westchester County,544,158,131,4,23,8,8,0,0,8,536,150,131,4,15,1369,40,1329
361190149091,36, New York,119, Westchester County,451,165,127,0,38,0,0,0,0,0,451,165,127,0,38,1204,0,1204
361190149092,36, New York,119, Westchester County,99,8,8,0,0,28,0,0,0,0,71,8,8,0,0,334,68,266
361190149093,36, New York,119, Westchester County,247,96,51,1,44,12,12,0,0,12,235,84,51,1,32,596,30,566
361190150001,36, New York,119, Westchester County,557,368,312,52,4,0,0,0,0,0,557,368,312,52,4,1279,0,1279
361190150002,36, New York,119, Westchester County,94,49,49,0,0,0,0,0,0,0,94,49,49,0,0,325,11,314
361190150003,36, New York,119, Westchester County,332,134,125,0,9,0,0,0,0,0,332,134,125,0,9,830,9,821
361190150004,36, New York,119, Westchester County,402,116,116,0,0,8,8,8,0,0,394,108,108,0,0,1073,56,1017
361190151001,36, New York,119, Westchester County,136,18,18,0,0,0,0,0,0,0,136,18,18,0,0,410,10,400
361190151002,36, New York,119, Westchester County,462,142,73,5,64,0,0,0,0,0,462,142,73,5,64,1410,1,1409
361190151003,36, New York,119, Westchester County,209,90,52,38,0,0,0,0,0,0,209,90,52,38,0,633,33,600
361190151004,36, New York,119, Westchester County,353,202,105,0,97,6,6,0,0,6,347,196,105,0,91,1104,44,1060
361199810001,36, New York,119, Westchester County,52,20,20,0,0,20,0,0,0,0,32,20,20,0,0,646,577,69
361199820001,36, New York,119, Westchester County,0,0,0,0,0,0,0,0,0,0,0,0,0,0,0,0,0,0
361199830001,36, New York,119, Westchester County,0,0,0,0,0,0,0,0,0,0,0,0,0,0,0,34,12,22
361199840001,36, New York,119, Westchester County,19,10,5,0,5,0,0,0,0,0,19,10,5,0,5,300,100,200
361199850001,36, New York,119, Westchester County,0,0,0,0,0,0,0,0,0,0,0,0,0,0,0,0,0,0
360470001001,36, New York,047, Kings County,289,15,15,0,0,0,0,0,0,0,289,15,15,0,0,814,0,814
360470001002,36, New York,047, Kings County,110,34,18,0,16,16,16,0,0,16,94,18,18,0,0,377,31,346
360470001003,36, New York,047, Kings County,467,148,148,0,0,0,0,0,0,0,467,148,148,0,0,1230,16,1214
360470001004,36, New York,047, Kings County,544,314,153,19,142,63,63,0,0,63,481,251,153,19,79,1370,63,1307
360470002001,36, New York,047, Kings County,258,147,76,14,57,79,68,24,0,44,179,79,52,14,13,696,123,573
360470003011,36, New York,047, Kings County,97,19,19,0,0,0,0,0,0,0,97,19,19,0,0,448,27,421
360470003012,36, New York,047, Kings County,326,165,165,0,0,17,0,0,0,0,309,165,165,0,0,1050,83,967
360470003013,36, New York,047, Kings County,274,152,108,44,0,0,0,0,0,0,274,152,108,44,0,676,14,662
360470003014,36, New York,047, Kings County,224,112,112,0,0,0,0,0,0,0,224,112,112,0,0,608,8,600
360470003015,36, New York,047, Kings County,75,17,17,0,0,0,0,0,0,0,75,17,17,0,0,326,0,326
360470005011,36, New York,047, Kings County,276,140,89,14,37,14,14,0,14,0,262,126,89,0,37,991,20,971
360470005012,36, New York,047, Kings County,204,63,63,0,0,28,0,0,0,0,176,63,63,0,0,823,79,744
360470005013,36, New York,047, Kings County,169,24,24,0,0,0,0,0,0,0,169,24,24,0,0,646,15,631
360470005021,36, New York,047, Kings County,347,185,150,0,35,0,0,0,0,0,347,185,150,0,35,1183,59,1124
360470005022,36, New York,047, Kings County,183,48,10,0,38,0,0,0,0,0,183,48,10,0,38,855,44,811
360470007001,36, New York,047, Kings County,467,231,183,14,34,10,0,0,0,0,457,231,183,14,34,1485,163,1322
360470007002,36, New York,047, Kings County,188,110,78,0,32,32,32,0,0,32,156,78,78,0,0,542,32,510
360470007003,36, New York,047, Kings County,268,145,145,0,0,0,0,0,0,0,268,145,145,0,0,857,21,836
360470009001,36, New York,047, Kings County,690,288,212,52,24,0,0,0,0,0,690,288,212,52,24,1890,57,1833
360470009002,36, New York,047, Kings County,423,228,208,0,20,0,0,0,0,0,423,228,208,0,20,1466,25,1441
360470011001,36, New York,047, Kings County,283,110,98,0,12,15,0,0,0,0,268,110,98,0,12,1152,101,1051
360470013001,36, New York,047, Kings County,457,118,107,0,11,12,0,0,0,0,445,118,107,0,11,1739,141,1598
360470013002,36, New York,047, Kings County,0,0,0,0,0,0,0,0,0,0,0,0,0,0,0,0,0,0
360470015011,36, New York,047, Kings County,501,219,162,0,57,0,0,0,0,0,501,219,162,0,57,2109,222,1887
360470015012,36, New York,047, Kings County,589,346,0,53,293,64,64,0,0,64,525,282,0,53,229,1357,295,1062
360470015021,36, New York,047, Kings County,928,294,183,71,40,35,0,0,0,0,893,294,183,71,40,3168,536,2632
360470018010,36, New York,047, Kings County,0,0,0,0,0,0,0,0,0,0,0,0,0,0,0,0,0,0
360470018011,36, New York,047, Kings County,0,0,0,0,0,0,0,0,0,0,0,0,0,0,0,0,0,0
360470018012,36, New York,047, Kings County,0,0,0,0,0,0,0,0,0,0,0,0,0,0,0,0,0,0
360470018020,36, New York,047, Kings County,0,0,0,0,0,0,0,0,0,0,0,0,0,0,0,0,0,0
360470018021,36, New York,047, Kings County,0,0,0,0,0,0,0,0,0,0,0,0,0,0,0,0,0,0
360470018030,36, New York,047, Kings County,0,0,0,0,0,0,0,0,0,0,0,0,0,0,0,0,0,0
360470018031,36, New York,047, Kings County,0,0,0,0,0,0,0,0,0,0,0,0,0,0,0,2,2,0
360470018040,36, New York,047, Kings County,0,0,0,0,0,0,0,0,0,0,0,0,0,0,0,0,0,0
360470018041,36, New York,047, Kings County,0,0,0,0,0,0,0,0,0,0,0,0,0,0,0,0,0,0
360470020001,36, New York,047, Kings County,112,75,51,0,24,0,0,0,0,0,112,75,51,0,24,372,39,333
360470020002,36, New York,047, Kings County,197,165,102,0,63,30,30,17,0,13,167,135,85,0,50,243,75,168
360470021001,36, New York,047, Kings County,481,316,230,69,17,47,22,0,22,0,434,294,230,47,17,1550,110,1440
360470021002,36, New York,047, Kings County,568,477,453,24,0,0,0,0,0,0,568,477,453,24,0,1512,156,1356
360470021003,36, New York,047, Kings County,294,75,75,0,0,0,0,0,0,0,294,75,75,0,0,666,0,666
360470022001,36, New York,047, Kings County,225,218,91,25,102,81,81,35,0,46,144,137,56,25,56,425,157,268
360470022002,36, New York,047, Kings County,316,198,159,9,30,88,69,69,0,0,228,129,90,9,30,597,70,527
360470022003,36, New York,047, Kings County,189,85,76,0,9,0,0,0,0,0,189,85,76,0,9,536,0,536
360470022004,36, New York,047, Kings County,128,0,0,0,0,24,0,0,0,0,104,0,0,0,0,664,161,503
360470023001,36, New York,047, Kings County,459,116,73,0,43,118,66,56,0,10,341,50,17,0,33,1091,355,736
360470023002,36, New York,047, Kings County,348,111,22,42,47,211,34,0,0,34,137,77,22,42,13,749,451,298
360470023003,36, New York,047, Kings County,233,113,0,78,35,99,10,0,0,10,134,103,0,78,25,692,459,233
360470029011,36, New York,047, Kings County,741,497,97,33,367,343,261,45,23,193,398,236,52,10,174,1620,727,893
360470029012,36, New York,047, Kings County,207,83,10,0,73,81,8,0,0,8,126,75,10,0,65,824,436,388
360470030001,36, New York,047, Kings County,304,119,94,6,19,0,0,0,0,0,304,119,94,6,19,644,30,614
360470030002,36, New York,047, Kings County,208,57,57,0,0,24,0,0,0,0,184,57,57,0,0,572,52,520
360470031011,36, New York,047, Kings County,559,241,178,22,41,43,23,0,0,23,516,218,178,22,18,1941,117,1824
360470031012,36, New York,047, Kings County,13,13,13,0,0,0,0,0,0,0,13,13,13,0,0,26,0,26
360470031013,36, New York,047, Kings County,0,0,0,0,0,0,0,0,0,0,0,0,0,0,0,12,0,12
360470031021,36, New York,047, Kings County,0,0,0,0,0,0,0,0,0,0,0,0,0,0,0,0,0,0
360470033001,36, New York,047, Kings County,197,150,126,24,0,22,22,22,0,0,175,128,104,24,0,560,57,503
360470033002,36, New York,047, Kings County,491,217,54,23,140,44,37,0,0,37,447,180,54,23,103,2678,454,2224
360470034000,36, New York,047, Kings County,0,0,0,0,0,0,0,0,0,0,0,0,0,0,0,0,0,0
360470034001,36, New York,047, Kings County,292,129,129,0,0,11,11,11,0,0,281,118,118,0,0,691,35,656
360470034002,36, New York,047, Kings County,325,165,136,7,22,0,0,0,0,0,325,165,136,7,22,941,46,895
360470034003,36, New York,047, Kings County,202,94,74,7,13,0,0,0,0,0,202,94,74,7,13,715,67,648
360470035001,36, New York,047, Kings County,285,120,82,0,38,0,0,0,0,0,285,120,82,0,38,1187,141,1046
360470035002,36, New York,047, Kings County,113,19,6,0,13,3,3,0,0,3,110,16,6,0,10,639,67,572
360470036001,36, New York,047, Kings County,288,80,52,0,28,28,28,28,0,0,260,52,24,0,28,700,74,626
360470036002,36, New York,047, Kings County,431,79,79,0,0,59,21,21,0,0,372,58,58,0,0,1484,256,1228
360470036003,36, New York,047, Kings County,270,139,98,0,41,0,0,0,0,0,270,139,98,0,41,768,5,763
360470037001,36, New York,047, Kings County,838,316,220,26,70,7,7,0,0,7,831,309,220,26,63,2614,172,2442
360470038000,36, New York,047, Kings County,0,0,0,0,0,0,0,0,0,0,0,0,0,0,0,0,0,0
360470038001,36, New York,047, Kings County,344,137,116,7,14,12,12,6,0,6,332,125,110,7,8,1165,62,1103
360470039001,36, New York,047, Kings County,193,154,128,12,14,0,0,0,0,0,193,154,128,12,14,772,98,674
360470039002,36, New York,047, Kings County,115,64,64,0,0,0,0,0,0,0,115,64,64,0,0,511,75,436
360470039003,36, New York,047, Kings County,123,40,26,14,0,14,14,0,14,0,109,26,26,0,0,501,50,451
360470041001,36, New York,047, Kings County,296,213,201,0,12,12,12,0,0,12,284,201,201,0,0,1189,223,966
360470041002,36, New York,047, Kings County,186,108,56,25,27,0,0,0,0,0,186,108,56,25,27,640,19,621
360470041003,36, New York,047, Kings County,111,27,27,0,0,0,0,0,0,0,111,27,27,0,0,564,50,514
360470043001,36, New York,047, Kings County,0,0,0,0,0,0,0,0,0,0,0,0,0,0,0,0,0,0
360470043002,36, New York,047, Kings County,316,160,160,0,0,0,0,0,0,0,316,160,160,0,0,1058,169,889
360470043003,36, New York,047, Kings County,108,29,19,0,10,10,10,0,0,10,98,19,19,0,0,517,43,474
360470043004,36, New York,047, Kings County,382,217,132,30,55,37,37,0,0,37,345,180,132,30,18,1141,148,993
360470044000,36, New York,047, Kings County,0,0,0,0,0,0,0,0,0,0,0,0,0,0,0,0,0,0
360470044001,36, New York,047, Kings County,416,129,129,0,0,6,0,0,0,0,410,129,129,0,0,1039,21,1018
360470044002,36, New York,047, Kings County,255,86,66,0,20,38,15,0,0,15,217,71,66,0,5,798,67,731
360470045001,36, New York,047, Kings County,264,130,81,49,0,11,0,0,0,0,253,130,81,49,0,988,58,930
360470045002,36, New York,047, Kings County,166,61,61,0,0,0,0,0,0,0,166,61,61,0,0,653,43,610
360470045003,36, New York,047, Kings County,116,37,28,0,9,0,0,0,0,0,116,37,28,0,9,521,12,509
360470045004,36, New York,047, Kings County,150,42,42,0,0,0,0,0,0,0,150,42,42,0,0,506,43,463
360470046000,36, New York,047, Kings County,0,0,0,0,0,0,0,0,0,0,0,0,0,0,0,0,0,0
360470046001,36, New York,047, Kings County,315,143,143,0,0,6,6,6,0,0,309,137,137,0,0,857,98,759
360470047001,36, New York,047, Kings County,468,327,294,0,33,12,5,1,0,4,456,322,293,0,29,1322,126,1196
360470049001,36, New York,047, Kings County,171,143,133,10,0,24,14,14,0,0,147,129,119,10,0,399,59,340
360470049002,36, New York,047, Kings County,240,116,98,10,8,0,0,0,0,0,240,116,98,10,8,704,35,669
360470049003,36, New York,047, Kings County,186,68,44,0,24,9,9,9,0,0,177,59,35,0,24,635,88,547
360470050000,36, New York,047, Kings County,0,0,0,0,0,0,0,0,0,0,0,0,0,0,0,0,0,0
360470050001,36, New York,047, Kings County,219,49,49,0,0,0,0,0,0,0,219,49,49,0,0,667,16,651
360470050002,36, New York,047, Kings County,219,140,72,10,58,44,44,0,0,44,175,96,72,10,14,583,56,527
360470050003,36, New York,047, Kings County,181,88,88,0,0,8,8,8,0,0,173,80,80,0,0,547,25,522
360470051001,36, New York,047, Kings County,131,75,75,0,0,9,0,0,0,0,122,75,75,0,0,395,57,338
360470051002,36, New York,047, Kings County,293,188,177,0,11,0,0,0,0,0,293,188,177,0,11,781,50,731
360470051003,36, New York,047, Kings County,177,77,68,9,0,0,0,0,0,0,177,77,68,9,0,723,39,684
360470052010,36, New York,047, Kings County,0,0,0,0,0,0,0,0,0,0,0,0,0,0,0,0,0,0
360470052011,36, New York,047, Kings County,312,85,76,0,9,56,0,0,0,0,256,85,76,0,9,1301,378,923
360470052020,36, New York,047, Kings County,0,0,0,0,0,0,0,0,0,0,0,0,0,0,0,0,0,0
360470052021,36, New York,047, Kings County,375,176,102,23,51,26,14,14,0,0,349,162,88,23,51,1120,86,1034
360470052022,36, New York,047, Kings County,433,149,138,0,11,22,22,22,0,0,411,127,116,0,11,1231,36,1195
360470053010,36, New York,047, Kings County,0,0,0,0,0,0,0,0,0,0,0,0,0,0,0,0,0,0
360470053011,36, New York,047, Kings County,347,177,101,26,50,1,0,0,0,0,346,177,101,26,50,1191,78,1113
360470053012,36, New York,047, Kings County,214,115,32,10,73,47,31,0,0,31,167,84,32,10,42,442,79,363
360470053020,36, New York,047, Kings County,0,0,0,0,0,0,0,0,0,0,0,0,0,0,0,0,0,0
360470053021,36, New York,047, Kings County,0,0,0,0,0,0,0,0,0,0,0,0,0,0,0,13,0,13
360470053022,36, New York,047, Kings County,0,0,0,0,0,0,0,0,0,0,0,0,0,0,0,0,0,0
360470053023,36, New York,047, Kings County,15,15,11,0,4,0,0,0,0,0,15,15,11,0,4,34,0,34
360470053031,36, New York,047, Kings County,0,0,0,0,0,0,0,0,0,0,0,0,0,0,0,0,0,0
360470054000,36, New York,047, Kings County,0,0,0,0,0,0,0,0,0,0,0,0,0,0,0,0,0,0
360470054001,36, New York,047, Kings County,455,109,86,11,12,0,0,0,0,0,455,109,86,11,12,1346,98,1248
360470054002,36, New York,047, Kings County,147,41,35,0,6,10,0,0,0,0,137,41,35,0,6,456,64,392
360470054003,36, New York,047, Kings County,273,97,24,11,62,9,0,0,0,0,264,97,24,11,62,881,59,822
360470056010,36, New York,047, Kings County,0,0,0,0,0,0,0,0,0,0,0,0,0,0,0,0,0,0
360470056011,36, New York,047, Kings County,395,254,245,0,9,177,177,177,0,0,218,77,68,0,9,1177,267,910
360470056012,36, New York,047, Kings County,349,109,61,16,32,0,0,0,0,0,349,109,61,16,32,974,36,938
360470056020,36, New York,047, Kings County,0,0,0,0,0,0,0,0,0,0,0,0,0,0,0,0,0,0
360470056021,36, New York,047, Kings County,392,128,111,7,10,0,0,0,0,0,392,128,111,7,10,1400,23,1377
360470058001,36, New York,047, Kings County,208,65,35,16,14,0,0,0,0,0,208,65,35,16,14,558,62,496
360470058002,36, New York,047, Kings County,353,143,132,11,0,15,3,3,0,0,338,140,129,11,0,1143,71,1072
360470058003,36, New York,047, Kings County,161,50,50,0,0,19,0,0,0,0,142,50,50,0,0,585,54,531
360470059001,36, New York,047, Kings County,204,93,49,0,44,14,0,0,0,0,190,93,49,0,44,689,50,639
360470059002,36, New York,047, Kings County,53,14,14,0,0,0,0,0,0,0,53,14,14,0,0,373,61,312
360470060001,36, New York,047, Kings County,408,265,231,24,10,34,22,22,0,0,374,243,209,24,10,763,31,732
360470060002,36, New York,047, Kings County,185,75,67,0,8,9,0,0,0,0,176,75,67,0,8,733,31,702
360470060003,36, New York,047, Kings County,129,72,61,0,11,0,0,0,0,0,129,72,61,0,11,327,0,327
360470062001,36, New York,047, Kings County,305,110,102,0,8,54,0,0,0,0,251,110,102,0,8,917,98,819
360470062002,36, New York,047, Kings County,135,94,94,0,0,46,46,46,0,0,89,48,48,0,0,438,160,278
360470062003,36, New York,047, Kings County,118,94,82,12,0,0,0,0,0,0,118,94,82,12,0,293,50,243
360470063001,36, New York,047, Kings County,242,106,100,0,6,26,0,0,0,0,216,106,100,0,6,637,92,545
360470063002,36, New York,047, Kings County,309,119,113,6,0,6,6,6,0,0,303,113,107,6,0,973,38,935
360470064001,36, New York,047, Kings County,204,44,28,0,16,0,0,0,0,0,204,44,28,0,16,762,129,633
360470064002,36, New York,047, Kings County,179,81,81,0,0,33,33,33,0,0,146,48,48,0,0,501,78,423
360470064003,36, New York,047, Kings County,428,279,146,40,93,42,42,10,0,32,386,237,136,40,61,1054,157,897
360470065001,36, New York,047, Kings County,323,87,87,0,0,0,0,0,0,0,323,87,87,0,0,843,22,821
360470065002,36, New York,047, Kings County,150,119,118,1,0,1,1,0,1,0,149,118,118,0,0,460,0,460
360470065003,36, New York,047, Kings County,85,34,34,0,0,0,0,0,0,0,85,34,34,0,0,149,0,149
360470065004,36, New York,047, Kings County,167,73,73,0,0,0,0,0,0,0,167,73,73,0,0,854,14,840
360470065005,36, New York,047, Kings County,117,70,35,16,19,0,0,0,0,0,117,70,35,16,19,483,52,431
360470065006,36, New York,047, Kings County,360,241,220,0,21,0,0,0,0,0,360,241,220,0,21,1007,34,973
360470065007,36, New York,047, Kings County,55,0,0,0,0,0,0,0,0,0,55,0,0,0,0,241,0,241
360470066001,36, New York,047, Kings County,324,134,105,0,29,102,82,53,0,29,222,52,52,0,0,913,264,649
360470066002,36, New York,047, Kings County,264,95,74,0,21,10,0,0,0,0,254,95,74,0,21,727,19,708
360470066003,36, New York,047, Kings County,418,182,133,0,49,58,25,8,0,17,360,157,125,0,32,1243,200,1043
360470067001,36, New York,047, Kings County,157,64,33,0,31,0,0,0,0,0,157,64,33,0,31,400,88,312
360470067002,36, New York,047, Kings County,254,166,157,0,9,0,0,0,0,0,254,166,157,0,9,739,22,717
360470067003,36, New York,047, Kings County,219,131,120,0,11,0,0,0,0,0,219,131,120,0,11,465,0,465
360470067004,36, New York,047, Kings County,178,137,89,29,19,0,0,0,0,0,178,137,89,29,19,332,27,305
360470067005,36, New York,047, Kings County,260,109,109,0,0,0,0,0,0,0,260,109,109,0,0,594,12,582
360470068001,36, New York,047, Kings County,246,103,58,45,0,45,45,0,45,0,201,58,58,0,0,665,63,602
360470068002,36, New York,047, Kings County,327,187,73,0,114,0,0,0,0,0,327,187,73,0,114,1100,161,939
360470068003,36, New York,047, Kings County,129,45,45,0,0,0,0,0,0,0,129,45,45,0,0,511,12,499
360470068004,36, New York,047, Kings County,139,33,33,0,0,19,19,19,0,0,120,14,14,0,0,357,16,341
360470069011,36, New York,047, Kings County,183,43,30,13,0,25,0,0,0,0,158,43,30,13,0,816,94,722
360470069012,36, New York,047, Kings County,179,98,98,0,0,18,0,0,0,0,161,98,98,0,0,611,75,536
360470069021,36, New York,047, Kings County,182,99,87,12,0,0,0,0,0,0,182,99,87,12,0,723,14,709
360470069022,36, New York,047, Kings County,206,85,85,0,0,0,0,0,0,0,206,85,85,0,0,654,28,626
360470070001,36, New York,047, Kings County,532,105,88,0,17,8,0,0,0,0,524,105,88,0,17,1507,90,1417
360470070002,36, New York,047, Kings County,186,97,34,57,6,6,6,0,0,6,180,91,34,57,0,557,39,518
360470071001,36, New York,047, Kings County,374,159,159,0,0,57,0,0,0,0,317,159,159,0,0,994,123,871
360470071002,36, New York,047, Kings County,570,359,94,0,265,165,113,58,0,55,405,246,36,0,210,1463,363,1100
360470071003,36, New York,047, Kings County,132,66,3,17,46,41,14,0,0,14,91,52,3,17,32,349,119,230
360470072001,36, New York,047, Kings County,446,249,154,19,76,106,99,58,9,32,340,150,96,10,44,797,136,661
360470074001,36, New York,047, Kings County,302,98,72,10,16,21,10,0,10,0,281,88,72,0,16,680,52,628
360470074002,36, New York,047, Kings County,428,230,134,66,30,150,109,44,54,11,278,121,90,12,19,859,244,615
360470074003,36, New York,047, Kings County,146,113,27,48,38,0,0,0,0,0,146,113,27,48,38,331,16,315
360470074004,36, New York,047, Kings County,286,166,115,39,12,72,30,16,14,0,214,136,99,25,12,682,96,586
360470075001,36, New York,047, Kings County,278,200,160,0,40,0,0,0,0,0,278,200,160,0,40,1047,65,982
360470075002,36, New York,047, Kings County,289,166,166,0,0,32,19,19,0,0,257,147,147,0,0,640,93,547
360470075003,36, New York,047, Kings County,194,95,82,0,13,0,0,0,0,0,194,95,82,0,13,531,0,531
360470075004,36, New York,047, Kings County,211,15,0,0,15,0,0,0,0,0,211,15,0,0,15,726,13,713
360470075005,36, New York,047, Kings County,114,35,35,0,0,0,0,0,0,0,114,35,35,0,0,516,107,409
360470076001,36, New York,047, Kings County,442,240,122,90,28,37,28,0,0,28,405,212,122,90,0,918,110,808
360470076002,36, New York,047, Kings County,166,132,70,14,48,48,48,0,0,48,118,84,70,14,0,418,83,335
360470076003,36, New York,047, Kings County,237,165,74,0,91,16,16,0,0,16,221,149,74,0,75,556,124,432
360470077001,36, New York,047, Kings County,335,224,199,0,25,8,0,0,0,0,327,224,199,0,25,1381,186,1195
360470077002,36, New York,047, Kings County,234,222,188,0,34,0,0,0,0,0,234,222,188,0,34,892,18,874
360470077003,36, New York,047, Kings County,378,172,153,0,19,0,0,0,0,0,378,172,153,0,19,1113,31,1082
360470077004,36, New York,047, Kings County,242,147,98,25,24,0,0,0,0,0,242,147,98,25,24,672,0,672
360470078001,36, New York,047, Kings County,286,162,67,25,70,52,52,8,0,44,234,110,59,25,26,710,0,710
360470078002,36, New York,047, Kings County,341,174,130,5,39,55,43,33,0,10,286,131,97,5,29,696,135,561
360470078003,36, New York,047, Kings County,297,117,87,1,29,76,31,30,1,0,221,86,57,0,29,793,168,625
360470078004,36, New York,047, Kings County,200,90,79,11,0,12,12,12,0,0,188,78,67,11,0,541,55,486
360470080001,36, New York,047, Kings County,499,231,121,90,20,31,20,0,0,20,468,211,121,90,0,1118,42,1076
360470080002,36, New York,047, Kings County,196,61,38,0,23,20,20,20,0,0,176,41,18,0,23,541,58,483
360470080003,36, New York,047, Kings County,143,108,75,0,33,43,33,0,0,33,100,75,75,0,0,477,59,418
360470082001,36, New York,047, Kings County,244,180,85,27,68,111,111,85,0,26,133,69,0,27,42,752,329,423
360470082002,36, New York,047, Kings County,267,46,8,0,38,38,22,0,0,22,229,24,8,0,16,1275,132,1143
360470082003,36, New York,047, Kings County,118,58,49,0,9,9,9,0,0,9,109,49,49,0,0,551,39,512
360470084001,36, New York,047, Kings County,247,97,84,0,13,40,40,34,0,6,207,57,50,0,7,689,56,633
360470084002,36, New York,047, Kings County,193,183,79,31,73,0,0,0,0,0,193,183,79,31,73,467,28,439
360470084003,36, New York,047, Kings County,329,44,0,35,9,35,35,0,35,0,294,9,0,0,9,548,148,400
360470085001,36, New York,047, Kings County,702,437,39,36,362,441,293,39,36,218,261,144,0,0,144,1773,1203,570
360470085002,36, New York,047, Kings County,604,275,180,0,95,260,34,0,0,34,344,241,180,0,61,1385,492,893
360470085003,36, New York,047, Kings County,781,525,14,36,475,307,243,0,36,207,474,282,14,0,268,1747,791,956
360470086001,36, New York,047, Kings County,0,0,0,0,0,0,0,0,0,0,0,0,0,0,0,0,0,0
360470088001,36, New York,047, Kings County,284,151,75,0,76,0,0,0,0,0,284,151,75,0,76,888,63,825
360470088002,36, New York,047, Kings County,195,79,50,29,0,36,29,0,29,0,159,50,50,0,0,775,68,707
360470090011,36, New York,047, Kings County,259,106,59,0,47,24,23,9,0,14,235,83,50,0,33,596,108,488
360470090021,36, New York,047, Kings County,225,149,84,65,0,12,0,0,0,0,213,149,84,65,0,427,81,346
360470092011,36, New York,047, Kings County,134,36,27,0,9,0,0,0,0,0,134,36,27,0,9,336,8,328
360470092012,36, New York,047, Kings County,289,184,152,0,32,84,57,57,0,0,205,127,95,0,32,484,68,416
360470092021,36, New York,047, Kings County,513,277,178,0,99,41,20,20,0,0,472,257,158,0,99,837,90,747
360470092022,36, New York,047, Kings County,333,203,129,61,13,89,61,61,0,0,244,142,68,61,13,793,243,550
360470094011,36, New York,047, Kings County,223,110,17,25,68,95,71,16,25,30,128,39,1,0,38,459,184,275
360470094012,36, New York,047, Kings County,186,158,82,20,56,27,27,13,0,14,159,131,69,20,42,428,106,322
360470094021,36, New York,047, Kings County,385,196,151,34,11,47,23,12,0,11,338,173,139,34,0,530,58,472
360470094022,36, New York,047, Kings County,446,331,236,23,72,53,53,27,8,18,393,278,209,15,54,773,150,623
360470096001,36, New York,047, Kings County,323,196,135,20,41,72,55,20,20,15,251,141,115,0,26,668,126,542
360470096002,36, New York,047, Kings County,419,203,182,0,21,70,27,16,0,11,349,176,166,0,10,866,77,789
360470096003,36, New York,047, Kings County,335,109,102,0,7,55,38,38,0,0,280,71,64,0,7,781,114,667
360470096004,36, New York,047, Kings County,325,147,85,0,62,79,21,21,0,0,246,126,64,0,62,751,160,591
360470098001,36, New York,047, Kings County,304,254,46,65,143,95,86,12,15,59,209,168,34,50,84,360,114,246
360470098002,36, New York,047, Kings County,419,289,118,70,101,89,89,12,0,77,330,200,106,70,24,669,189,480
360470098003,36, New York,047, Kings County,401,179,144,10,25,94,22,18,4,0,307,157,126,6,25,691,174,517
360470098004,36, New York,047, Kings County,291,147,60,65,22,48,29,16,0,13,243,118,44,65,9,409,38,371
360470100001,36, New York,047, Kings County,353,163,130,13,20,32,21,0,13,8,321,142,130,0,12,639,97,542
360470100002,36, New York,047, Kings County,384,221,113,0,108,50,35,20,0,15,334,186,93,0,93,480,43,437
360470100003,36, New York,047, Kings County,388,196,138,26,32,4,4,4,0,0,384,192,134,26,32,695,107,588
360470100004,36, New York,047, Kings County,133,99,92,7,0,51,51,51,0,0,82,48,41,7,0,407,103,304
360470101001,36, New York,047, Kings County,242,102,86,0,16,29,23,23,0,0,213,79,63,0,16,687,110,577
360470101002,36, New York,047, Kings County,379,206,178,0,28,31,0,0,0,0,348,206,178,0,28,1115,143,972
360470101003,36, New York,047, Kings County,216,124,113,11,0,30,30,30,0,0,186,94,83,11,0,1074,139,935
360470102001,36, New York,047, Kings County,341,233,184,24,25,0,0,0,0,0,341,233,184,24,25,545,9,536
360470102002,36, New York,047, Kings County,350,185,163,10,12,41,41,41,0,0,309,144,122,10,12,729,147,582
360470102003,36, New York,047, Kings County,327,253,175,48,30,129,108,73,12,23,198,145,102,36,7,645,207,438
360470104011,36, New York,047, Kings County,280,170,148,0,22,79,62,62,0,0,201,108,86,0,22,427,124,303
360470104012,36, New York,047, Kings County,235,100,43,0,57,36,12,12,0,0,199,88,31,0,57,355,77,278
360470104021,36, New York,047, Kings County,156,106,95,0,11,47,47,47,0,0,109,59,48,0,11,381,170,211
360470104022,36, New York,047, Kings County,335,262,179,0,83,169,169,86,0,83,166,93,93,0,0,290,110,180
360470106011,36, New York,047, Kings County,266,152,133,9,10,85,66,57,9,0,181,86,76,0,10,330,105,225
360470106012,36, New York,047, Kings County,230,167,66,33,68,92,91,23,0,68,138,76,43,33,0,390,111,279
360470106021,36, New York,047, Kings County,260,170,142,0,28,13,0,0,0,0,247,170,142,0,28,506,75,431
360470106022,36, New York,047, Kings County,216,173,155,0,18,74,54,36,0,18,142,119,119,0,0,513,60,453
360470108011,36, New York,047, Kings County,236,144,141,3,0,38,26,26,0,0,198,118,115,3,0,341,66,275
360470108012,36, New York,047, Kings County,169,87,71,0,16,31,0,0,0,0,138,87,71,0,16,289,75,214
360470108021,36, New York,047, Kings County,334,139,124,0,15,78,73,58,0,15,256,66,66,0,0,573,39,534
360470108022,36, New York,047, Kings County,139,89,41,0,48,88,66,18,0,48,51,23,23,0,0,173,42,131
360470110001,36, New York,047, Kings County,173,50,38,1,11,1,1,0,1,0,172,49,38,0,11,583,39,544
360470110002,36, New York,047, Kings County,264,127,110,0,17,35,35,35,0,0,229,92,75,0,17,617,135,482
360470112001,36, New York,047, Kings County,586,297,261,0,36,85,24,24,0,0,501,273,237,0,36,1467,368,1099
360470112002,36, New York,047, Kings County,260,89,31,0,58,89,62,31,0,31,171,27,0,0,27,406,88,318
360470112003,36, New York,047, Kings County,380,145,121,24,0,106,74,74,0,0,274,71,47,24,0,487,154,333
360470112004,36, New York,047, Kings County,251,159,76,0,83,23,23,23,0,0,228,136,53,0,83,508,126,382
360470114001,36, New York,047, Kings County,206,95,87,0,8,46,46,38,0,8,160,49,49,0,0,501,84,417
360470114002,36, New York,047, Kings County,297,167,119,0,48,121,79,31,0,48,176,88,88,0,0,668,258,410
360470114003,36, New York,047, Kings County,170,75,31,0,44,10,10,0,0,10,160,65,31,0,34,316,10,306
360470116001,36, New York,047, Kings County,324,233,86,127,20,68,20,20,0,0,256,213,66,127,20,645,143,502
360470116002,36, New York,047, Kings County,374,128,128,0,0,86,29,29,0,0,288,99,99,0,0,782,167,615
360470116003,36, New York,047, Kings County,153,103,90,13,0,32,32,32,0,0,121,71,58,13,0,269,67,202
360470117001,36, New York,047, Kings County,221,97,55,36,6,6,6,0,0,6,215,91,55,36,0,635,24,611
360470117002,36, New York,047, Kings County,184,109,64,32,13,22,22,0,22,0,162,87,64,10,13,498,39,459
360470117003,36, New York,047, Kings County,378,225,196,0,29,59,39,10,0,29,319,186,186,0,0,793,125,668
360470118001,36, New York,047, Kings County,0,0,0,0,0,0,0,0,0,0,0,0,0,0,0,0,0,0
360470118002,36, New York,047, Kings County,144,85,47,22,16,6,6,6,0,0,138,79,41,22,16,303,39,264
360470118003,36, New York,047, Kings County,281,116,87,12,17,69,23,11,12,0,212,93,76,0,17,381,25,356
360470119011,36, New York,047, Kings County,82,9,9,0,0,0,0,0,0,0,82,9,9,0,0,316,27,289
360470119012,36, New York,047, Kings County,282,68,50,0,18,0,0,0,0,0,282,68,50,0,18,759,80,679
360470119021,36, New York,047, Kings County,0,0,0,0,0,0,0,0,0,0,0,0,0,0,0,0,0,0
360470120001,36, New York,047, Kings County,288,200,188,0,12,54,39,27,0,12,234,161,161,0,0,635,72,563
360470121001,36, New York,047, Kings County,206,71,63,8,0,2,2,0,2,0,204,69,63,6,0,775,50,725
360470121002,36, New York,047, Kings County,201,98,82,6,10,22,6,0,6,0,179,92,82,0,10,746,108,638
360470122001,36, New York,047, Kings County,219,128,72,38,18,38,18,0,0,18,181,110,72,38,0,462,192,270
360470122002,36, New York,047, Kings County,327,277,225,52,0,142,123,71,52,0,185,154,154,0,0,834,126,708
360470122003,36, New York,047, Kings County,0,0,0,0,0,0,0,0,0,0,0,0,0,0,0,0,0,0
360470122004,36, New York,047, Kings County,411,284,171,17,96,87,54,0,0,54,324,230,171,17,42,827,182,645
360470126001,36, New York,047, Kings County,257,97,87,4,6,65,22,16,0,6,192,75,71,4,0,610,206,404
360470126002,36, New York,047, Kings County,182,101,90,0,11,67,34,34,0,0,115,67,56,0,11,480,103,377
360470126003,36, New York,047, Kings County,156,39,30,0,9,12,0,0,0,0,144,39,30,0,9,341,44,297
360470127001,36, New York,047, Kings County,318,112,112,0,0,31,0,0,0,0,287,112,112,0,0,1664,183,1481
360470127002,36, New York,047, Kings County,277,168,114,0,54,9,0,0,0,0,268,168,114,0,54,720,85,635
360470127003,36, New York,047, Kings County,190,69,0,0,69,38,0,0,0,0,152,69,0,0,69,683,227,456
360470128011,36, New York,047, Kings County,484,193,142,12,39,116,81,40,6,35,368,112,102,6,4,1263,192,1071
360470129011,36, New York,047, Kings County,0,0,0,0,0,0,0,0,0,0,0,0,0,0,0,0,0,0
360470129012,36, New York,047, Kings County,217,157,145,0,12,18,18,18,0,0,199,139,127,0,12,635,24,611
360470129013,36, New York,047, Kings County,169,70,70,0,0,0,0,0,0,0,169,70,70,0,0,652,37,615
360470129014,36, New York,047, Kings County,173,67,36,9,22,0,0,0,0,0,173,67,36,9,22,545,12,533
360470129021,36, New York,047, Kings County,180,104,104,0,0,0,0,0,0,0,180,104,104,0,0,686,27,659
360470129022,36, New York,047, Kings County,318,134,56,13,65,42,22,0,13,9,276,112,56,0,56,1602,210,1392
360470130001,36, New York,047, Kings County,343,208,195,0,13,37,29,19,0,10,306,179,176,0,3,894,74,820
360470130002,36, New York,047, Kings County,232,135,69,8,58,26,26,0,0,26,206,109,69,8,32,709,104,605
360470130003,36, New York,047, Kings County,223,69,54,8,7,7,7,0,0,7,216,62,54,8,0,592,7,585
360470130004,36, New York,047, Kings County,253,135,74,0,61,26,26,26,0,0,227,109,48,0,61,510,59,451
360470131001,36, New York,047, Kings County,194,47,28,0,19,0,0,0,0,0,194,47,28,0,19,662,73,589
360470131002,36, New York,047, Kings County,148,78,46,0,32,0,0,0,0,0,148,78,46,0,32,569,32,537
360470131003,36, New York,047, Kings County,266,159,96,0,63,14,0,0,0,0,252,159,96,0,63,644,70,574
360470131004,36, New York,047, Kings County,317,52,52,0,0,0,0,0,0,0,317,52,52,0,0,868,45,823
360470132001,36, New York,047, Kings County,219,105,78,17,10,68,47,36,11,0,151,58,42,6,10,370,111,259
360470132002,36, New York,047, Kings County,363,111,88,6,17,30,19,19,0,0,333,92,69,6,17,1188,42,1146
360470133001,36, New York,047, Kings County,208,92,80,0,12,0,0,0,0,0,208,92,80,0,12,568,0,568
360470133002,36, New York,047, Kings County,234,96,96,0,0,0,0,0,0,0,234,96,96,0,0,659,61,598
360470133003,36, New York,047, Kings County,404,251,211,0,40,0,0,0,0,0,404,251,211,0,40,1123,10,1113
360470133004,36, New York,047, Kings County,254,176,166,10,0,0,0,0,0,0,254,176,166,10,0,697,34,663
360470134001,36, New York,047, Kings County,375,192,141,0,51,55,38,0,0,38,320,154,141,0,13,950,45,905
360470134002,36, New York,047, Kings County,272,175,144,0,31,15,15,15,0,0,257,160,129,0,31,782,60,722
360470134003,36, New York,047, Kings County,325,155,109,0,46,26,26,26,0,0,299,129,83,0,46,842,0,842
360470135001,36, New York,047, Kings County,267,178,157,0,21,0,0,0,0,0,267,178,157,0,21,644,35,609
360470135002,36, New York,047, Kings County,335,191,158,0,33,0,0,0,0,0,335,191,158,0,33,949,13,936
360470135003,36, New York,047, Kings County,416,262,222,0,40,15,15,0,0,15,401,247,222,0,25,1030,46,984
360470136001,36, New York,047, Kings County,270,172,127,37,8,50,50,50,0,0,220,122,77,37,8,791,98,693
360470136002,36, New York,047, Kings County,220,71,71,0,0,0,0,0,0,0,220,71,71,0,0,722,8,714
360470136003,36, New York,047, Kings County,201,130,98,0,32,0,0,0,0,0,201,130,98,0,32,667,0,667
360470136004,36, New York,047, Kings County,217,98,52,0,46,9,9,9,0,0,208,89,43,0,46,640,26,614
360470137001,36, New York,047, Kings County,353,146,146,0,0,9,9,9,0,0,344,137,137,0,0,922,17,905
360470137002,36, New York,047, Kings County,160,69,60,9,0,0,0,0,0,0,160,69,60,9,0,721,64,657
360470137003,36, New York,047, Kings County,208,143,91,52,0,0,0,0,0,0,208,143,91,52,0,892,94,798
360470138001,36, New York,047, Kings County,377,242,184,0,58,11,11,11,0,0,366,231,173,0,58,1155,75,1080
360470138002,36, New York,047, Kings County,264,102,102,0,0,0,0,0,0,0,264,102,102,0,0,628,19,609
360470138003,36, New York,047, Kings County,212,108,85,0,23,23,23,0,0,23,189,85,85,0,0,589,32,557
360470139001,36, New York,047, Kings County,160,115,86,16,13,0,0,0,0,0,160,115,86,16,13,523,12,511
360470139002,36, New York,047, Kings County,179,47,38,0,9,0,0,0,0,0,179,47,38,0,9,725,36,689
360470139003,36, New York,047, Kings County,204,71,63,0,8,0,0,0,0,0,204,71,63,0,8,635,0,635
360470139004,36, New York,047, Kings County,199,160,129,0,31,7,0,0,0,0,192,160,129,0,31,572,61,511
360470140001,36, New York,047, Kings County,311,58,50,0,8,17,17,17,0,0,294,41,33,0,8,736,22,714
360470140002,36, New York,047, Kings County,228,105,81,7,17,72,7,0,7,0,156,98,81,0,17,634,206,428
360470141011,36, New York,047, Kings County,220,140,112,15,13,0,0,0,0,0,220,140,112,15,13,894,128,766
360470141021,36, New York,047, Kings County,329,82,70,0,12,0,0,0,0,0,329,82,70,0,12,730,25,705
360470141022,36, New York,047, Kings County,251,178,115,20,43,11,0,0,0,0,240,178,115,20,43,522,43,479
360470142001,36, New York,047, Kings County,309,72,46,0,26,22,6,6,0,0,287,66,40,0,26,900,81,819
360470142002,36, New York,047, Kings County,232,133,74,0,59,24,24,24,0,0,208,109,50,0,59,408,34,374
360470142003,36, New York,047, Kings County,328,217,123,77,17,25,25,25,0,0,303,192,98,77,17,793,159,634
360470143001,36, New York,047, Kings County,261,145,82,0,63,21,20,0,0,20,240,125,82,0,43,1066,49,1017
360470143002,36, New York,047, Kings County,210,92,77,5,10,0,0,0,0,0,210,92,77,5,10,869,25,844
360470143003,36, New York,047, Kings County,364,173,127,46,0,77,45,45,0,0,287,128,82,46,0,1108,217,891
360470145001,36, New York,047, Kings County,255,168,168,0,0,0,0,0,0,0,255,168,168,0,0,789,18,771
360470145002,36, New York,047, Kings County,296,146,97,15,34,0,0,0,0,0,296,146,97,15,34,1063,62,1001
360470145003,36, New York,047, Kings County,171,61,61,0,0,21,8,8,0,0,150,53,53,0,0,643,70,573
360470145004,36, New York,047, Kings County,204,83,83,0,0,0,0,0,0,0,204,83,83,0,0,745,37,708
360470147001,36, New York,047, Kings County,173,140,127,0,13,6,6,0,0,6,167,134,127,0,7,443,10,433
360470147002,36, New York,047, Kings County,350,227,187,11,29,35,35,23,0,12,315,192,164,11,17,998,79,919
360470148001,36, New York,047, Kings County,150,63,39,24,0,30,0,0,0,0,120,63,39,24,0,414,46,368
360470148002,36, New York,047, Kings County,163,34,34,0,0,22,5,5,0,0,141,29,29,0,0,433,72,361
360470149011,36, New York,047, Kings County,157,128,104,0,24,0,0,0,0,0,157,128,104,0,24,632,0,632
360470149012,36, New York,047, Kings County,141,73,73,0,0,0,0,0,0,0,141,73,73,0,0,682,90,592
360470149021,36, New York,047, Kings County,596,282,182,65,35,12,0,0,0,0,584,282,182,65,35,1173,32,1141
360470149022,36, New York,047, Kings County,334,28,28,0,0,36,0,0,0,0,298,28,28,0,0,1191,115,1076
360470149023,36, New York,047, Kings County,276,152,131,0,21,44,44,23,0,21,232,108,108,0,0,674,86,588
360470150001,36, New York,047, Kings County,235,75,67,0,8,55,5,5,0,0,180,70,62,0,8,745,113,632
360470150002,36, New York,047, Kings County,205,111,100,1,10,6,1,0,1,0,199,110,100,0,10,438,27,411
360470151001,36, New York,047, Kings County,329,133,125,0,8,0,0,0,0,0,329,133,125,0,8,758,15,743
360470151002,36, New York,047, Kings County,305,139,96,9,34,0,0,0,0,0,305,139,96,9,34,815,15,800
360470151003,36, New York,047, Kings County,375,163,147,0,16,0,0,0,0,0,375,163,147,0,16,975,40,935
360470151004,36, New York,047, Kings County,134,48,48,0,0,0,0,0,0,0,134,48,48,0,0,511,30,481
360470152001,36, New York,047, Kings County,180,55,55,0,0,0,0,0,0,0,180,55,55,0,0,665,23,642
360470152002,36, New York,047, Kings County,274,62,44,0,18,81,18,0,0,18,193,44,44,0,0,704,144,560
360470152003,36, New York,047, Kings County,214,91,91,0,0,18,11,11,0,0,196,80,80,0,0,611,63,548
360470153001,36, New York,047, Kings County,0,0,0,0,0,0,0,0,0,0,0,0,0,0,0,22,12,10
360470153002,36, New York,047, Kings County,169,112,112,0,0,10,10,10,0,0,159,102,102,0,0,540,26,514
360470153003,36, New York,047, Kings County,198,107,107,0,0,9,9,9,0,0,189,98,98,0,0,649,32,617
360470153004,36, New York,047, Kings County,133,80,72,0,8,0,0,0,0,0,133,80,72,0,8,614,30,584
360470154001,36, New York,047, Kings County,0,0,0,0,0,0,0,0,0,0,0,0,0,0,0,0,0,0
360470155001,36, New York,047, Kings County,136,64,45,0,19,0,0,0,0,0,136,64,45,0,19,335,26,309
360470155002,36, New York,047, Kings County,317,150,150,0,0,31,0,0,0,0,286,150,150,0,0,724,74,650
360470155003,36, New York,047, Kings County,241,87,68,19,0,8,8,8,0,0,233,79,60,19,0,638,41,597
360470155004,36, New York,047, Kings County,398,216,176,12,28,0,0,0,0,0,398,216,176,12,28,741,0,741
360470157001,36, New York,047, Kings County,341,95,74,0,21,0,0,0,0,0,341,95,74,0,21,906,11,895
360470157002,36, New York,047, Kings County,194,127,127,0,0,0,0,0,0,0,194,127,127,0,0,641,3,638
360470157003,36, New York,047, Kings County,456,309,288,0,21,0,0,0,0,0,456,309,288,0,21,687,0,687
360470157004,36, New York,047, Kings County,223,94,29,0,65,0,0,0,0,0,223,94,29,0,65,1079,0,1079
360470159001,36, New York,047, Kings County,304,206,206,0,0,0,0,0,0,0,304,206,206,0,0,820,85,735
360470159002,36, New York,047, Kings County,116,37,37,0,0,0,0,0,0,0,116,37,37,0,0,376,11,365
360470159003,36, New York,047, Kings County,177,78,78,0,0,26,0,0,0,0,151,78,78,0,0,578,82,496
360470159004,36, New York,047, Kings County,220,94,94,0,0,0,0,0,0,0,220,94,94,0,0,990,22,968
360470159005,36, New York,047, Kings County,0,0,0,0,0,0,0,0,0,0,0,0,0,0,0,0,0,0
360470159006,36, New York,047, Kings County,297,145,145,0,0,0,0,0,0,0,297,145,145,0,0,1037,0,1037
360470160001,36, New York,047, Kings County,410,106,95,0,11,35,0,0,0,0,375,106,95,0,11,1099,178,921
360470160002,36, New York,047, Kings County,182,83,83,0,0,12,12,12,0,0,170,71,71,0,0,601,24,577
360470160003,36, New York,047, Kings County,173,73,73,0,0,20,20,20,0,0,153,53,53,0,0,661,64,597
360470160004,36, New York,047, Kings County,228,108,83,0,25,12,0,0,0,0,216,108,83,0,25,863,81,782
360470161001,36, New York,047, Kings County,314,55,44,11,0,0,0,0,0,0,314,55,44,11,0,1172,2,1170
360470161002,36, New York,047, Kings County,0,0,0,0,0,0,0,0,0,0,0,0,0,0,0,0,0,0
360470161003,36, New York,047, Kings County,266,80,46,0,34,7,0,0,0,0,259,80,46,0,34,865,41,824
360470161004,36, New York,047, Kings County,254,86,86,0,0,0,0,0,0,0,254,86,86,0,0,781,8,773
360470162001,36, New York,047, Kings County,169,85,38,0,47,47,47,0,0,47,122,38,38,0,0,626,101,525
360470162002,36, New York,047, Kings County,314,60,60,0,0,0,0,0,0,0,314,60,60,0,0,1118,92,1026
360470163001,36, New York,047, Kings County,0,0,0,0,0,0,0,0,0,0,0,0,0,0,0,0,0,0
360470163002,36, New York,047, Kings County,361,241,202,0,39,41,29,0,0,29,320,212,202,0,10,1128,114,1014
360470163003,36, New York,047, Kings County,289,88,80,0,8,10,0,0,0,0,279,88,80,0,8,1203,78,1125
360470163004,36, New York,047, Kings County,185,88,88,0,0,8,0,0,0,0,177,88,88,0,0,609,29,580
360470164000,36, New York,047, Kings County,0,0,0,0,0,0,0,0,0,0,0,0,0,0,0,0,0,0
360470164001,36, New York,047, Kings County,179,148,130,0,18,0,0,0,0,0,179,148,130,0,18,428,0,428
360470165001,36, New York,047, Kings County,207,144,144,0,0,0,0,0,0,0,207,144,144,0,0,1141,128,1013
360470165002,36, New York,047, Kings County,447,278,241,0,37,32,32,32,0,0,415,246,209,0,37,1296,108,1188
360470165003,36, New York,047, Kings County,426,212,212,0,0,21,0,0,0,0,405,212,212,0,0,1019,116,903
360470165004,36, New York,047, Kings County,399,225,94,0,131,0,0,0,0,0,399,225,94,0,131,1151,0,1151
360470166001,36, New York,047, Kings County,305,91,91,0,0,29,0,0,0,0,276,91,91,0,0,840,56,784
360470166002,36, New York,047, Kings County,233,56,56,0,0,8,0,0,0,0,225,56,56,0,0,612,24,588
360470167001,36, New York,047, Kings County,259,144,144,0,0,18,18,18,0,0,241,126,126,0,0,737,36,701
360470167002,36, New York,047, Kings County,261,97,76,0,21,0,0,0,0,0,261,97,76,0,21,984,17,967
360470167003,36, New York,047, Kings County,356,102,66,16,20,0,0,0,0,0,356,102,66,16,20,888,0,888
360470167004,36, New York,047, Kings County,237,76,76,0,0,0,0,0,0,0,237,76,76,0,0,1040,66,974
360470168000,36, New York,047, Kings County,0,0,0,0,0,0,0,0,0,0,0,0,0,0,0,0,0,0
360470168001,36, New York,047, Kings County,569,254,195,0,59,27,27,25,0,2,542,227,170,0,57,1629,72,1557
360470169001,36, New York,047, Kings County,441,293,252,21,20,116,116,116,0,0,325,177,136,21,20,1016,247,769
360470169002,36, New York,047, Kings County,444,243,211,0,32,0,0,0,0,0,444,243,211,0,32,783,59,724
360470169003,36, New York,047, Kings County,162,75,75,0,0,0,0,0,0,0,162,75,75,0,0,447,0,447
360470169004,36, New York,047, Kings County,274,167,167,0,0,0,0,0,0,0,274,167,167,0,0,802,18,784
360470169005,36, New York,047, Kings County,185,87,53,18,16,0,0,0,0,0,185,87,53,18,16,425,35,390
360470170001,36, New York,047, Kings County,192,44,44,0,0,29,0,0,0,0,163,44,44,0,0,430,79,351
360470170002,36, New York,047, Kings County,286,151,137,0,14,50,50,36,0,14,236,101,101,0,0,891,67,824
360470170003,36, New York,047, Kings County,372,127,117,0,10,37,10,10,0,0,335,117,107,0,10,921,93,828
360470171001,36, New York,047, Kings County,541,336,127,53,156,0,0,0,0,0,541,336,127,53,156,1168,21,1147
360470171002,36, New York,047, Kings County,279,142,117,0,25,0,0,0,0,0,279,142,117,0,25,714,0,714
360470171003,36, New York,047, Kings County,223,129,98,22,9,12,0,0,0,0,211,129,98,22,9,516,50,466
360470171004,36, New York,047, Kings County,160,97,83,14,0,0,0,0,0,0,160,97,83,14,0,551,19,532
360470172001,36, New York,047, Kings County,539,260,227,0,33,0,0,0,0,0,539,260,227,0,33,1315,28,1287
360470172002,36, New York,047, Kings County,254,63,63,0,0,12,0,0,0,0,242,63,63,0,0,758,36,722
360470174000,36, New York,047, Kings County,0,0,0,0,0,0,0,0,0,0,0,0,0,0,0,0,0,0
360470174001,36, New York,047, Kings County,340,154,137,0,17,5,0,0,0,0,335,154,137,0,17,899,27,872
360470174002,36, New York,047, Kings County,237,132,72,21,39,58,42,11,0,31,179,90,61,21,8,557,93,464
360470175001,36, New York,047, Kings County,0,0,0,0,0,0,0,0,0,0,0,0,0,0,0,0,0,0
360470176000,36, New York,047, Kings County,0,0,0,0,0,0,0,0,0,0,0,0,0,0,0,0,0,0
360470176001,36, New York,047, Kings County,282,99,94,5,0,40,16,16,0,0,242,83,78,5,0,678,90,588
360470176002,36, New York,047, Kings County,331,102,86,11,5,13,6,6,0,0,318,96,80,11,5,1044,39,1005
360470177001,36, New York,047, Kings County,0,0,0,0,0,0,0,0,0,0,0,0,0,0,0,0,0,0
360470178001,36, New York,047, Kings County,255,108,96,12,0,20,16,16,0,0,235,92,80,12,0,483,21,462
360470178002,36, New York,047, Kings County,454,302,225,17,60,30,23,23,0,0,424,279,202,17,60,1027,48,979
360470179001,36, New York,047, Kings County,203,99,0,0,99,82,65,0,0,65,121,34,0,0,34,667,246,421
360470179002,36, New York,047, Kings County,495,273,200,37,36,80,49,42,0,7,415,224,158,37,29,1559,280,1279
360470179003,36, New York,047, Kings County,114,51,51,0,0,10,10,10,0,0,104,41,41,0,0,519,49,470
360470180001,36, New York,047, Kings County,320,81,38,0,43,13,0,0,0,0,307,81,38,0,43,874,65,809
360470180002,36, New York,047, Kings County,387,245,111,26,108,34,34,21,0,13,353,211,90,26,95,784,218,566
360470181001,36, New York,047, Kings County,131,45,19,0,26,18,0,0,0,0,113,45,19,0,26,623,48,575
360470181002,36, New York,047, Kings County,219,144,128,16,0,0,0,0,0,0,219,144,128,16,0,658,22,636
360470181003,36, New York,047, Kings County,229,132,132,0,0,0,0,0,0,0,229,132,132,0,0,1074,71,1003
360470181004,36, New York,047, Kings County,190,33,20,13,0,13,13,0,13,0,177,20,20,0,0,680,13,667
360470182001,36, New York,047, Kings County,171,63,50,0,13,10,0,0,0,0,161,63,50,0,13,579,64,515
360470182002,36, New York,047, Kings County,642,233,193,0,40,69,6,6,0,0,573,227,187,0,40,1350,174,1176
360470183001,36, New York,047, Kings County,231,158,125,7,26,7,7,0,7,0,224,151,125,0,26,826,32,794
360470183002,36, New York,047, Kings County,122,63,63,0,0,0,0,0,0,0,122,63,63,0,0,477,36,441
360470183003,36, New York,047, Kings County,172,72,72,0,0,7,0,0,0,0,165,72,72,0,0,725,48,677
360470184001,36, New York,047, Kings County,390,137,48,18,71,40,12,0,0,12,350,125,48,18,59,927,79,848
360470184002,36, New York,047, Kings County,261,123,107,8,8,29,1,0,0,1,232,122,107,8,7,636,1,635
360470185011,36, New York,047, Kings County,56,32,32,0,0,0,0,0,0,0,56,32,32,0,0,615,115,500
360470185012,36, New York,047, Kings County,282,162,22,0,140,82,58,0,0,58,200,104,22,0,82,761,242,519
360470185013,36, New York,047, Kings County,403,235,119,0,116,33,0,0,0,0,370,235,119,0,116,1350,146,1204
360470185014,36, New York,047, Kings County,335,220,69,0,151,103,57,0,0,57,232,163,69,0,94,734,231,503
360470186001,36, New York,047, Kings County,282,91,50,0,41,24,13,13,0,0,258,78,37,0,41,754,48,706
360470186002,36, New York,047, Kings County,213,88,54,21,13,20,15,15,0,0,193,73,39,21,13,788,48,740
360470187001,36, New York,047, Kings County,231,98,98,0,0,0,0,0,0,0,231,98,98,0,0,1093,144,949
360470188001,36, New York,047, Kings County,308,124,66,15,43,24,0,0,0,0,284,124,66,15,43,740,86,654
360470188002,36, New York,047, Kings County,446,147,77,51,19,71,71,38,33,0,375,76,39,18,19,1262,123,1139
360470190001,36, New York,047, Kings County,390,198,120,20,58,41,0,0,0,0,349,198,120,20,58,765,140,625
360470190002,36, New York,047, Kings County,206,72,32,40,0,37,0,0,0,0,169,72,32,40,0,458,98,360
360470190003,36, New York,047, Kings County,525,250,118,43,89,8,7,7,0,0,517,243,111,43,89,1199,238,961
360470191001,36, New York,047, Kings County,197,135,123,0,12,7,7,7,0,0,190,128,116,0,12,729,92,637
360470191002,36, New York,047, Kings County,190,163,137,26,0,0,0,0,0,0,190,163,137,26,0,758,0,758
360470191003,36, New York,047, Kings County,63,25,11,14,0,0,0,0,0,0,63,25,11,14,0,362,60,302
360470192001,36, New York,047, Kings County,178,106,79,16,11,51,29,18,0,11,127,77,61,16,0,302,138,164
360470192002,36, New York,047, Kings County,129,94,80,7,7,0,0,0,0,0,129,94,80,7,7,373,35,338
360470192003,36, New York,047, Kings County,199,130,90,33,7,49,23,10,6,7,150,107,80,27,0,421,61,360
360470192004,36, New York,047, Kings County,17,0,0,0,0,0,0,0,0,0,17,0,0,0,0,29,0,29
360470193001,36, New York,047, Kings County,219,30,14,0,16,0,0,0,0,0,219,30,14,0,16,1320,32,1288
360470193002,36, New York,047, Kings County,154,52,19,0,33,0,0,0,0,0,154,52,19,0,33,1134,302,832
360470193003,36, New York,047, Kings County,0,0,0,0,0,0,0,0,0,0,0,0,0,0,0,0,0,0
360470193004,36, New York,047, Kings County,288,74,54,0,20,37,20,0,0,20,251,54,54,0,0,1266,197,1069
360470194001,36, New York,047, Kings County,339,195,129,33,33,148,95,83,0,12,191,100,46,33,21,488,171,317
360470194002,36, New York,047, Kings County,364,248,248,0,0,205,205,205,0,0,159,43,43,0,0,728,241,487
360470194003,36, New York,047, Kings County,257,201,193,8,0,6,0,0,0,0,251,201,193,8,0,470,32,438
360470195001,36, New York,047, Kings County,135,31,10,0,21,15,0,0,0,0,120,31,10,0,21,422,28,394
360470195002,36, New York,047, Kings County,125,49,35,14,0,9,0,0,0,0,116,49,35,14,0,447,28,419
360470195003,36, New York,047, Kings County,413,298,156,63,79,0,0,0,0,0,413,298,156,63,79,1533,283,1250
360470195004,36, New York,047, Kings County,89,0,0,0,0,0,0,0,0,0,89,0,0,0,0,353,44,309
360470196001,36, New York,047, Kings County,517,387,364,0,23,73,53,36,0,17,444,334,328,0,6,697,116,581
360470196002,36, New York,047, Kings County,273,115,58,8,49,84,56,25,0,31,189,59,33,8,18,1045,219,826
360470196003,36, New York,047, Kings County,342,217,175,31,11,59,32,1,31,0,283,185,174,0,11,501,194,307
360470197001,36, New York,047, Kings County,89,29,9,0,20,9,0,0,0,0,80,29,9,0,20,382,40,342
360470197002,36, New York,047, Kings County,139,88,78,0,10,0,0,0,0,0,139,88,78,0,10,457,0,457
360470197003,36, New York,047, Kings County,432,311,134,44,133,0,0,0,0,0,432,311,134,44,133,1171,72,1099
360470197004,36, New York,047, Kings County,179,52,45,0,7,0,0,0,0,0,179,52,45,0,7,623,60,563
360470198001,36, New York,047, Kings County,166,79,79,0,0,5,0,0,0,0,161,79,79,0,0,568,51,517
360470198002,36, New York,047, Kings County,333,126,124,0,2,18,18,16,0,2,315,108,108,0,0,841,48,793
360470199001,36, New York,047, Kings County,53,31,31,0,0,0,0,0,0,0,53,31,31,0,0,498,20,478
360470199002,36, New York,047, Kings County,109,19,19,0,0,0,0,0,0,0,109,19,19,0,0,592,13,579
360470199003,36, New York,047, Kings County,312,169,85,0,84,0,0,0,0,0,312,169,85,0,84,899,28,871
360470199004,36, New York,047, Kings County,213,107,67,0,40,61,40,0,0,40,152,67,67,0,0,653,187,466
360470200001,36, New York,047, Kings County,243,103,83,7,13,28,1,0,1,0,215,102,83,6,13,619,48,571
360470200002,36, New York,047, Kings County,315,106,45,34,27,42,13,1,12,0,273,93,44,22,27,686,94,592
360470201001,36, New York,047, Kings County,95,56,19,12,25,0,0,0,0,0,95,56,19,12,25,444,21,423
360470201002,36, New York,047, Kings County,204,100,100,0,0,0,0,0,0,0,204,100,100,0,0,749,15,734
360470201003,36, New York,047, Kings County,217,53,34,0,19,58,0,0,0,0,159,53,34,0,19,1261,293,968
360470201004,36, New York,047, Kings County,221,129,112,17,0,0,0,0,0,0,221,129,112,17,0,882,27,855
360470202001,36, New York,047, Kings County,233,56,47,3,6,16,3,0,3,0,217,53,47,0,6,580,39,541
360470202002,36, New York,047, Kings County,282,188,119,6,63,0,0,0,0,0,282,188,119,6,63,664,16,648
360470203001,36, New York,047, Kings County,264,124,109,0,15,7,0,0,0,0,257,124,109,0,15,886,94,792
360470203002,36, New York,047, Kings County,111,62,40,0,22,0,0,0,0,0,111,62,40,0,22,629,78,551
360470204001,36, New York,047, Kings County,218,56,42,0,14,19,19,19,0,0,199,37,23,0,14,656,40,616
360470204002,36, New York,047, Kings County,244,121,87,0,34,5,5,5,0,0,239,116,82,0,34,800,77,723
360470205001,36, New York,047, Kings County,92,19,19,0,0,0,0,0,0,0,92,19,19,0,0,550,44,506
360470205002,36, New York,047, Kings County,215,154,130,0,24,0,0,0,0,0,215,154,130,0,24,771,56,715
360470205003,36, New York,047, Kings County,443,216,167,38,11,0,0,0,0,0,443,216,167,38,11,1201,31,1170
360470206001,36, New York,047, Kings County,330,142,92,17,33,86,67,47,0,20,244,75,45,17,13,748,207,541
360470206002,36, New York,047, Kings County,384,148,96,26,26,26,6,0,0,6,358,142,96,26,20,978,63,915
360470207001,36, New York,047, Kings County,371,164,164,0,0,0,0,0,0,0,371,164,164,0,0,1233,19,1214
360470207002,36, New York,047, Kings County,385,177,139,0,38,18,18,0,0,18,367,159,139,0,20,1352,92,1260
360470207003,36, New York,047, Kings County,335,85,85,0,0,0,0,0,0,0,335,85,85,0,0,889,69,820
360470208001,36, New York,047, Kings County,175,63,50,0,13,0,0,0,0,0,175,63,50,0,13,433,78,355
360470208002,36, New York,047, Kings County,276,155,155,0,0,9,9,9,0,0,267,146,146,0,0,685,33,652
360470208003,36, New York,047, Kings County,522,110,80,0,30,36,20,0,0,20,486,90,80,0,10,680,43,637
360470210001,36, New York,047, Kings County,279,129,109,0,20,85,51,51,0,0,194,78,58,0,20,716,137,579
360470210002,36, New York,047, Kings County,388,191,171,0,20,94,93,75,0,18,294,98,96,0,2,891,254,637
360470210003,36, New York,047, Kings County,261,140,123,17,0,49,49,49,0,0,212,91,74,17,0,475,93,382
360470211001,36, New York,047, Kings County,167,77,15,17,45,0,0,0,0,0,167,77,15,17,45,528,7,521
360470211002,36, New York,047, Kings County,335,176,65,25,86,24,19,0,13,6,311,157,65,12,80,1210,238,972
360470211003,36, New York,047, Kings County,55,0,0,0,0,5,0,0,0,0,50,0,0,0,0,197,12,185
360470212001,36, New York,047, Kings County,334,158,100,12,46,52,34,23,0,11,282,124,77,12,35,760,122,638
360470212002,36, New York,047, Kings County,315,140,140,0,0,54,35,35,0,0,261,105,105,0,0,495,49,446
360470212003,36, New York,047, Kings County,277,127,112,0,15,122,97,82,0,15,155,30,30,0,0,538,49,489
360470213001,36, New York,047, Kings County,70,42,0,0,42,8,0,0,0,0,62,42,0,0,42,660,107,553
360470213002,36, New York,047, Kings County,655,357,271,21,65,186,149,149,0,0,469,208,122,21,65,1404,280,1124
360470213003,36, New York,047, Kings County,285,142,77,0,65,2,0,0,0,0,283,142,77,0,65,1103,122,981
360470214001,36, New York,047, Kings County,11,0,0,0,0,0,0,0,0,0,11,0,0,0,0,40,0,40
360470214002,36, New York,047, Kings County,282,206,176,16,14,61,55,46,0,9,221,151,130,16,5,634,155,479
360470214003,36, New York,047, Kings County,138,66,36,0,30,43,36,26,0,10,95,30,10,0,20,395,69,326
360470215001,36, New York,047, Kings County,133,63,63,0,0,15,0,0,0,0,118,63,63,0,0,505,88,417
360470215002,36, New York,047, Kings County,185,15,15,0,0,0,0,0,0,0,185,15,15,0,0,647,42,605
360470215003,36, New York,047, Kings County,241,58,58,0,0,38,38,38,0,0,203,20,20,0,0,1278,97,1181
360470215004,36, New York,047, Kings County,549,346,314,0,32,0,0,0,0,0,549,346,314,0,32,2080,114,1966
360470216001,36, New York,047, Kings County,323,255,205,20,30,201,155,125,0,30,122,100,80,20,0,749,521,228
360470216002,36, New York,047, Kings County,237,114,114,0,0,33,19,19,0,0,204,95,95,0,0,540,68,472
360470216003,36, New York,047, Kings County,290,107,67,0,40,104,62,46,0,16,186,45,21,0,24,455,156,299
360470217001,36, New York,047, Kings County,213,47,35,0,12,12,0,0,0,0,201,47,35,0,12,1032,227,805
360470217002,36, New York,047, Kings County,516,265,176,21,68,24,14,0,0,14,492,251,176,21,54,1893,242,1651
360470218001,36, New York,047, Kings County,201,148,117,0,31,34,22,22,0,0,167,126,95,0,31,472,67,405
360470218002,36, New York,047, Kings County,227,99,99,0,0,0,0,0,0,0,227,99,99,0,0,569,14,555
360470218003,36, New York,047, Kings County,212,112,64,22,26,20,9,0,0,9,192,103,64,22,17,616,90,526
360470219001,36, New York,047, Kings County,159,103,34,0,69,29,29,0,0,29,130,74,34,0,40,752,47,705
360470219002,36, New York,047, Kings County,216,44,25,0,19,1,0,0,0,0,215,44,25,0,19,1137,167,970
360470219003,36, New York,047, Kings County,295,115,72,43,0,0,0,0,0,0,295,115,72,43,0,1528,142,1386
360470220001,36, New York,047, Kings County,128,106,106,0,0,35,35,35,0,0,93,71,71,0,0,386,191,195
360470220002,36, New York,047, Kings County,219,104,93,0,11,74,63,63,0,0,145,41,30,0,11,454,149,305
360470220003,36, New York,047, Kings County,269,256,256,0,0,115,115,115,0,0,154,141,141,0,0,992,328,664
360470220004,36, New York,047, Kings County,150,117,117,0,0,107,107,107,0,0,43,10,10,0,0,592,305,287
360470221001,36, New York,047, Kings County,193,91,61,0,30,86,22,0,0,22,107,69,61,0,8,1527,765,762
360470221002,36, New York,047, Kings County,330,76,10,0,66,0,0,0,0,0,330,76,10,0,66,996,97,899
360470221003,36, New York,047, Kings County,158,31,16,15,0,13,0,0,0,0,145,31,16,15,0,515,61,454
360470222001,36, New York,047, Kings County,258,208,195,0,13,171,171,171,0,0,87,37,24,0,13,709,528,181
360470222002,36, New York,047, Kings County,162,69,46,0,23,28,28,28,0,0,134,41,18,0,23,390,109,281
360470222003,36, New York,047, Kings County,457,188,125,0,63,53,53,10,0,43,404,135,115,0,20,821,182,639
360470224001,36, New York,047, Kings County,175,155,155,0,0,13,13,13,0,0,162,142,142,0,0,442,27,415
360470224002,36, New York,047, Kings County,295,204,190,14,0,95,95,81,14,0,200,109,109,0,0,824,200,624
360470224003,36, New York,047, Kings County,311,155,71,52,32,15,15,15,0,0,296,140,56,52,32,607,100,507
360470224004,36, New York,047, Kings County,261,178,162,16,0,28,28,28,0,0,233,150,134,16,0,758,54,704
360470226001,36, New York,047, Kings County,255,177,157,0,20,12,12,12,0,0,243,165,145,0,20,549,26,523
360470226002,36, New York,047, Kings County,219,108,108,0,0,21,12,12,0,0,198,96,96,0,0,449,47,402
360470227001,36, New York,047, Kings County,71,31,31,0,0,0,0,0,0,0,71,31,31,0,0,470,48,422
360470227002,36, New York,047, Kings County,244,159,99,0,60,0,0,0,0,0,244,159,99,0,60,902,47,855
360470227003,36, New York,047, Kings County,76,18,18,0,0,12,0,0,0,0,64,18,18,0,0,591,67,524
360470227004,36, New York,047, Kings County,383,262,135,17,110,11,0,0,0,0,372,262,135,17,110,1239,218,1021
360470228001,36, New York,047, Kings County,289,194,170,0,24,56,18,18,0,0,233,176,152,0,24,573,124,449
360470228002,36, New York,047, Kings County,305,161,158,0,3,173,103,100,0,3,132,58,58,0,0,881,438,443
360470228003,36, New York,047, Kings County,101,86,53,0,33,33,33,0,0,33,68,53,53,0,0,278,66,212
360470229001,36, New York,047, Kings County,149,98,87,0,11,0,0,0,0,0,149,98,87,0,11,545,19,526
360470229002,36, New York,047, Kings County,109,89,59,0,30,0,0,0,0,0,109,89,59,0,30,878,93,785
360470229003,36, New York,047, Kings County,110,19,11,0,8,0,0,0,0,0,110,19,11,0,8,455,43,412
360470229004,36, New York,047, Kings County,126,104,85,0,19,26,26,26,0,0,100,78,59,0,19,844,260,584
360470230001,36, New York,047, Kings County,351,213,164,28,21,152,152,131,0,21,199,61,33,28,0,755,339,416
360470230002,36, New York,047, Kings County,86,28,28,0,0,41,26,26,0,0,45,2,2,0,0,177,84,93
360470230003,36, New York,047, Kings County,381,216,166,0,50,48,35,23,0,12,333,181,143,0,38,968,151,817
360470231001,36, New York,047, Kings County,194,110,92,0,18,9,0,0,0,0,185,110,92,0,18,888,145,743
360470231002,36, New York,047, Kings County,336,106,85,21,0,8,8,8,0,0,328,98,77,21,0,1237,30,1207
360470231003,36, New York,047, Kings County,242,31,31,0,0,0,0,0,0,0,242,31,31,0,0,717,8,709
360470232001,36, New York,047, Kings County,225,183,183,0,0,15,15,15,0,0,210,168,168,0,0,559,32,527
360470232002,36, New York,047, Kings County,296,233,233,0,0,28,28,28,0,0,268,205,205,0,0,664,52,612
360470232003,36, New York,047, Kings County,245,183,183,0,0,95,88,88,0,0,150,95,95,0,0,447,44,403
360470232004,36, New York,047, Kings County,148,9,9,0,0,94,0,0,0,0,54,9,9,0,0,477,330,147
360470232005,36, New York,047, Kings County,178,93,83,0,10,158,73,71,0,2,20,20,12,0,8,408,365,43
360470233001,36, New York,047, Kings County,349,188,157,0,31,0,0,0,0,0,349,188,157,0,31,1462,117,1345
360470233002,36, New York,047, Kings County,532,383,61,0,322,245,211,0,0,211,287,172,61,0,111,1629,605,1024
360470233003,36, New York,047, Kings County,283,267,234,0,33,97,97,97,0,0,186,170,137,0,33,1253,419,834
360470234001,36, New York,047, Kings County,402,247,221,26,0,172,147,121,26,0,230,100,100,0,0,885,387,498
360470234002,36, New York,047, Kings County,389,317,317,0,0,147,147,147,0,0,242,170,170,0,0,845,377,468
360470234003,36, New York,047, Kings County,260,149,121,0,28,101,75,47,0,28,159,74,74,0,0,749,170,579
360470235001,36, New York,047, Kings County,496,298,271,4,23,136,136,136,0,0,360,162,135,4,23,1549,412,1137
360470235002,36, New York,047, Kings County,312,275,184,40,51,152,144,110,0,34,160,131,74,40,17,787,328,459
360470236001,36, New York,047, Kings County,202,161,153,8,0,79,59,59,0,0,123,102,94,8,0,457,136,321
360470236002,36, New York,047, Kings County,413,368,368,0,0,152,140,140,0,0,261,228,228,0,0,1107,383,724
360470236003,36, New York,047, Kings County,349,233,233,0,0,106,69,69,0,0,243,164,164,0,0,853,210,643
360470236004,36, New York,047, Kings County,187,138,138,0,0,76,76,76,0,0,111,62,62,0,0,452,193,259
360470238001,36, New York,047, Kings County,306,204,204,0,0,32,32,32,0,0,274,172,172,0,0,912,99,813
360470238002,36, New York,047, Kings County,420,373,340,8,25,207,191,183,8,0,213,182,157,0,25,833,448,385
360470238003,36, New York,047, Kings County,189,129,129,0,0,17,8,8,0,0,172,121,121,0,0,408,57,351
360470240001,36, New York,047, Kings County,398,282,227,0,55,206,177,122,0,55,192,105,105,0,0,677,315,362
360470240002,36, New York,047, Kings County,478,368,295,33,40,188,148,148,0,0,290,220,147,33,40,1080,368,712
360470240003,36, New York,047, Kings County,379,227,227,0,0,198,134,134,0,0,181,93,93,0,0,904,427,477
360470241001,36, New York,047, Kings County,283,186,186,0,0,142,127,127,0,0,141,59,59,0,0,1036,332,704
360470241002,36, New York,047, Kings County,157,30,23,0,7,11,0,0,0,0,146,30,23,0,7,978,266,712
360470242001,36, New York,047, Kings County,247,163,163,0,0,46,46,46,0,0,201,117,117,0,0,741,148,593
360470242002,36, New York,047, Kings County,295,176,162,0,14,18,12,12,0,0,277,164,150,0,14,811,47,764
360470243001,36, New York,047, Kings County,190,44,30,14,0,0,0,0,0,0,190,44,30,14,0,1184,97,1087
360470243002,36, New York,047, Kings County,250,161,149,0,12,0,0,0,0,0,250,161,149,0,12,1112,108,1004
360470243003,36, New York,047, Kings County,198,120,81,0,39,0,0,0,0,0,198,120,81,0,39,1093,300,793
360470244001,36, New York,047, Kings County,202,118,51,0,67,53,53,8,0,45,149,65,43,0,22,434,93,341
360470244002,36, New York,047, Kings County,283,125,119,0,6,64,50,50,0,0,219,75,69,0,6,619,209,410
360470244003,36, New York,047, Kings County,348,126,120,0,6,90,74,74,0,0,258,52,46,0,6,692,190,502
360470245001,36, New York,047, Kings County,234,191,77,0,114,0,0,0,0,0,234,191,77,0,114,587,24,563
360470245002,36, New York,047, Kings County,489,193,160,16,17,17,17,0,0,17,472,176,160,16,0,1457,83,1374
360470245003,36, New York,047, Kings County,190,49,49,0,0,17,0,0,0,0,173,49,49,0,0,814,97,717
360470245004,36, New York,047, Kings County,70,57,57,0,0,20,20,20,0,0,50,37,37,0,0,324,83,241
360470246001,36, New York,047, Kings County,237,129,107,15,7,15,15,8,0,7,222,114,99,15,0,508,24,484
360470246002,36, New York,047, Kings County,278,151,118,7,26,39,34,21,0,13,239,117,97,7,13,660,88,572
360470246003,36, New York,047, Kings County,214,111,64,12,35,32,31,19,12,0,182,80,45,0,35,499,40,459
360470247001,36, New York,047, Kings County,395,89,10,0,79,132,79,0,0,79,263,10,10,0,0,1315,333,982
360470247002,36, New York,047, Kings County,152,79,35,0,44,20,17,17,0,0,132,62,18,0,44,962,118,844
360470248001,36, New York,047, Kings County,378,159,149,0,10,24,16,11,0,5,354,143,138,0,5,675,42,633
360470248002,36, New York,047, Kings County,218,130,130,0,0,33,21,21,0,0,185,109,109,0,0,428,107,321
360470249001,36, New York,047, Kings County,110,57,43,0,14,14,14,0,0,14,96,43,43,0,0,829,121,708
360470249002,36, New York,047, Kings County,290,110,67,0,43,44,18,0,0,18,246,92,67,0,25,1089,211,878
360470249003,36, New York,047, Kings County,166,80,48,32,0,18,0,0,0,0,148,80,48,32,0,839,214,625
360470249004,36, New York,047, Kings County,108,57,23,34,0,0,0,0,0,0,108,57,23,34,0,346,47,299
360470250001,36, New York,047, Kings County,192,58,35,0,23,26,20,6,0,14,166,38,29,0,9,593,97,496
360470250002,36, New York,047, Kings County,140,64,46,16,2,14,8,6,0,2,126,56,40,16,0,455,96,359
360470251001,36, New York,047, Kings County,237,16,16,0,0,58,0,0,0,0,179,16,16,0,0,715,150,565
360470251002,36, New York,047, Kings County,397,128,51,0,77,55,55,0,0,55,342,73,51,0,22,1540,376,1164
360470251003,36, New York,047, Kings County,244,115,33,0,82,135,100,33,0,67,109,15,0,0,15,1027,331,696
360470252001,36, New York,047, Kings County,171,54,54,0,0,12,0,0,0,0,159,54,54,0,0,366,50,316
360470252002,36, New York,047, Kings County,485,162,62,83,17,36,17,0,0,17,449,145,62,83,0,1051,103,948
360470252003,36, New York,047, Kings County,356,143,74,7,62,86,70,40,7,23,270,73,34,0,39,888,274,614
360470252004,36, New York,047, Kings County,399,170,160,10,0,47,46,41,5,0,352,124,119,5,0,509,67,442
360470253001,36, New York,047, Kings County,305,201,98,0,103,10,10,10,0,0,295,191,88,0,103,934,90,844
360470253002,36, New York,047, Kings County,336,200,62,78,60,119,119,16,78,25,217,81,46,0,35,1170,280,890
360470253003,36, New York,047, Kings County,121,28,0,0,28,0,0,0,0,0,121,28,0,0,28,466,44,422
360470254001,36, New York,047, Kings County,486,254,192,22,40,6,0,0,0,0,480,254,192,22,40,951,29,922
360470254002,36, New York,047, Kings County,233,47,47,0,0,78,11,11,0,0,155,36,36,0,0,412,118,294
360470254003,36, New York,047, Kings County,221,91,39,21,31,42,42,11,0,31,179,49,28,21,0,645,79,566
360470255001,36, New York,047, Kings County,762,262,45,28,189,204,96,35,16,45,558,166,10,12,144,1885,644,1241
360470255002,36, New York,047, Kings County,669,256,36,44,176,274,97,36,0,61,395,159,0,44,115,1898,896,1002
360470256001,36, New York,047, Kings County,507,344,320,0,24,48,0,0,0,0,459,344,320,0,24,699,88,611
360470256002,36, New York,047, Kings County,405,200,148,17,35,74,55,38,17,0,331,145,110,0,35,858,116,742
360470257001,36, New York,047, Kings County,201,133,46,0,87,25,25,6,0,19,176,108,40,0,68,955,271,684
360470257002,36, New York,047, Kings County,87,39,0,0,39,0,0,0,0,0,87,39,0,0,39,337,18,319
360470257003,36, New York,047, Kings County,180,105,95,0,10,10,10,0,0,10,170,95,95,0,0,490,17,473
360470258001,36, New York,047, Kings County,220,121,85,0,36,70,69,33,0,36,150,52,52,0,0,482,78,404
360470258002,36, New York,047, Kings County,394,241,103,13,125,73,59,27,0,32,321,182,76,13,93,632,64,568
360470258003,36, New York,047, Kings County,346,112,112,0,0,20,0,0,0,0,326,112,112,0,0,784,133,651
360470259011,36, New York,047, Kings County,360,157,103,17,37,107,49,19,17,13,253,108,84,0,24,1460,369,1091
360470259021,36, New York,047, Kings County,1109,606,16,0,590,547,291,0,0,291,562,315,16,0,299,2100,889,1211
360470260001,36, New York,047, Kings County,288,212,134,8,70,9,9,0,0,9,279,203,134,8,61,421,9,412
360470260002,36, New York,047, Kings County,138,46,40,0,6,34,26,26,0,0,104,20,14,0,6,403,64,339
360470260003,36, New York,047, Kings County,308,89,44,4,41,21,21,11,0,10,287,68,33,4,31,873,49,824
360470261001,36, New York,047, Kings County,97,48,48,0,0,0,0,0,0,0,97,48,48,0,0,952,323,629
360470261002,36, New York,047, Kings County,205,93,93,0,0,97,0,0,0,0,108,93,93,0,0,868,219,649
360470261003,36, New York,047, Kings County,181,107,28,0,79,126,79,0,0,79,55,28,28,0,0,810,334,476
360470261004,36, New York,047, Kings County,91,24,10,0,14,0,0,0,0,0,91,24,10,0,14,393,17,376
360470261005,36, New York,047, Kings County,94,31,0,12,19,12,12,0,12,0,82,19,0,0,19,689,282,407
360470262001,36, New York,047, Kings County,360,162,85,57,20,57,34,22,12,0,303,128,63,45,20,810,147,663
360470262002,36, New York,047, Kings County,296,114,87,0,27,0,0,0,0,0,296,114,87,0,27,545,0,545
360470263001,36, New York,047, Kings County,528,217,87,65,65,74,55,9,0,46,454,162,78,65,19,1777,300,1477
360470264001,36, New York,047, Kings County,151,102,95,0,7,15,15,8,0,7,136,87,87,0,0,261,34,227
360470264002,36, New York,047, Kings County,281,112,85,0,27,35,27,0,0,27,246,85,85,0,0,618,68,550
360470264003,36, New York,047, Kings County,462,252,72,17,163,42,27,27,0,0,420,225,45,17,163,748,34,714
360470264004,36, New York,047, Kings County,297,109,53,0,56,7,7,7,0,0,290,102,46,0,56,723,106,617
360470265001,36, New York,047, Kings County,184,89,0,26,63,93,63,0,0,63,91,26,0,26,0,890,334,556
360470265002,36, New York,047, Kings County,267,155,70,60,25,27,0,0,0,0,240,155,70,60,25,1042,87,955
360470265003,36, New York,047, Kings County,172,42,0,0,42,0,0,0,0,0,172,42,0,0,42,850,132,718
360470265004,36, New York,047, Kings County,99,45,20,0,25,0,0,0,0,0,99,45,20,0,25,381,51,330
360470266001,36, New York,047, Kings County,248,163,149,14,0,16,0,0,0,0,232,163,149,14,0,374,46,328
360470266002,36, New York,047, Kings County,407,191,107,33,51,98,52,15,0,37,309,139,92,33,14,857,223,634
360470266003,36, New York,047, Kings County,255,103,91,0,12,18,0,0,0,0,237,103,91,0,12,749,86,663
360470267001,36, New York,047, Kings County,206,57,0,0,57,0,0,0,0,0,206,57,0,0,57,679,13,666
360470267002,36, New York,047, Kings County,322,154,119,14,21,0,0,0,0,0,322,154,119,14,21,979,47,932
360470267003,36, New York,047, Kings County,367,100,56,0,44,24,24,0,0,24,343,76,56,0,20,1210,67,1143
360470267004,36, New York,047, Kings County,131,49,0,0,49,51,30,0,0,30,80,19,0,0,19,724,132,592
360470268001,36, New York,047, Kings County,201,22,10,0,12,10,10,10,0,0,191,12,0,0,12,397,49,348
360470268002,36, New York,047, Kings County,244,111,87,23,1,24,1,0,0,1,220,110,87,23,0,564,66,498
360470268003,36, New York,047, Kings County,380,181,137,44,0,48,0,0,0,0,332,181,137,44,0,784,65,719
360470268004,36, New York,047, Kings County,303,115,51,30,34,60,54,24,30,0,243,61,27,0,34,727,172,555
360470269001,36, New York,047, Kings County,300,161,129,9,23,47,23,0,0,23,253,138,129,9,0,916,141,775
360470269002,36, New York,047, Kings County,213,180,91,13,76,25,25,0,0,25,188,155,91,13,51,725,90,635
360470269003,36, New York,047, Kings County,175,46,46,0,0,23,23,23,0,0,152,23,23,0,0,655,111,544
360470270001,36, New York,047, Kings County,244,95,53,2,40,35,35,19,0,16,209,60,34,2,24,524,71,453
360470270002,36, New York,047, Kings County,320,183,159,6,18,109,78,78,0,0,211,105,81,6,18,885,344,541
360470271001,36, New York,047, Kings County,249,79,42,0,37,5,5,0,0,5,244,74,42,0,32,1271,298,973
360470271002,36, New York,047, Kings County,419,321,159,54,108,32,18,0,0,18,387,303,159,54,90,1261,139,1122
360470272001,36, New York,047, Kings County,219,112,60,14,38,39,29,0,0,29,180,83,60,14,9,485,54,431
360470272002,36, New York,047, Kings County,530,126,115,11,0,60,24,24,0,0,470,102,91,11,0,912,99,813
360470272003,36, New York,047, Kings County,266,81,72,0,9,85,19,19,0,0,181,62,53,0,9,774,235,539
360470273001,36, New York,047, Kings County,204,125,109,0,16,0,0,0,0,0,204,125,109,0,16,1017,49,968
360470273002,36, New York,047, Kings County,178,36,36,0,0,0,0,0,0,0,178,36,36,0,0,685,0,685
360470273003,36, New York,047, Kings County,403,180,81,0,99,77,73,0,0,73,326,107,81,0,26,1141,109,1032
360470274001,36, New York,047, Kings County,337,89,76,0,13,58,23,11,0,12,279,66,65,0,1,944,185,759
360470274002,36, New York,047, Kings County,434,193,103,32,58,59,49,0,0,49,375,144,103,32,9,1086,63,1023
360470275001,36, New York,047, Kings County,70,23,6,0,17,20,0,0,0,0,50,23,6,0,17,753,272,481
360470275002,36, New York,047, Kings County,273,81,0,23,58,50,50,0,0,50,223,31,0,23,8,1305,229,1076
360470275003,36, New York,047, Kings County,154,26,14,0,12,0,0,0,0,0,154,26,14,0,12,719,141,578
360470275004,36, New York,047, Kings County,315,119,79,12,28,14,14,13,0,1,301,105,66,12,27,1097,145,952
360470276001,36, New York,047, Kings County,484,337,272,23,42,64,64,46,0,18,420,273,226,23,24,607,67,540
360470276002,36, New York,047, Kings County,183,57,38,0,19,8,0,0,0,0,175,57,38,0,19,522,72,450
360470276003,36, New York,047, Kings County,472,164,145,0,19,26,26,7,0,19,446,138,138,0,0,793,49,744
360470277001,36, New York,047, Kings County,357,235,47,0,188,116,82,0,0,82,241,153,47,0,106,895,218,677
360470277002,36, New York,047, Kings County,208,67,19,0,48,30,0,0,0,0,178,67,19,0,48,625,79,546
360470277003,36, New York,047, Kings County,105,86,35,0,51,14,14,0,0,14,91,72,35,0,37,409,40,369
360470277004,36, New York,047, Kings County,336,93,26,0,67,32,0,0,0,0,304,93,26,0,67,1051,231,820
360470278001,36, New York,047, Kings County,300,194,74,9,111,46,37,7,0,30,254,157,67,9,81,920,93,827
360470278002,36, New York,047, Kings County,345,106,85,8,13,8,0,0,0,0,337,106,85,8,13,923,77,846
360470279001,36, New York,047, Kings County,180,119,16,13,90,93,93,16,0,77,87,26,0,13,13,616,251,365
360470279002,36, New York,047, Kings County,239,47,47,0,0,0,0,0,0,0,239,47,47,0,0,938,95,843
360470279003,36, New York,047, Kings County,194,80,27,0,53,15,15,0,0,15,179,65,27,0,38,535,15,520
360470279004,36, New York,047, Kings County,225,101,56,45,0,62,0,0,0,0,163,101,56,45,0,622,210,412
360470280000,36, New York,047, Kings County,0,0,0,0,0,0,0,0,0,0,0,0,0,0,0,0,0,0
360470280001,36, New York,047, Kings County,280,79,66,0,13,23,19,15,0,4,257,60,51,0,9,712,50,662
360470280002,36, New York,047, Kings County,187,108,105,3,0,5,0,0,0,0,182,108,105,3,0,418,23,395
360470281001,36, New York,047, Kings County,321,184,49,24,111,92,92,0,24,68,229,92,49,0,43,877,187,690
360470281002,36, New York,047, Kings County,320,262,48,0,214,67,67,0,0,67,253,195,48,0,147,1252,419,833
360470281003,36, New York,047, Kings County,257,69,37,0,32,15,13,0,0,13,242,56,37,0,19,1031,155,876
360470282000,36, New York,047, Kings County,0,0,0,0,0,0,0,0,0,0,0,0,0,0,0,0,0,0
360470282001,36, New York,047, Kings County,451,80,65,0,15,13,0,0,0,0,438,80,65,0,15,1122,83,1039
360470282002,36, New York,047, Kings County,222,102,55,47,0,26,26,26,0,0,196,76,29,47,0,519,0,519
360470282003,36, New York,047, Kings County,182,71,71,0,0,17,17,17,0,0,165,54,54,0,0,568,128,440
360470283001,36, New York,047, Kings County,300,110,44,0,66,149,110,44,0,66,151,0,0,0,0,1099,488,611
360470283002,36, New York,047, Kings County,405,158,14,0,144,51,14,0,0,14,354,144,14,0,130,1098,317,781
360470283003,36, New York,047, Kings County,230,150,84,0,66,40,0,0,0,0,190,150,84,0,66,645,197,448
360470284001,36, New York,047, Kings County,181,109,100,9,0,37,25,16,9,0,144,84,84,0,0,410,81,329
360470284002,36, New York,047, Kings County,404,131,115,0,16,51,28,14,0,14,353,103,101,0,2,1115,171,944
360470284003,36, New York,047, Kings County,192,156,128,28,0,39,28,0,28,0,153,128,128,0,0,513,106,407
360470285011,36, New York,047, Kings County,64,13,0,0,13,13,13,0,0,13,51,0,0,0,0,334,109,225
360470285021,36, New York,047, Kings County,934,443,199,0,244,392,253,39,0,214,542,190,160,0,30,2534,818,1716
360470286000,36, New York,047, Kings County,0,0,0,0,0,0,0,0,0,0,0,0,0,0,0,0,0,0
360470286001,36, New York,047, Kings County,284,256,171,35,50,30,30,13,0,17,254,226,158,35,33,447,62,385
360470286002,36, New York,047, Kings County,134,86,32,13,41,41,41,0,0,41,93,45,32,13,0,399,44,355
360470286003,36, New York,047, Kings County,243,193,137,0,56,97,57,57,0,0,146,136,80,0,56,657,154,503
360470286004,36, New York,047, Kings County,146,146,146,0,0,41,41,41,0,0,105,105,105,0,0,359,0,359
360470286005,36, New York,047, Kings County,232,132,75,0,57,57,57,0,0,57,175,75,75,0,0,374,39,335
360470287001,36, New York,047, Kings County,92,67,67,0,0,33,33,33,0,0,59,34,34,0,0,860,229,631
360470287002,36, New York,047, Kings County,81,24,14,0,10,0,0,0,0,0,81,24,14,0,10,499,93,406
360470287003,36, New York,047, Kings County,346,286,32,0,254,147,147,32,0,115,199,139,0,0,139,975,344,631
360470288001,36, New York,047, Kings County,188,42,3,0,39,40,15,0,0,15,148,27,3,0,24,466,114,352
360470288002,36, New York,047, Kings County,293,74,74,0,0,54,0,0,0,0,239,74,74,0,0,897,47,850
360470288003,36, New York,047, Kings County,183,73,59,14,0,27,9,9,0,0,156,64,50,14,0,279,44,235
360470289001,36, New York,047, Kings County,125,57,0,0,57,32,13,0,0,13,93,44,0,0,44,562,130,432
360470289002,36, New York,047, Kings County,277,214,120,43,51,0,0,0,0,0,277,214,120,43,51,852,79,773
360470289003,36, New York,047, Kings County,94,38,0,38,0,0,0,0,0,0,94,38,0,38,0,382,21,361
360470289004,36, New York,047, Kings County,97,69,13,37,19,78,69,13,37,19,19,0,0,0,0,1002,547,455
360470290001,36, New York,047, Kings County,335,133,86,0,47,102,33,33,0,0,233,100,53,0,47,771,338,433
360470290002,36, New York,047, Kings County,134,56,56,0,0,17,17,17,0,0,117,39,39,0,0,553,128,425
360470290003,36, New York,047, Kings County,302,106,71,11,24,56,0,0,0,0,246,106,71,11,24,894,167,727
360470291001,36, New York,047, Kings County,306,88,0,0,88,2,0,0,0,0,304,88,0,0,88,1014,18,996
360470291002,36, New York,047, Kings County,167,45,13,0,32,0,0,0,0,0,167,45,13,0,32,602,144,458
360470291003,36, New York,047, Kings County,333,134,0,0,134,86,86,0,0,86,247,48,0,0,48,1037,156,881
360470292000,36, New York,047, Kings County,0,0,0,0,0,0,0,0,0,0,0,0,0,0,0,0,0,0
360470292001,36, New York,047, Kings County,292,120,64,26,30,41,27,8,0,19,251,93,56,26,11,973,259,714
360470292002,36, New York,047, Kings County,326,145,116,0,29,62,20,20,0,0,264,125,96,0,29,663,115,548
360470292003,36, New York,047, Kings County,0,0,0,0,0,0,0,0,0,0,0,0,0,0,0,0,0,0
360470293001,36, New York,047, Kings County,252,151,55,28,68,43,15,15,0,0,209,136,40,28,68,715,119,596
360470293002,36, New York,047, Kings County,244,151,20,76,55,95,76,0,76,0,149,75,20,0,55,680,235,445
360470293003,36, New York,047, Kings County,114,93,93,0,0,0,0,0,0,0,114,93,93,0,0,561,32,529
360470293004,36, New York,047, Kings County,206,33,33,0,0,35,0,0,0,0,171,33,33,0,0,634,116,518
360470294000,36, New York,047, Kings County,0,0,0,0,0,0,0,0,0,0,0,0,0,0,0,0,0,0
360470294001,36, New York,047, Kings County,446,213,122,15,76,56,48,33,7,8,390,165,89,8,68,1383,262,1121
360470295001,36, New York,047, Kings County,452,189,56,0,133,145,133,0,0,133,307,56,56,0,0,1193,309,884
360470295002,36, New York,047, Kings County,140,12,0,0,12,12,12,0,0,12,128,0,0,0,0,458,37,421
360470295003,36, New York,047, Kings County,361,262,35,55,172,0,0,0,0,0,361,262,35,55,172,770,36,734
360470295004,36, New York,047, Kings County,133,22,0,0,22,0,0,0,0,0,133,22,0,0,22,641,52,589
360470296001,36, New York,047, Kings County,411,106,55,0,51,81,60,21,0,39,330,46,34,0,12,608,68,540
360470296002,36, New York,047, Kings County,285,112,83,0,29,94,47,18,0,29,191,65,65,0,0,716,310,406
360470296003,36, New York,047, Kings County,467,260,166,23,71,212,180,86,23,71,255,80,80,0,0,1236,448,788
360470296004,36, New York,047, Kings County,272,149,21,41,87,87,87,0,0,87,185,62,21,41,0,493,55,438
360470297001,36, New York,047, Kings County,294,202,110,22,70,0,0,0,0,0,294,202,110,22,70,651,3,648
360470297002,36, New York,047, Kings County,555,201,54,25,122,215,98,0,11,87,340,103,54,14,35,1814,495,1319
360470297003,36, New York,047, Kings County,312,168,117,0,51,0,0,0,0,0,312,168,117,0,51,1120,25,1095
360470298001,36, New York,047, Kings County,427,188,136,0,52,55,55,26,0,29,372,133,110,0,23,1208,96,1112
360470298002,36, New York,047, Kings County,198,144,85,5,54,71,62,39,0,23,127,82,46,5,31,393,155,238
360470298003,36, New York,047, Kings County,257,129,88,14,27,78,37,37,0,0,179,92,51,14,27,474,136,338
360470299001,36, New York,047, Kings County,298,184,56,0,128,164,146,18,0,128,134,38,38,0,0,772,143,629
360470299002,36, New York,047, Kings County,247,180,88,0,92,60,60,20,0,40,187,120,68,0,52,718,159,559
360470300001,36, New York,047, Kings County,269,148,115,13,20,70,45,34,0,11,199,103,81,13,9,661,200,461
360470300002,36, New York,047, Kings County,225,77,53,0,24,34,24,0,0,24,191,53,53,0,0,546,52,494
360470300003,36, New York,047, Kings County,235,101,48,34,19,81,19,0,0,19,154,82,48,34,0,343,134,209
360470300004,36, New York,047, Kings County,237,97,89,0,8,18,18,10,0,8,219,79,79,0,0,631,45,586
360470300005,36, New York,047, Kings County,83,22,9,0,13,41,0,0,0,0,42,22,9,0,13,225,44,181
360470300006,36, New York,047, Kings County,0,0,0,0,0,0,0,0,0,0,0,0,0,0,0,0,0,0
360470301001,36, New York,047, Kings County,175,114,0,0,114,40,27,0,0,27,135,87,0,0,87,776,149,627
360470301002,36, New York,047, Kings County,163,123,25,0,98,59,59,0,0,59,104,64,25,0,39,420,90,330
360470301003,36, New York,047, Kings County,220,107,36,0,71,16,16,0,0,16,204,91,36,0,55,844,110,734
360470302001,36, New York,047, Kings County,380,152,131,4,17,51,36,27,0,9,329,116,104,4,8,693,81,612
360470302002,36, New York,047, Kings County,303,138,106,13,19,25,11,0,0,11,278,127,106,13,8,700,87,613
360470302003,36, New York,047, Kings County,382,149,138,0,11,89,28,28,0,0,293,121,110,0,11,1221,265,956
360470303001,36, New York,047, Kings County,477,197,40,10,147,111,37,22,0,15,366,160,18,10,132,1554,415,1139
360470303002,36, New York,047, Kings County,232,46,0,0,46,46,46,0,0,46,186,0,0,0,0,542,72,470
360470303003,36, New York,047, Kings County,316,129,0,0,129,90,49,0,0,49,226,80,0,0,80,1369,562,807
360470304000,36, New York,047, Kings County,0,0,0,0,0,0,0,0,0,0,0,0,0,0,0,0,0,0
360470304001,36, New York,047, Kings County,432,132,77,19,36,120,4,4,0,0,312,128,73,19,36,896,168,728
360470304002,36, New York,047, Kings County,336,98,67,30,1,83,43,12,30,1,253,55,55,0,0,721,241,480
360470304003,36, New York,047, Kings County,367,174,155,0,19,35,22,22,0,0,332,152,133,0,19,786,140,646
360470305001,36, New York,047, Kings County,261,221,73,87,61,44,44,44,0,0,217,177,29,87,61,637,94,543
360470305002,36, New York,047, Kings County,640,172,145,0,27,75,27,0,0,27,565,145,145,0,0,2005,235,1770
360470305003,36, New York,047, Kings County,380,132,113,0,19,15,0,0,0,0,365,132,113,0,19,1616,44,1572
360470305004,36, New York,047, Kings County,233,102,102,0,0,0,0,0,0,0,233,102,102,0,0,1111,0,1111
360470306001,36, New York,047, Kings County,475,147,133,4,10,68,17,12,0,5,407,130,121,4,5,1418,252,1166
360470307001,36, New York,047, Kings County,586,336,0,22,314,258,227,0,0,227,328,109,0,22,87,1618,574,1044
360470307002,36, New York,047, Kings County,288,166,0,0,166,207,141,0,0,141,81,25,0,0,25,909,525,384
360470307003,36, New York,047, Kings County,1001,280,69,29,182,8,8,8,0,0,993,272,61,29,182,1610,41,1569
360470308001,36, New York,047, Kings County,546,146,110,14,22,50,0,0,0,0,496,146,110,14,22,1390,110,1280
360470309001,36, New York,047, Kings County,322,248,61,20,167,169,144,0,0,144,153,104,61,20,23,634,322,312
360470309002,36, New York,047, Kings County,309,161,63,22,76,19,10,0,0,10,290,151,63,22,66,980,96,884
360470311001,36, New York,047, Kings County,126,31,31,0,0,31,31,31,0,0,95,0,0,0,0,497,170,327
360470311002,36, New York,047, Kings County,291,178,100,33,45,40,39,39,0,0,251,139,61,33,45,1005,89,916
360470311003,36, New York,047, Kings County,163,77,77,0,0,2,0,0,0,0,161,77,77,0,0,579,147,432
360470313001,36, New York,047, Kings County,253,119,96,0,23,0,0,0,0,0,253,119,96,0,23,983,207,776
360470313002,36, New York,047, Kings County,231,80,0,19,61,0,0,0,0,0,231,80,0,19,61,937,33,904
360470313003,36, New York,047, Kings County,243,123,17,0,106,162,92,0,0,92,81,31,17,0,14,1110,275,835
360470313004,36, New York,047, Kings County,254,24,24,0,0,32,0,0,0,0,222,24,24,0,0,875,149,726
360470314010,36, New York,047, Kings County,0,0,0,0,0,0,0,0,0,0,0,0,0,0,0,0,0,0
360470314011,36, New York,047, Kings County,235,131,131,0,0,0,0,0,0,0,235,131,131,0,0,692,36,656
360470314012,36, New York,047, Kings County,190,70,0,5,65,0,0,0,0,0,190,70,0,5,65,649,0,649
360470314013,36, New York,047, Kings County,306,68,51,0,17,17,17,0,0,17,289,51,51,0,0,796,52,744
360470314014,36, New York,047, Kings County,0,0,0,0,0,0,0,0,0,0,0,0,0,0,0,0,0,0
360470314015,36, New York,047, Kings County,406,145,145,0,0,0,0,0,0,0,406,145,145,0,0,787,0,787
360470314016,36, New York,047, Kings County,235,51,8,0,43,38,38,0,0,38,197,13,8,0,5,472,38,434
360470314020,36, New York,047, Kings County,0,0,0,0,0,0,0,0,0,0,0,0,0,0,0,0,0,0
360470314021,36, New York,047, Kings County,0,0,0,0,0,0,0,0,0,0,0,0,0,0,0,0,0,0
360470315001,36, New York,047, Kings County,217,35,35,0,0,22,22,22,0,0,195,13,13,0,0,1153,308,845
360470315002,36, New York,047, Kings County,278,128,110,0,18,0,0,0,0,0,278,128,110,0,18,1291,86,1205
360470315003,36, New York,047, Kings County,190,84,55,29,0,0,0,0,0,0,190,84,55,29,0,943,24,919
360470315004,36, New York,047, Kings County,254,59,27,0,32,13,0,0,0,0,241,59,27,0,32,872,110,762
360470317011,36, New York,047, Kings County,243,145,126,19,0,17,17,17,0,0,226,128,109,19,0,1305,151,1154
360470317012,36, New York,047, Kings County,361,243,54,0,189,28,24,24,0,0,333,219,30,0,189,1373,203,1170
360470317013,36, New York,047, Kings County,241,180,161,0,19,19,19,0,0,19,222,161,161,0,0,732,72,660
360470317021,36, New York,047, Kings County,212,105,66,12,27,12,12,12,0,0,200,93,54,12,27,832,101,731
360470317022,36, New York,047, Kings County,207,101,81,0,20,0,0,0,0,0,207,101,81,0,20,784,60,724
360470317023,36, New York,047, Kings County,305,171,117,0,54,0,0,0,0,0,305,171,117,0,54,1245,37,1208
360470319001,36, New York,047, Kings County,191,90,45,0,45,0,0,0,0,0,191,90,45,0,45,718,54,664
360470319002,36, New York,047, Kings County,531,293,179,16,98,43,16,0,16,0,488,277,179,0,98,1208,92,1116
360470319003,36, New York,047, Kings County,72,16,16,0,0,7,7,7,0,0,65,9,9,0,0,284,21,263
360470321001,36, New York,047, Kings County,175,69,28,0,41,18,18,0,0,18,157,51,28,0,23,861,106,755
360470321002,36, New York,047, Kings County,294,46,17,0,29,0,0,0,0,0,294,46,17,0,29,711,39,672
360470321003,36, New York,047, Kings County,99,31,0,0,31,0,0,0,0,0,99,31,0,0,31,634,51,583
360470321004,36, New York,047, Kings County,514,252,96,0,156,55,55,55,0,0,459,197,41,0,156,1511,172,1339
360470323001,36, New York,047, Kings County,162,31,0,0,31,31,31,0,0,31,131,0,0,0,0,836,162,674
360470323002,36, New York,047, Kings County,372,181,134,0,47,33,33,0,0,33,339,148,134,0,14,1007,108,899
360470323003,36, New York,047, Kings County,139,38,26,0,12,37,12,0,0,12,102,26,26,0,0,646,89,557
360470325001,36, New York,047, Kings County,310,134,134,0,0,98,98,98,0,0,212,36,36,0,0,988,182,806
360470325002,36, New York,047, Kings County,116,70,11,0,59,59,59,0,0,59,57,11,11,0,0,1178,387,791
360470325003,36, New York,047, Kings County,736,279,148,90,41,60,60,0,19,41,676,219,148,71,0,2200,297,1903
360470326001,36, New York,047, Kings County,210,134,24,0,110,134,134,24,0,110,76,0,0,0,0,377,101,276
360470326002,36, New York,047, Kings County,365,220,36,0,184,235,109,36,0,73,130,111,0,0,111,1260,804,456
360470326003,36, New York,047, Kings County,772,394,44,0,350,265,146,23,0,123,507,248,21,0,227,1924,873,1051
360470326004,36, New York,047, Kings County,88,45,23,0,22,88,45,23,0,22,0,0,0,0,0,318,264,54
360470326005,36, New York,047, Kings County,696,209,126,63,20,65,65,65,0,0,631,144,61,63,20,1458,69,1389
360470327001,36, New York,047, Kings County,148,41,41,0,0,46,0,0,0,0,102,41,41,0,0,602,90,512
360470327002,36, New York,047, Kings County,259,104,64,0,40,58,29,0,0,29,201,75,64,0,11,677,121,556
360470327003,36, New York,047, Kings County,149,64,64,0,0,0,0,0,0,0,149,64,64,0,0,674,82,592
360470328001,36, New York,047, Kings County,129,37,21,0,16,23,9,0,0,9,106,28,21,0,7,358,62,296
360470328002,36, New York,047, Kings County,156,7,7,0,0,0,0,0,0,0,156,7,7,0,0,442,9,433
360470328003,36, New York,047, Kings County,336,92,31,0,61,29,29,0,0,29,307,63,31,0,32,692,69,623
360470328004,36, New York,047, Kings County,255,130,130,0,0,113,20,20,0,0,142,110,110,0,0,404,86,318
360470329001,36, New York,047, Kings County,281,137,137,0,0,55,18,18,0,0,226,119,119,0,0,795,153,642
360470329002,36, New York,047, Kings County,612,219,24,7,188,84,84,0,7,77,528,135,24,0,111,1852,227,1625
360470329003,36, New York,047, Kings County,213,155,56,50,49,67,50,0,50,0,146,105,56,0,49,851,163,688
360470329004,36, New York,047, Kings County,272,94,50,0,44,0,0,0,0,0,272,94,50,0,44,831,81,750
360470330000,36, New York,047, Kings County,0,0,0,0,0,0,0,0,0,0,0,0,0,0,0,0,0,0
360470330001,36, New York,047, Kings County,587,301,17,0,284,226,149,0,0,149,361,152,17,0,135,1675,688,987
360470330002,36, New York,047, Kings County,105,0,0,0,0,0,0,0,0,0,105,0,0,0,0,366,1,365
360470330003,36, New York,047, Kings County,449,269,21,64,184,174,135,13,44,78,275,134,8,20,106,1160,651,509
360470331001,36, New York,047, Kings County,319,212,131,0,81,96,85,39,0,46,223,127,92,0,35,936,377,559
360470331002,36, New York,047, Kings County,482,110,76,0,34,0,0,0,0,0,482,110,76,0,34,1412,143,1269
360470331003,36, New York,047, Kings County,154,98,80,18,0,46,35,17,18,0,108,63,63,0,0,438,130,308
360470333001,36, New York,047, Kings County,178,18,18,0,0,0,0,0,0,0,178,18,18,0,0,500,43,457
360470333002,36, New York,047, Kings County,386,207,92,37,78,38,38,38,0,0,348,169,54,37,78,1039,76,963
360470333003,36, New York,047, Kings County,436,268,232,36,0,83,75,75,0,0,353,193,157,36,0,1132,380,752
360470335001,36, New York,047, Kings County,114,80,67,9,4,24,24,24,0,0,90,56,43,9,4,454,103,351
360470335002,36, New York,047, Kings County,184,100,39,0,61,69,53,6,0,47,115,47,33,0,14,590,137,453
360470335003,36, New York,047, Kings County,393,114,70,23,21,39,39,0,18,21,354,75,70,5,0,929,104,825
360470336000,36, New York,047, Kings County,0,0,0,0,0,0,0,0,0,0,0,0,0,0,0,0,0,0
360470336001,36, New York,047, Kings County,293,127,82,45,0,0,0,0,0,0,293,127,82,45,0,968,142,826
360470336002,36, New York,047, Kings County,160,77,19,58,0,18,18,18,0,0,142,59,1,58,0,545,108,437
360470336003,36, New York,047, Kings County,242,110,110,0,0,33,23,23,0,0,209,87,87,0,0,600,80,520
360470336004,36, New York,047, Kings County,135,13,13,0,0,0,0,0,0,0,135,13,13,0,0,358,0,358
360470336005,36, New York,047, Kings County,256,92,92,0,0,0,0,0,0,0,256,92,92,0,0,951,21,930
360470337011,36, New York,047, Kings County,343,184,111,0,73,0,0,0,0,0,343,184,111,0,73,1002,0,1002
360470337012,36, New York,047, Kings County,180,75,36,0,39,0,0,0,0,0,180,75,36,0,39,945,125,820
360470337021,36, New York,047, Kings County,160,69,69,0,0,34,34,34,0,0,126,35,35,0,0,343,4,339
360470337022,36, New York,047, Kings County,127,11,5,0,6,44,0,0,0,0,83,11,5,0,6,608,248,360
360470339001,36, New York,047, Kings County,236,138,34,0,104,72,42,19,0,23,164,96,15,0,81,653,127,526
360470339002,36, New York,047, Kings County,172,61,22,0,39,33,0,0,0,0,139,61,22,0,39,576,198,378
360470339003,36, New York,047, Kings County,111,78,64,0,14,28,28,28,0,0,83,50,36,0,14,910,303,607
360470339004,36, New York,047, Kings County,367,243,116,0,127,79,79,0,0,79,288,164,116,0,48,828,60,768
360470340001,36, New York,047, Kings County,411,174,23,19,132,117,72,11,12,49,294,102,12,7,83,1029,377,652
360470340002,36, New York,047, Kings County,43,0,0,0,0,28,0,0,0,0,15,0,0,0,0,132,79,53
360470341001,36, New York,047, Kings County,261,153,33,37,83,6,0,0,0,0,255,153,33,37,83,887,77,810
360470341002,36, New York,047, Kings County,41,0,0,0,0,8,0,0,0,0,33,0,0,0,0,407,102,305
360470341003,36, New York,047, Kings County,281,145,25,0,120,77,77,0,0,77,204,68,25,0,43,858,138,720
360470342001,36, New York,047, Kings County,736,339,0,115,224,199,104,0,0,104,537,235,0,115,120,1744,474,1270
360470342002,36, New York,047, Kings County,352,203,37,34,132,62,37,0,0,37,290,166,37,34,95,670,123,547
360470342003,36, New York,047, Kings County,421,103,1,0,102,276,102,0,0,102,145,1,1,0,0,1374,952,422
360470342004,36, New York,047, Kings County,164,0,0,0,0,124,0,0,0,0,40,0,0,0,0,686,500,186
360470343001,36, New York,047, Kings County,71,60,22,0,38,60,60,22,0,38,11,0,0,0,0,275,60,215
360470343002,36, New York,047, Kings County,178,35,0,0,35,40,0,0,0,0,138,35,0,0,35,803,219,584
360470343003,36, New York,047, Kings County,445,227,28,0,199,210,124,28,0,96,235,103,0,0,103,1226,593,633
360470343004,36, New York,047, Kings County,463,194,0,0,194,248,117,0,0,117,215,77,0,0,77,1262,586,676
360470345001,36, New York,047, Kings County,216,146,69,39,38,64,51,0,39,12,152,95,69,0,26,634,148,486
360470345002,36, New York,047, Kings County,325,131,84,23,24,6,0,0,0,0,319,131,84,23,24,1277,74,1203
360470347001,36, New York,047, Kings County,153,103,0,0,103,77,77,0,0,77,76,26,0,0,26,581,123,458
360470347002,36, New York,047, Kings County,74,41,41,0,0,25,15,15,0,0,49,26,26,0,0,593,264,329
360470347003,36, New York,047, Kings County,463,254,24,206,24,27,0,0,0,0,436,254,24,206,24,992,208,784
360470348001,36, New York,047, Kings County,374,196,128,54,14,56,41,41,0,0,318,155,87,54,14,645,74,571
360470348002,36, New York,047, Kings County,262,167,79,19,69,50,44,0,0,44,212,123,79,19,25,421,42,379
360470349011,36, New York,047, Kings County,359,202,116,23,63,24,24,24,0,0,335,178,92,23,63,488,47,441
360470349012,36, New York,047, Kings County,160,49,22,0,27,0,0,0,0,0,160,49,22,0,27,560,15,545
360470349021,36, New York,047, Kings County,333,216,145,0,71,15,15,0,0,15,318,201,145,0,56,1235,208,1027
360470349022,36, New York,047, Kings County,149,149,8,27,114,37,37,0,0,37,112,112,8,27,77,587,200,387
360470349023,36, New York,047, Kings County,308,242,35,140,67,55,41,0,41,0,253,201,35,99,67,654,146,508
360470350001,36, New York,047, Kings County,565,142,80,11,51,38,6,0,0,6,527,136,80,11,45,1561,273,1288
360470350002,36, New York,047, Kings County,407,39,39,0,0,25,0,0,0,0,382,39,39,0,0,1232,197,1035
360470351011,36, New York,047, Kings County,471,317,29,0,288,100,75,0,0,75,371,242,29,0,213,1046,348,698
360470351021,36, New York,047, Kings County,431,263,30,60,173,136,136,12,60,64,295,127,18,0,109,851,247,604
360470351022,36, New York,047, Kings County,246,79,25,11,43,39,25,14,0,11,207,54,11,11,32,875,107,768
360470352000,36, New York,047, Kings County,0,0,0,0,0,0,0,0,0,0,0,0,0,0,0,0,0,0
360470352001,36, New York,047, Kings County,120,54,39,0,15,44,0,0,0,0,76,54,39,0,15,954,585,369
360470353011,36, New York,047, Kings County,336,184,22,97,65,87,0,0,0,0,249,184,22,97,65,1935,722,1213
360470353012,36, New York,047, Kings County,71,19,0,0,19,19,19,0,0,19,52,0,0,0,0,374,124,250
360470353021,36, New York,047, Kings County,406,196,158,0,38,10,10,10,0,0,396,186,148,0,38,926,89,837
360470353022,36, New York,047, Kings County,386,190,62,90,38,32,27,27,0,0,354,163,35,90,38,1117,78,1039
360470354001,36, New York,047, Kings County,503,114,78,36,0,60,0,0,0,0,443,114,78,36,0,1748,433,1315
360470354002,36, New York,047, Kings County,669,259,132,0,127,21,0,0,0,0,648,259,132,0,127,1658,150,1508
360470354003,36, New York,047, Kings County,394,58,58,0,0,18,0,0,0,0,376,58,58,0,0,1089,70,1019
360470355001,36, New York,047, Kings County,473,242,123,18,101,66,0,0,0,0,407,242,123,18,101,1117,86,1031
360470355002,36, New York,047, Kings County,417,171,29,0,142,0,0,0,0,0,417,171,29,0,142,882,59,823
360470355003,36, New York,047, Kings County,430,175,119,0,56,83,42,23,0,19,347,133,96,0,37,1308,280,1028
360470356011,36, New York,047, Kings County,860,128,70,24,34,127,11,0,0,11,733,117,70,24,23,2245,461,1784
360470356021,36, New York,047, Kings County,208,50,13,0,37,27,0,0,0,0,181,50,13,0,37,758,154,604
360470356022,36, New York,047, Kings County,820,245,209,36,0,38,0,0,0,0,782,245,209,36,0,2390,167,2223
360470356023,36, New York,047, Kings County,626,275,205,36,34,48,34,0,0,34,578,241,205,36,0,1599,240,1359
360470357011,36, New York,047, Kings County,521,253,79,0,174,134,113,42,0,71,387,140,37,0,103,1690,367,1323
360470357021,36, New York,047, Kings County,0,0,0,0,0,0,0,0,0,0,0,0,0,0,0,0,0,0
360470359001,36, New York,047, Kings County,220,31,0,0,31,51,31,0,0,31,169,0,0,0,0,952,118,834
360470359002,36, New York,047, Kings County,364,186,90,0,96,0,0,0,0,0,364,186,90,0,96,1146,66,1080
360470359003,36, New York,047, Kings County,417,174,97,0,77,169,111,58,0,53,248,63,39,0,24,1690,805,885
360470359004,36, New York,047, Kings County,263,102,81,0,21,21,21,0,0,21,242,81,81,0,0,749,45,704
360470360011,36, New York,047, Kings County,219,28,28,0,0,6,0,0,0,0,213,28,28,0,0,590,76,514
360470360012,36, New York,047, Kings County,327,32,23,0,9,160,15,6,0,9,167,17,17,0,0,728,280,448
360470360013,36, New York,047, Kings County,345,114,58,0,56,110,64,18,0,46,235,50,40,0,10,671,278,393
360470360021,36, New York,047, Kings County,482,112,112,0,0,126,17,17,0,0,356,95,95,0,0,1273,451,822
360470360022,36, New York,047, Kings County,673,83,83,0,0,198,0,0,0,0,475,83,83,0,0,1680,607,1073
360470361001,36, New York,047, Kings County,112,57,0,24,33,0,0,0,0,0,112,57,0,24,33,553,111,442
360470361002,36, New York,047, Kings County,261,195,62,25,108,113,113,0,25,88,148,82,62,0,20,1001,571,430
360470361003,36, New York,047, Kings County,106,56,0,0,56,0,0,0,0,0,106,56,0,0,56,667,189,478
360470362001,36, New York,047, Kings County,358,190,143,16,31,145,92,75,0,17,213,98,68,16,14,752,234,518
360470362002,36, New York,047, Kings County,188,124,86,0,38,77,77,39,0,38,111,47,47,0,0,351,49,302
360470362003,36, New York,047, Kings County,438,285,262,23,0,20,0,0,0,0,418,285,262,23,0,591,49,542
360470363001,36, New York,047, Kings County,132,70,70,0,0,94,70,70,0,0,38,0,0,0,0,650,362,288
360470363002,36, New York,047, Kings County,327,64,26,12,26,79,0,0,0,0,248,64,26,12,26,982,238,744
360470363003,36, New York,047, Kings County,515,352,104,72,176,153,118,0,72,46,362,234,104,0,130,1215,334,881
360470363004,36, New York,047, Kings County,409,211,0,0,211,114,114,0,0,114,295,97,0,0,97,784,114,670
360470364001,36, New York,047, Kings County,326,91,44,0,47,26,25,0,0,25,300,66,44,0,22,750,114,636
360470364002,36, New York,047, Kings County,281,143,90,0,53,32,17,0,0,17,249,126,90,0,36,577,75,502
360470365011,36, New York,047, Kings County,653,312,93,49,170,104,104,48,25,31,549,208,45,24,139,1835,235,1600
360470365012,36, New York,047, Kings County,207,164,132,32,0,63,32,0,32,0,144,132,132,0,0,403,177,226
360470365021,36, New York,047, Kings County,358,323,58,13,252,95,95,0,0,95,263,228,58,13,157,1071,443,628
360470366001,36, New York,047, Kings County,242,167,120,28,19,58,58,39,0,19,184,109,81,28,0,531,67,464
360470366002,36, New York,047, Kings County,276,141,85,0,56,62,62,37,0,25,214,79,48,0,31,750,218,532
360470366003,36, New York,047, Kings County,304,185,158,0,27,29,29,29,0,0,275,156,129,0,27,449,55,394
360470367001,36, New York,047, Kings County,0,0,0,0,0,0,0,0,0,0,0,0,0,0,0,62,46,16
360470367002,36, New York,047, Kings County,231,85,8,0,77,16,0,0,0,0,215,85,8,0,77,767,200,567
360470367003,36, New York,047, Kings County,211,74,34,0,40,9,9,0,0,9,202,65,34,0,31,521,18,503
360470367004,36, New York,047, Kings County,0,0,0,0,0,0,0,0,0,0,0,0,0,0,0,0,0,0
360470369001,36, New York,047, Kings County,265,105,36,0,69,89,53,0,0,53,176,52,36,0,16,876,240,636
360470369002,36, New York,047, Kings County,215,95,95,0,0,59,0,0,0,0,156,95,95,0,0,741,229,512
360470369003,36, New York,047, Kings County,229,99,12,0,87,87,87,0,0,87,142,12,12,0,0,1501,670,831
360470369004,36, New York,047, Kings County,380,111,69,0,42,26,0,0,0,0,354,111,69,0,42,1077,77,1000
360470370001,36, New York,047, Kings County,291,125,125,0,0,51,51,51,0,0,240,74,74,0,0,777,101,676
360470370002,36, New York,047, Kings County,277,71,43,0,28,0,0,0,0,0,277,71,43,0,28,738,26,712
360470370003,36, New York,047, Kings County,264,89,81,0,8,36,15,7,0,8,228,74,74,0,0,688,106,582
360470370004,36, New York,047, Kings County,214,34,21,0,13,22,1,0,0,1,192,33,21,0,12,557,49,508
360470371001,36, New York,047, Kings County,150,102,102,0,0,0,0,0,0,0,150,102,102,0,0,389,14,375
360470371002,36, New York,047, Kings County,263,177,166,0,11,36,0,0,0,0,227,177,166,0,11,828,113,715
360470371003,36, New York,047, Kings County,213,118,70,0,48,62,48,0,0,48,151,70,70,0,0,699,87,612
360470371004,36, New York,047, Kings County,290,207,78,0,129,35,35,0,0,35,255,172,78,0,94,672,89,583
360470371005,36, New York,047, Kings County,217,64,0,0,64,0,0,0,0,0,217,64,0,0,64,723,0,723
360470373001,36, New York,047, Kings County,267,204,113,34,57,101,101,32,34,35,166,103,81,0,22,938,336,602
360470373002,36, New York,047, Kings County,239,79,0,0,79,0,0,0,0,0,239,79,0,0,79,1119,457,662
360470373003,36, New York,047, Kings County,163,69,35,0,34,42,0,0,0,0,121,69,35,0,34,607,70,537
360470373004,36, New York,047, Kings County,329,166,133,0,33,13,0,0,0,0,316,166,133,0,33,964,218,746
360470374011,36, New York,047, Kings County,95,41,25,0,16,16,16,0,0,16,79,25,25,0,0,342,16,326
360470374012,36, New York,047, Kings County,79,12,12,0,0,0,0,0,0,0,79,12,12,0,0,306,8,298
360470374013,36, New York,047, Kings County,285,224,203,0,21,87,50,50,0,0,198,174,153,0,21,685,115,570
360470374014,36, New York,047, Kings County,278,189,14,0,175,8,8,0,0,8,270,181,14,0,167,518,17,501
360470374015,36, New York,047, Kings County,457,208,126,63,19,46,6,0,0,6,411,202,126,63,13,957,283,674
360470374021,36, New York,047, Kings County,428,164,129,19,16,33,33,17,0,16,395,131,112,19,0,793,95,698
360470374022,36, New York,047, Kings County,476,308,284,0,24,53,53,53,0,0,423,255,231,0,24,1091,268,823
360470374023,36, New York,047, Kings County,193,31,31,0,0,0,0,0,0,0,193,31,31,0,0,597,82,515
360470374024,36, New York,047, Kings County,108,30,30,0,0,0,0,0,0,0,108,30,30,0,0,376,17,359
360470375001,36, New York,047, Kings County,197,60,42,0,18,0,0,0,0,0,197,60,42,0,18,696,0,696
360470375002,36, New York,047, Kings County,214,138,36,27,75,56,42,0,0,42,158,96,36,27,33,1250,254,996
360470375003,36, New York,047, Kings County,216,106,0,86,20,8,8,0,0,8,208,98,0,86,12,889,210,679
360470377001,36, New York,047, Kings County,232,168,41,0,127,61,61,30,0,31,171,107,11,0,96,767,238,529
360470377002,36, New York,047, Kings County,215,121,3,0,118,15,0,0,0,0,200,121,3,0,118,696,101,595
360470377003,36, New York,047, Kings County,294,165,78,0,87,84,47,0,0,47,210,118,78,0,40,1013,233,780
360470377004,36, New York,047, Kings County,395,209,149,26,34,40,11,0,0,11,355,198,149,26,23,1092,91,1001
360470379001,36, New York,047, Kings County,263,190,78,0,112,59,36,0,0,36,204,154,78,0,76,845,215,630
360470379002,36, New York,047, Kings County,346,171,78,0,93,0,0,0,0,0,346,171,78,0,93,1133,243,890
360470379003,36, New York,047, Kings County,460,228,121,9,98,104,104,57,0,47,356,124,64,9,51,1473,438,1035
360470381001,36, New York,047, Kings County,350,251,88,76,87,55,55,0,0,55,295,196,88,76,32,865,99,766
360470381002,36, New York,047, Kings County,632,194,20,0,174,138,91,20,0,71,494,103,0,0,103,1944,451,1493
360470381003,36, New York,047, Kings County,96,81,14,0,67,0,0,0,0,0,96,81,14,0,67,280,16,264
360470381004,36, New York,047, Kings County,180,89,77,0,12,29,29,17,0,12,151,60,60,0,0,1012,245,767
360470382001,36, New York,047, Kings County,134,75,47,28,0,0,0,0,0,0,134,75,47,28,0,248,15,233
360470382002,36, New York,047, Kings County,740,443,138,30,275,411,325,82,0,243,329,118,56,30,32,1576,804,772
360470382003,36, New York,047, Kings County,586,299,35,9,255,317,210,35,9,166,269,89,0,0,89,1531,661,870
360470383001,36, New York,047, Kings County,320,195,170,0,25,7,0,0,0,0,313,195,170,0,25,1336,129,1207
360470383002,36, New York,047, Kings County,389,114,9,0,105,182,48,0,0,48,207,66,9,0,57,1293,497,796
360470383003,36, New York,047, Kings County,164,61,40,21,0,0,0,0,0,0,164,61,40,21,0,617,12,605
360470383004,36, New York,047, Kings County,369,143,48,38,57,82,38,0,38,0,287,105,48,0,57,915,263,652
360470385001,36, New York,047, Kings County,239,128,110,0,18,5,1,0,0,1,234,127,110,0,17,1026,41,985
360470385002,36, New York,047, Kings County,150,62,62,0,0,20,20,20,0,0,130,42,42,0,0,989,71,918
360470385003,36, New York,047, Kings County,250,104,56,0,48,71,48,0,0,48,179,56,56,0,0,629,69,560
360470385004,36, New York,047, Kings County,162,85,65,0,20,0,0,0,0,0,162,85,65,0,20,684,42,642
360470386001,36, New York,047, Kings County,416,167,162,0,5,58,38,38,0,0,358,129,124,0,5,909,176,733
360470386002,36, New York,047, Kings County,444,206,154,12,40,53,34,22,0,12,391,172,132,12,28,996,97,899
360470387001,36, New York,047, Kings County,539,371,343,0,28,303,274,274,0,0,236,97,69,0,28,1279,467,812
360470387002,36, New York,047, Kings County,258,85,0,16,69,98,45,0,0,45,160,40,0,16,24,807,203,604
360470387003,36, New York,047, Kings County,105,48,35,0,13,29,0,0,0,0,76,48,35,0,13,549,171,378
360470387004,36, New York,047, Kings County,284,112,71,0,41,33,33,33,0,0,251,79,38,0,41,845,120,725
360470388001,36, New York,047, Kings County,309,167,100,37,30,8,0,0,0,0,301,167,100,37,30,698,92,606
360470388002,36, New York,047, Kings County,254,124,93,25,6,40,29,4,25,0,214,95,89,0,6,830,114,716
360470388003,36, New York,047, Kings County,164,95,63,0,32,24,8,8,0,0,140,87,55,0,32,401,62,339
360470388004,36, New York,047, Kings County,357,144,110,0,34,36,36,28,0,8,321,108,82,0,26,790,88,702
360470389001,36, New York,047, Kings County,305,212,148,0,64,32,16,16,0,0,273,196,132,0,64,948,138,810
360470389002,36, New York,047, Kings County,168,64,0,0,64,20,20,0,0,20,148,44,0,0,44,822,182,640
360470389003,36, New York,047, Kings County,101,37,0,0,37,54,37,0,0,37,47,0,0,0,0,453,138,315
360470390001,36, New York,047, Kings County,327,169,151,10,8,32,17,17,0,0,295,152,134,10,8,821,75,746
360470390002,36, New York,047, Kings County,238,135,135,0,0,32,32,32,0,0,206,103,103,0,0,638,35,603
360470391001,36, New York,047, Kings County,496,376,131,0,245,98,66,0,0,66,398,310,131,0,179,2117,304,1813
360470391002,36, New York,047, Kings County,131,74,0,0,74,74,74,0,0,74,57,0,0,0,0,1243,312,931
360470392001,36, New York,047, Kings County,304,144,111,0,33,33,33,0,0,33,271,111,111,0,0,747,27,720
360470392002,36, New York,047, Kings County,510,293,251,10,32,31,0,0,0,0,479,293,251,10,32,1296,216,1080
360470393001,36, New York,047, Kings County,183,79,34,0,45,28,28,0,0,28,155,51,34,0,17,683,66,617
360470393002,36, New York,047, Kings County,124,52,0,0,52,0,0,0,0,0,124,52,0,0,52,1078,145,933
360470393003,36, New York,047, Kings County,326,150,76,0,74,73,60,0,0,60,253,90,76,0,14,1265,243,1022
360470394001,36, New York,047, Kings County,104,59,54,0,5,51,13,13,0,0,53,46,41,0,5,265,110,155
360470394002,36, New York,047, Kings County,201,107,107,0,0,62,24,24,0,0,139,83,83,0,0,503,128,375
360470394003,36, New York,047, Kings County,179,61,61,0,0,51,39,39,0,0,128,22,22,0,0,418,105,313
360470395001,36, New York,047, Kings County,116,19,13,0,6,6,6,0,0,6,110,13,13,0,0,880,351,529
360470395002,36, New York,047, Kings County,176,62,48,0,14,0,0,0,0,0,176,62,48,0,14,1086,98,988
360470395003,36, New York,047, Kings County,202,73,35,0,38,73,73,35,0,38,129,0,0,0,0,1035,159,876
360470396001,36, New York,047, Kings County,151,44,39,0,5,5,5,0,0,5,146,39,39,0,0,515,71,444
360470396002,36, New York,047, Kings County,290,116,116,0,0,29,12,12,0,0,261,104,104,0,0,932,135,797
360470397001,36, New York,047, Kings County,201,128,69,59,0,0,0,0,0,0,201,128,69,59,0,585,60,525
360470397002,36, New York,047, Kings County,134,63,31,0,32,32,32,0,0,32,102,31,31,0,0,505,112,393
360470397003,36, New York,047, Kings County,407,95,20,0,75,30,15,0,0,15,377,80,20,0,60,1031,64,967
360470398001,36, New York,047, Kings County,465,263,147,34,82,62,42,25,0,17,403,221,122,34,65,1122,127,995
360470398002,36, New York,047, Kings County,294,162,154,8,0,16,9,9,0,0,278,153,145,8,0,547,74,473
360470399001,36, New York,047, Kings County,144,103,23,62,18,0,0,0,0,0,144,103,23,62,18,903,83,820
360470399002,36, New York,047, Kings County,269,160,56,61,43,26,14,0,0,14,243,146,56,61,29,1328,337,991
360470399003,36, New York,047, Kings County,262,183,50,0,133,79,72,0,0,72,183,111,50,0,61,929,380,549
360470400001,36, New York,047, Kings County,234,124,115,0,9,28,22,13,0,9,206,102,102,0,0,532,81,451
360470400002,36, New York,047, Kings County,112,39,17,0,22,18,18,8,0,10,94,21,9,0,12,308,37,271
360470400003,36, New York,047, Kings County,282,200,159,20,21,19,8,0,8,0,263,192,159,12,21,704,49,655
360470401001,36, New York,047, Kings County,148,56,56,0,0,0,0,0,0,0,148,56,56,0,0,745,256,489
360470401002,36, New York,047, Kings County,164,15,15,0,0,81,0,0,0,0,83,15,15,0,0,746,390,356
360470401003,36, New York,047, Kings County,289,175,123,30,22,114,65,40,25,0,175,110,83,5,22,1059,219,840
360470402001,36, New York,047, Kings County,0,0,0,0,0,0,0,0,0,0,0,0,0,0,0,0,0,0
360470402002,36, New York,047, Kings County,197,111,103,8,0,21,11,11,0,0,176,100,92,8,0,616,199,417
360470402003,36, New York,047, Kings County,142,39,11,15,13,29,15,0,15,0,113,24,11,0,13,413,74,339
360470402004,36, New York,047, Kings County,270,104,73,12,19,26,0,0,0,0,244,104,73,12,19,749,130,619
360470403001,36, New York,047, Kings County,135,52,52,0,0,56,38,38,0,0,79,14,14,0,0,853,127,726
360470403002,36, New York,047, Kings County,228,84,26,0,58,10,0,0,0,0,218,84,26,0,58,1318,173,1145
360470403003,36, New York,047, Kings County,400,198,69,0,129,135,88,14,0,74,265,110,55,0,55,1372,367,1005
360470404001,36, New York,047, Kings County,364,194,110,0,84,19,4,0,0,4,345,190,110,0,80,981,64,917
360470404002,36, New York,047, Kings County,345,220,108,9,103,51,51,24,0,27,294,169,84,9,76,713,73,640
360470405001,36, New York,047, Kings County,169,53,27,0,26,0,0,0,0,0,169,53,27,0,26,846,64,782
360470405002,36, New York,047, Kings County,35,35,0,0,35,35,35,0,0,35,0,0,0,0,0,385,128,257
360470406001,36, New York,047, Kings County,411,250,207,10,33,27,27,27,0,0,384,223,180,10,33,779,19,760
360470406002,36, New York,047, Kings County,281,182,148,0,34,47,30,18,0,12,234,152,130,0,22,832,82,750
360470406003,36, New York,047, Kings County,169,68,68,0,0,0,0,0,0,0,169,68,68,0,0,580,21,559
360470407001,36, New York,047, Kings County,0,0,0,0,0,0,0,0,0,0,0,0,0,0,0,0,0,0
360470408001,36, New York,047, Kings County,243,126,118,0,8,1,0,0,0,0,242,126,118,0,8,799,242,557
360470408002,36, New York,047, Kings County,365,167,167,0,0,75,75,75,0,0,290,92,92,0,0,679,0,679
360470408003,36, New York,047, Kings County,322,164,129,0,35,9,9,9,0,0,313,155,120,0,35,708,36,672
360470409001,36, New York,047, Kings County,454,141,112,22,7,42,42,42,0,0,412,99,70,22,7,935,116,819
360470409002,36, New York,047, Kings County,257,114,49,35,30,72,49,49,0,0,185,65,0,35,30,798,218,580
360470409003,36, New York,047, Kings County,293,145,81,0,64,90,90,38,0,52,203,55,43,0,12,682,122,560
360470410001,36, New York,047, Kings County,183,140,140,0,0,31,31,31,0,0,152,109,109,0,0,543,64,479
360470410002,36, New York,047, Kings County,180,140,107,0,33,21,13,0,0,13,159,127,107,0,20,535,57,478
360470411001,36, New York,047, Kings County,254,172,130,29,13,59,59,46,0,13,195,113,84,29,0,716,161,555
360470411002,36, New York,047, Kings County,107,44,0,44,0,0,0,0,0,0,107,44,0,44,0,769,195,574
360470411003,36, New York,047, Kings County,188,39,39,0,0,49,0,0,0,0,139,39,39,0,0,422,113,309
360470412001,36, New York,047, Kings County,347,155,87,0,68,75,52,0,0,52,272,103,87,0,16,782,143,639
360470412002,36, New York,047, Kings County,408,185,159,8,18,28,9,1,0,8,380,176,158,8,10,924,172,752
360470413001,36, New York,047, Kings County,291,144,27,48,69,0,0,0,0,0,291,144,27,48,69,1254,155,1099
360470413002,36, New York,047, Kings County,118,67,58,0,9,34,9,0,0,9,84,58,58,0,0,563,156,407
360470413003,36, New York,047, Kings County,236,106,54,31,21,31,31,0,31,0,205,75,54,0,21,1033,155,878
360470414011,36, New York,047, Kings County,173,110,94,0,16,54,48,32,0,16,119,62,62,0,0,385,77,308
360470414012,36, New York,047, Kings County,93,11,11,0,0,6,6,6,0,0,87,5,5,0,0,305,4,301
360470414021,36, New York,047, Kings County,289,114,76,20,18,106,64,44,20,0,183,50,32,0,18,521,157,364
360470414022,36, New York,047, Kings County,258,55,55,0,0,12,0,0,0,0,246,55,55,0,0,600,49,551
360470415001,36, New York,047, Kings County,290,89,72,0,17,17,17,0,0,17,273,72,72,0,0,649,114,535
360470415002,36, New York,047, Kings County,557,246,147,4,95,57,18,0,0,18,500,228,147,4,77,1784,305,1479
360470415003,36, New York,047, Kings County,179,179,32,16,131,92,92,0,0,92,87,87,32,16,39,648,174,474
360470416001,36, New York,047, Kings County,231,103,103,0,0,37,26,26,0,0,194,77,77,0,0,523,31,492
360470416002,36, New York,047, Kings County,363,177,169,0,8,29,5,3,0,2,334,172,166,0,6,850,117,733
360470417001,36, New York,047, Kings County,170,72,14,49,9,46,0,0,0,0,124,72,14,49,9,595,141,454
360470417002,36, New York,047, Kings County,174,77,41,0,36,53,36,0,0,36,121,41,41,0,0,359,99,260
360470417003,36, New York,047, Kings County,314,71,71,0,0,72,0,0,0,0,242,71,71,0,0,1028,206,822
360470417004,36, New York,047, Kings County,178,112,14,0,98,64,64,14,0,50,114,48,0,0,48,487,219,268
360470418001,36, New York,047, Kings County,232,68,51,0,17,64,40,32,0,8,168,28,19,0,9,393,153,240
360470418002,36, New York,047, Kings County,344,229,166,28,35,44,23,23,0,0,300,206,143,28,35,851,168,683
360470419001,36, New York,047, Kings County,355,119,7,30,82,147,76,0,30,46,208,43,7,0,36,1367,786,581
360470419002,36, New York,047, Kings County,76,48,0,0,48,48,48,0,0,48,28,0,0,0,0,225,95,130
360470419003,36, New York,047, Kings County,300,131,44,0,87,11,0,0,0,0,289,131,44,0,87,1277,110,1167
360470420001,36, New York,047, Kings County,132,51,35,16,0,16,16,0,16,0,116,35,35,0,0,317,32,285
360470420002,36, New York,047, Kings County,277,142,122,20,0,45,38,18,20,0,232,104,104,0,0,702,133,569
360470421001,36, New York,047, Kings County,53,25,8,0,17,17,17,0,0,17,36,8,8,0,0,528,114,414
360470421002,36, New York,047, Kings County,306,122,122,0,0,0,0,0,0,0,306,122,122,0,0,953,133,820
360470421003,36, New York,047, Kings County,210,69,22,0,47,50,47,0,0,47,160,22,22,0,0,905,229,676
360470421004,36, New York,047, Kings County,139,80,80,0,0,0,0,0,0,0,139,80,80,0,0,617,99,518
360470422001,36, New York,047, Kings County,139,98,51,0,47,43,34,34,0,0,96,64,17,0,47,331,89,242
360470422002,36, New York,047, Kings County,536,253,253,0,0,104,66,66,0,0,432,187,187,0,0,1181,124,1057
360470422003,36, New York,047, Kings County,209,61,18,43,0,11,0,0,0,0,198,61,18,43,0,475,39,436
360470423001,36, New York,047, Kings County,218,80,29,51,0,0,0,0,0,0,218,80,29,51,0,819,149,670
360470423002,36, New York,047, Kings County,260,76,52,11,13,28,13,0,0,13,232,63,52,11,0,1068,126,942
360470423003,36, New York,047, Kings County,173,64,64,0,0,16,0,0,0,0,157,64,64,0,0,758,77,681
360470424001,36, New York,047, Kings County,270,163,42,39,82,118,111,19,33,59,152,52,23,6,23,464,77,387
360470424002,36, New York,047, Kings County,347,175,137,0,38,29,29,8,0,21,318,146,129,0,17,1128,105,1023
360470424003,36, New York,047, Kings County,252,162,134,0,28,61,50,22,0,28,191,112,112,0,0,507,136,371
360470425001,36, New York,047, Kings County,316,215,159,0,56,48,48,7,0,41,268,167,152,0,15,941,110,831
360470425002,36, New York,047, Kings County,95,84,84,0,0,84,84,84,0,0,11,0,0,0,0,487,120,367
360470425003,36, New York,047, Kings County,99,78,50,0,28,0,0,0,0,0,99,78,50,0,28,719,61,658
360470426001,36, New York,047, Kings County,439,340,299,0,41,131,130,89,0,41,308,210,210,0,0,935,213,722
360470426002,36, New York,047, Kings County,293,78,58,11,9,63,21,21,0,0,230,57,37,11,9,715,154,561
360470426003,36, New York,047, Kings County,329,66,66,0,0,61,37,37,0,0,268,29,29,0,0,814,169,645
360470427001,36, New York,047, Kings County,232,81,19,18,44,59,44,0,0,44,173,37,19,18,0,982,87,895
360470427002,36, New York,047, Kings County,274,157,77,0,80,26,0,0,0,0,248,157,77,0,80,1028,106,922
360470427003,36, New York,047, Kings County,141,94,30,52,12,12,12,0,0,12,129,82,30,52,0,514,41,473
360470427004,36, New York,047, Kings County,166,45,29,16,0,24,0,0,0,0,142,45,29,16,0,863,288,575
360470428001,36, New York,047, Kings County,366,180,78,20,82,32,20,0,20,0,334,160,78,0,82,700,98,602
360470428002,36, New York,047, Kings County,388,99,73,0,26,21,0,0,0,0,367,99,73,0,26,946,129,817
360470428003,36, New York,047, Kings County,289,196,153,0,43,0,0,0,0,0,289,196,153,0,43,715,50,665
360470429001,36, New York,047, Kings County,229,104,25,51,28,104,104,25,51,28,125,0,0,0,0,529,16,513
360470429002,36, New York,047, Kings County,165,121,109,0,12,28,12,0,0,12,137,109,109,0,0,649,113,536
360470429003,36, New York,047, Kings County,276,143,9,45,89,27,18,0,0,18,249,125,9,45,71,985,122,863
360470429004,36, New York,047, Kings County,208,82,25,0,57,37,8,0,0,8,171,74,25,0,49,870,171,699
360470430001,36, New York,047, Kings County,304,125,125,0,0,16,6,6,0,0,288,119,119,0,0,529,27,502
360470430002,36, New York,047, Kings County,240,42,27,0,15,8,8,0,0,8,232,34,27,0,7,579,73,506
360470430003,36, New York,047, Kings County,496,356,267,31,58,51,51,25,0,26,445,305,242,31,32,538,87,451
360470431001,36, New York,047, Kings County,291,108,37,43,28,4,4,0,0,4,287,104,37,43,24,518,57,461
360470431002,36, New York,047, Kings County,36,0,0,0,0,0,0,0,0,0,36,0,0,0,0,645,0,645
360470431003,36, New York,047, Kings County,110,71,71,0,0,30,30,30,0,0,80,41,41,0,0,381,96,285
360470431004,36, New York,047, Kings County,184,61,26,0,35,0,0,0,0,0,184,61,26,0,35,939,26,913
360470432001,36, New York,047, Kings County,301,195,172,8,15,0,0,0,0,0,301,195,172,8,15,403,27,376
360470432002,36, New York,047, Kings County,410,102,76,20,6,0,0,0,0,0,410,102,76,20,6,879,60,819
360470432003,36, New York,047, Kings County,437,196,132,0,64,160,108,80,0,28,277,88,52,0,36,1048,231,817
360470433001,36, New York,047, Kings County,280,102,68,0,34,163,62,62,0,0,117,40,6,0,34,773,390,383
360470433002,36, New York,047, Kings County,113,0,0,0,0,0,0,0,0,0,113,0,0,0,0,563,55,508
360470433003,36, New York,047, Kings County,295,214,125,15,74,40,40,40,0,0,255,174,85,15,74,799,191,608
360470434001,36, New York,047, Kings County,347,217,137,16,64,80,59,25,0,34,267,158,112,16,30,566,130,436
360470434002,36, New York,047, Kings County,347,85,76,0,9,32,23,23,0,0,315,62,53,0,9,855,78,777
360470434003,36, New York,047, Kings County,295,128,90,17,21,64,0,0,0,0,231,128,90,17,21,744,219,525
360470435001,36, New York,047, Kings County,228,137,108,0,29,29,29,0,0,29,199,108,108,0,0,557,72,485
360470435002,36, New York,047, Kings County,533,290,172,0,118,184,99,0,0,99,349,191,172,0,19,1361,394,967
360470435003,36, New York,047, Kings County,432,154,132,0,22,70,0,0,0,0,362,154,132,0,22,1154,113,1041
360470436001,36, New York,047, Kings County,522,110,71,30,9,68,0,0,0,0,454,110,71,30,9,976,106,870
360470436002,36, New York,047, Kings County,530,369,84,0,285,315,303,18,0,285,215,66,66,0,0,599,46,553
360470436003,36, New York,047, Kings County,460,150,121,0,29,19,19,0,0,19,441,131,121,0,10,1018,86,932
360470437001,36, New York,047, Kings County,249,110,0,0,110,96,73,0,0,73,153,37,0,0,37,1116,241,875
360470437002,36, New York,047, Kings County,248,164,78,0,86,18,18,0,0,18,230,146,78,0,68,1097,72,1025
360470437003,36, New York,047, Kings County,301,10,0,0,10,10,10,0,0,10,291,0,0,0,0,937,29,908
360470437004,36, New York,047, Kings County,216,78,0,0,78,60,60,0,0,60,156,18,0,0,18,533,111,422
360470438001,36, New York,047, Kings County,397,204,151,43,10,26,26,5,11,10,371,178,146,32,0,681,60,621
360470438002,36, New York,047, Kings County,251,142,128,0,14,42,25,25,0,0,209,117,103,0,14,666,67,599
360470439001,36, New York,047, Kings County,220,146,86,35,25,26,26,0,18,8,194,120,86,17,17,687,78,609
360470439002,36, New York,047, Kings County,233,148,124,24,0,33,0,0,0,0,200,148,124,24,0,1131,130,1001
360470439003,36, New York,047, Kings County,186,98,41,0,57,58,57,0,0,57,128,41,41,0,0,602,48,554
360470440001,36, New York,047, Kings County,168,116,97,0,19,23,17,5,0,12,145,99,92,0,7,414,65,349
360470440002,36, New York,047, Kings County,197,125,113,0,12,66,37,25,0,12,131,88,88,0,0,509,153,356
360470440003,36, New York,047, Kings County,249,153,149,0,4,17,11,7,0,4,232,142,142,0,0,673,136,537
360470441001,36, New York,047, Kings County,234,162,109,0,53,114,96,43,0,53,120,66,66,0,0,937,343,594
360470441002,36, New York,047, Kings County,360,85,26,0,59,85,85,26,0,59,275,0,0,0,0,1248,133,1115
360470441003,36, New York,047, Kings County,435,188,42,25,121,24,24,0,0,24,411,164,42,25,97,1374,176,1198
360470442001,36, New York,047, Kings County,230,128,128,0,0,28,22,22,0,0,202,106,106,0,0,657,79,578
360470442002,36, New York,047, Kings County,313,146,138,8,0,42,17,9,8,0,271,129,129,0,0,889,303,586
360470443001,36, New York,047, Kings County,306,163,105,35,23,67,53,30,0,23,239,110,75,35,0,824,114,710
360470443002,36, New York,047, Kings County,155,70,26,0,44,16,0,0,0,0,139,70,26,0,44,884,74,810
360470443003,36, New York,047, Kings County,131,34,34,0,0,21,0,0,0,0,110,34,34,0,0,771,117,654
360470443004,36, New York,047, Kings County,117,52,22,0,30,30,30,0,0,30,87,22,22,0,0,552,134,418
360470444001,36, New York,047, Kings County,181,99,58,0,41,36,0,0,0,0,145,99,58,0,41,424,134,290
360470444002,36, New York,047, Kings County,164,75,75,0,0,0,0,0,0,0,164,75,75,0,0,668,0,668
360470444003,36, New York,047, Kings County,393,308,126,37,145,168,162,54,0,108,225,146,72,37,37,855,242,613
360470445001,36, New York,047, Kings County,193,99,99,0,0,20,20,20,0,0,173,79,79,0,0,525,109,416
360470445002,36, New York,047, Kings County,378,201,57,56,88,116,91,27,0,64,262,110,30,56,24,1378,336,1042
360470445003,36, New York,047, Kings County,325,80,31,0,49,35,0,0,0,0,290,80,31,0,49,1237,250,987
360470446001,36, New York,047, Kings County,223,137,112,0,25,26,21,21,0,0,197,116,91,0,25,437,39,398
360470446002,36, New York,047, Kings County,245,144,90,50,4,6,0,0,0,0,239,144,90,50,4,728,77,651
360470447001,36, New York,047, Kings County,224,87,65,15,7,64,24,9,15,0,160,63,56,0,7,1647,659,988
360470447002,36, New York,047, Kings County,61,42,9,0,33,33,33,0,0,33,28,9,9,0,0,377,122,255
360470448001,36, New York,047, Kings County,105,46,43,0,3,21,21,21,0,0,84,25,22,0,3,310,55,255
360470448002,36, New York,047, Kings County,330,113,90,23,0,13,0,0,0,0,317,113,90,23,0,939,39,900
360470449011,36, New York,047, Kings County,590,266,31,0,235,180,153,8,0,145,410,113,23,0,90,1752,410,1342
360470449012,36, New York,047, Kings County,59,9,9,0,0,0,0,0,0,0,59,9,9,0,0,319,0,319
360470449013,36, New York,047, Kings County,0,0,0,0,0,0,0,0,0,0,0,0,0,0,0,0,0,0
360470449014,36, New York,047, Kings County,6,0,0,0,0,0,0,0,0,0,6,0,0,0,0,43,0,43
360470449021,36, New York,047, Kings County,0,0,0,0,0,0,0,0,0,0,0,0,0,0,0,0,0,0
360470449022,36, New York,047, Kings County,0,0,0,0,0,0,0,0,0,0,0,0,0,0,0,0,0,0
360470449023,36, New York,047, Kings County,0,0,0,0,0,0,0,0,0,0,0,0,0,0,0,0,0,0
360470450001,36, New York,047, Kings County,198,137,122,11,4,36,36,32,0,4,162,101,90,11,0,439,97,342
360470452001,36, New York,047, Kings County,237,149,136,0,13,5,5,5,0,0,232,144,131,0,13,637,26,611
360470452002,36, New York,047, Kings County,392,190,162,5,23,41,27,22,5,0,351,163,140,0,23,915,81,834
360470453001,36, New York,047, Kings County,158,66,25,0,41,57,14,14,0,0,101,52,11,0,41,1259,711,548
360470453002,36, New York,047, Kings County,77,22,0,22,0,0,0,0,0,0,77,22,0,22,0,494,90,404
360470454001,36, New York,047, Kings County,164,88,76,0,12,17,17,5,0,12,147,71,71,0,0,498,19,479
360470454002,36, New York,047, Kings County,205,95,91,0,4,0,0,0,0,0,205,95,91,0,4,538,18,520
360470456001,36, New York,047, Kings County,327,128,128,0,0,0,0,0,0,0,327,128,128,0,0,704,49,655
360470456002,36, New York,047, Kings County,242,99,50,0,49,61,24,24,0,0,181,75,26,0,49,578,189,389
360470458001,36, New York,047, Kings County,129,36,36,0,0,5,0,0,0,0,124,36,36,0,0,378,35,343
360470458002,36, New York,047, Kings County,120,60,60,0,0,5,0,0,0,0,115,60,60,0,0,279,9,270
360470460001,36, New York,047, Kings County,339,166,115,0,51,41,23,23,0,0,298,143,92,0,51,905,125,780
360470460002,36, New York,047, Kings County,348,196,141,0,55,45,45,27,0,18,303,151,114,0,37,678,143,535
360470460003,36, New York,047, Kings County,170,89,60,6,23,10,7,7,0,0,160,82,53,6,23,430,28,402
360470462011,36, New York,047, Kings County,291,206,199,0,7,34,34,34,0,0,257,172,165,0,7,923,146,777
360470462012,36, New York,047, Kings County,209,0,0,0,0,16,0,0,0,0,193,0,0,0,0,696,110,586
360470462021,36, New York,047, Kings County,260,116,92,12,12,17,17,17,0,0,243,99,75,12,12,597,59,538
360470462022,36, New York,047, Kings County,158,91,91,0,0,8,8,8,0,0,150,83,83,0,0,572,40,532
360470464001,36, New York,047, Kings County,268,179,179,0,0,88,70,70,0,0,180,109,109,0,0,869,351,518
360470464002,36, New York,047, Kings County,226,183,166,7,10,32,32,22,0,10,194,151,144,7,0,566,90,476
360470468001,36, New York,047, Kings County,455,292,292,0,0,20,20,20,0,0,435,272,272,0,0,1142,92,1050
360470470001,36, New York,047, Kings County,318,200,187,0,13,52,52,52,0,0,266,148,135,0,13,740,115,625
360470470002,36, New York,047, Kings County,275,173,150,10,13,9,9,9,0,0,266,164,141,10,13,658,33,625
360470472001,36, New York,047, Kings County,108,71,71,0,0,52,45,45,0,0,56,26,26,0,0,283,116,167
360470472002,36, New York,047, Kings County,257,108,108,0,0,51,33,33,0,0,206,75,75,0,0,556,119,437
360470472003,36, New York,047, Kings County,213,180,150,0,30,21,21,21,0,0,192,159,129,0,30,550,46,504
360470474001,36, New York,047, Kings County,384,161,142,0,19,54,54,54,0,0,330,107,88,0,19,865,135,730
360470474002,36, New York,047, Kings County,210,118,116,2,0,34,25,25,0,0,176,93,91,2,0,541,127,414
360470476001,36, New York,047, Kings County,206,169,169,0,0,0,0,0,0,0,206,169,169,0,0,491,50,441
360470476002,36, New York,047, Kings County,166,115,115,0,0,76,66,66,0,0,90,49,49,0,0,436,161,275
360470476003,36, New York,047, Kings County,279,75,75,0,0,10,0,0,0,0,269,75,75,0,0,631,53,578
360470477001,36, New York,047, Kings County,311,72,61,0,11,0,0,0,0,0,311,72,61,0,11,1202,100,1102
360470477002,36, New York,047, Kings County,328,205,174,10,21,20,20,20,0,0,308,185,154,10,21,1545,206,1339
360470478001,36, New York,047, Kings County,204,77,43,17,17,0,0,0,0,0,204,77,43,17,17,698,89,609
360470478002,36, New York,047, Kings County,276,129,120,0,9,54,48,39,0,9,222,81,81,0,0,669,78,591
360470478003,36, New York,047, Kings County,367,243,225,0,18,102,72,72,0,0,265,171,153,0,18,1026,267,759
360470480001,36, New York,047, Kings County,180,38,38,0,0,47,0,0,0,0,133,38,38,0,0,718,383,335
360470480002,36, New York,047, Kings County,456,296,215,0,81,223,182,101,0,81,233,114,114,0,0,939,225,714
360470481001,36, New York,047, Kings County,141,44,43,0,1,0,0,0,0,0,141,44,43,0,1,441,34,407
360470481002,36, New York,047, Kings County,188,15,15,0,0,0,0,0,0,0,188,15,15,0,0,525,77,448
360470481003,36, New York,047, Kings County,276,101,85,9,7,7,0,0,0,0,269,101,85,9,7,1137,122,1015
360470482001,36, New York,047, Kings County,203,56,56,0,0,72,0,0,0,0,131,56,56,0,0,389,216,173
360470482002,36, New York,047, Kings County,460,163,126,0,37,10,10,10,0,0,450,153,116,0,37,1495,158,1337
360470482003,36, New York,047, Kings County,559,133,94,0,39,74,0,0,0,0,485,133,94,0,39,1556,179,1377
360470482004,36, New York,047, Kings County,134,99,78,0,21,14,0,0,0,0,120,99,78,0,21,384,45,339
360470482005,36, New York,047, Kings County,20,10,10,0,0,0,0,0,0,0,20,10,10,0,0,67,0,67
360470484001,36, New York,047, Kings County,506,223,211,4,8,1,0,0,0,0,505,223,211,4,8,1705,160,1545
360470484002,36, New York,047, Kings County,354,274,159,0,115,127,77,77,0,0,227,197,82,0,115,1063,382,681
360470484003,36, New York,047, Kings County,185,96,96,0,0,31,31,31,0,0,154,65,65,0,0,899,82,817
360470485001,36, New York,047, Kings County,186,86,18,0,68,49,49,0,0,49,137,37,18,0,19,634,148,486
360470485002,36, New York,047, Kings County,216,88,45,25,18,73,43,0,25,18,143,45,45,0,0,1239,262,977
360470486001,36, New York,047, Kings County,148,106,106,0,0,47,47,47,0,0,101,59,59,0,0,384,96,288
360470486002,36, New York,047, Kings County,303,149,134,3,12,30,20,20,0,0,273,129,114,3,12,613,30,583
360470486003,36, New York,047, Kings County,191,89,82,0,7,0,0,0,0,0,191,89,82,0,7,479,7,472
360470488001,36, New York,047, Kings County,258,101,68,0,33,0,0,0,0,0,258,101,68,0,33,764,10,754
360470488002,36, New York,047, Kings County,310,203,203,0,0,20,20,20,0,0,290,183,183,0,0,746,126,620
360470488003,36, New York,047, Kings County,346,192,140,0,52,52,52,0,0,52,294,140,140,0,0,1321,245,1076
360470489001,36, New York,047, Kings County,192,99,0,0,99,74,74,0,0,74,118,25,0,0,25,434,74,360
360470489002,36, New York,047, Kings County,323,164,45,0,119,98,98,0,0,98,225,66,45,0,21,811,212,599
360470489003,36, New York,047, Kings County,440,129,0,0,129,71,16,0,0,16,369,113,0,0,113,1006,235,771
360470490001,36, New York,047, Kings County,696,492,139,24,329,149,149,17,0,132,547,343,122,24,197,1559,266,1293
360470490002,36, New York,047, Kings County,641,350,280,0,70,0,0,0,0,0,641,350,280,0,70,1400,113,1287
360470490003,36, New York,047, Kings County,44,22,22,0,0,0,0,0,0,0,44,22,22,0,0,186,47,139
360470491001,36, New York,047, Kings County,759,301,192,43,66,185,185,185,0,0,574,116,7,43,66,1803,486,1317
360470491002,36, New York,047, Kings County,55,1,1,0,0,0,0,0,0,0,55,1,1,0,0,415,78,337
360470491003,36, New York,047, Kings County,569,255,99,0,156,188,117,0,0,117,381,138,99,0,39,1258,305,953
360470491004,36, New York,047, Kings County,593,154,21,0,133,139,59,0,0,59,454,95,21,0,74,1424,295,1129
360470492001,36, New York,047, Kings County,176,99,88,0,11,11,11,0,0,11,165,88,88,0,0,663,74,589
360470492002,36, New York,047, Kings County,256,179,155,5,19,16,0,0,0,0,240,179,155,5,19,611,43,568
360470492003,36, New York,047, Kings County,287,96,96,0,0,89,78,78,0,0,198,18,18,0,0,823,324,499
360470493011,36, New York,047, Kings County,671,346,31,0,315,190,157,0,0,157,481,189,31,0,158,1426,386,1040
360470493021,36, New York,047, Kings County,310,112,99,0,13,0,0,0,0,0,310,112,99,0,13,1175,102,1073
360470493022,36, New York,047, Kings County,58,0,0,0,0,0,0,0,0,0,58,0,0,0,0,654,33,621
360470493023,36, New York,047, Kings County,598,179,18,0,161,322,161,0,0,161,276,18,18,0,0,1374,773,601
360470493024,36, New York,047, Kings County,155,54,0,21,33,65,33,0,0,33,90,21,0,21,0,662,144,518
360470494001,36, New York,047, Kings County,280,191,150,0,41,0,0,0,0,0,280,191,150,0,41,822,12,810
360470494002,36, New York,047, Kings County,159,46,46,0,0,0,0,0,0,0,159,46,46,0,0,375,38,337
360470494003,36, New York,047, Kings County,514,153,92,21,40,49,36,0,0,36,465,117,92,21,4,1524,107,1417
360470494004,36, New York,047, Kings County,202,43,43,0,0,0,0,0,0,0,202,43,43,0,0,588,26,562
360470495001,36, New York,047, Kings County,69,0,0,0,0,0,0,0,0,0,69,0,0,0,0,596,58,538
360470495002,36, New York,047, Kings County,94,43,43,0,0,29,0,0,0,0,65,43,43,0,0,836,105,731
360470495003,36, New York,047, Kings County,199,115,10,0,105,117,105,0,0,105,82,10,10,0,0,620,212,408
360470496001,36, New York,047, Kings County,261,138,95,31,12,0,0,0,0,0,261,138,95,31,12,1137,119,1018
360470496002,36, New York,047, Kings County,180,92,75,0,17,21,7,7,0,0,159,85,68,0,17,510,41,469
360470496003,36, New York,047, Kings County,263,120,73,35,12,15,0,0,0,0,248,120,73,35,12,604,61,543
360470497001,36, New York,047, Kings County,200,108,59,0,49,13,0,0,0,0,187,108,59,0,49,709,49,660
360470497002,36, New York,047, Kings County,187,55,38,0,17,0,0,0,0,0,187,55,38,0,17,672,85,587
360470497003,36, New York,047, Kings County,274,143,138,0,5,0,0,0,0,0,274,143,138,0,5,1134,90,1044
360470498001,36, New York,047, Kings County,319,198,151,30,17,21,1,0,1,0,298,197,151,29,17,854,180,674
360470498002,36, New York,047, Kings County,641,181,122,0,59,0,0,0,0,0,641,181,122,0,59,1592,1,1591
360470498003,36, New York,047, Kings County,129,105,64,0,41,18,0,0,0,0,111,105,64,0,41,326,18,308
360470499001,36, New York,047, Kings County,205,73,70,0,3,3,3,0,0,3,202,70,70,0,0,573,41,532
360470499002,36, New York,047, Kings County,182,111,44,0,67,0,0,0,0,0,182,111,44,0,67,953,82,871
360470500011,36, New York,047, Kings County,268,114,85,15,14,0,0,0,0,0,268,114,85,15,14,822,39,783
360470500012,36, New York,047, Kings County,266,88,79,6,3,0,0,0,0,0,266,88,79,6,3,818,28,790
360470500021,36, New York,047, Kings County,453,273,255,7,11,0,0,0,0,0,453,273,255,7,11,1294,22,1272
360470501001,36, New York,047, Kings County,166,29,25,0,4,4,4,0,0,4,162,25,25,0,0,685,30,655
360470501002,36, New York,047, Kings County,177,97,66,0,31,48,19,0,0,19,129,78,66,0,12,788,286,502
360470501003,36, New York,047, Kings County,173,51,3,17,31,23,23,0,0,23,150,28,3,17,8,915,38,877
360470502021,36, New York,047, Kings County,244,76,75,0,1,26,0,0,0,0,218,76,75,0,1,787,69,718
360470502022,36, New York,047, Kings County,320,158,137,0,21,0,0,0,0,0,320,158,137,0,21,1119,80,1039
360470503001,36, New York,047, Kings County,83,23,11,0,12,21,12,0,0,12,62,11,11,0,0,835,62,773
360470503002,36, New York,047, Kings County,141,37,37,0,0,0,0,0,0,0,141,37,37,0,0,725,85,640
360470503003,36, New York,047, Kings County,213,74,69,0,5,0,0,0,0,0,213,74,69,0,5,731,9,722
360470504011,36, New York,047, Kings County,367,172,120,0,52,47,32,0,0,32,320,140,120,0,20,972,74,898
360470504012,36, New York,047, Kings County,391,175,140,35,0,53,0,0,0,0,338,175,140,35,0,1251,143,1108
360470504021,36, New York,047, Kings County,368,79,30,0,49,52,12,0,0,12,316,67,30,0,37,866,140,726
360470504022,36, New York,047, Kings County,116,98,68,30,0,0,0,0,0,0,116,98,68,30,0,505,33,472
360470505001,36, New York,047, Kings County,432,298,168,10,120,203,120,0,0,120,229,178,168,10,0,1241,488,753
360470505002,36, New York,047, Kings County,187,0,0,0,0,0,0,0,0,0,187,0,0,0,0,695,64,631
360470505003,36, New York,047, Kings County,329,150,150,0,0,148,113,113,0,0,181,37,37,0,0,1100,253,847
360470506001,36, New York,047, Kings County,275,93,55,1,37,44,12,12,0,0,231,81,43,1,37,864,160,704
360470506002,36, New York,047, Kings County,174,91,55,0,36,0,0,0,0,0,174,91,55,0,36,780,30,750
360470506003,36, New York,047, Kings County,365,280,183,23,74,0,0,0,0,0,365,280,183,23,74,700,39,661
360470506004,36, New York,047, Kings County,582,115,48,25,42,136,19,0,0,19,446,96,48,25,23,1240,245,995
360470507001,36, New York,047, Kings County,570,456,405,0,51,190,190,175,0,15,380,266,230,0,36,1396,524,872
360470508011,36, New York,047, Kings County,293,144,31,18,95,19,9,9,0,0,274,135,22,18,95,959,97,862
360470508012,36, New York,047, Kings County,493,208,83,12,113,51,51,8,12,31,442,157,75,0,82,1578,301,1277
360470508031,36, New York,047, Kings County,506,208,78,60,70,69,22,22,0,0,437,186,56,60,70,2296,457,1839
360470508041,36, New York,047, Kings County,832,341,200,45,96,19,0,0,0,0,813,341,200,45,96,1689,35,1654
360470508042,36, New York,047, Kings County,303,53,0,0,53,46,24,0,0,24,257,29,0,0,29,1263,267,996
360470508043,36, New York,047, Kings County,373,94,42,0,52,0,0,0,0,0,373,94,42,0,52,1164,171,993
360470509001,36, New York,047, Kings County,289,265,254,10,1,152,138,137,0,1,137,127,117,10,0,763,297,466
360470509002,36, New York,047, Kings County,510,460,390,0,70,288,288,264,0,24,222,172,126,0,46,1227,753,474
360470510011,36, New York,047, Kings County,476,134,76,43,15,41,29,29,0,0,435,105,47,43,15,1301,219,1082
360470510012,36, New York,047, Kings County,477,351,145,92,114,88,88,0,22,66,389,263,145,70,48,1636,322,1314
360470510021,36, New York,047, Kings County,467,324,123,44,157,38,27,0,0,27,429,297,123,44,130,1174,201,973
360470510022,36, New York,047, Kings County,353,111,62,27,22,11,0,0,0,0,342,111,62,27,22,986,47,939
360470510023,36, New York,047, Kings County,194,96,40,20,36,47,36,0,0,36,147,60,40,20,0,625,153,472
360470511001,36, New York,047, Kings County,411,62,43,0,19,120,43,43,0,0,291,19,0,0,19,1061,262,799
360470511002,36, New York,047, Kings County,171,67,57,10,0,0,0,0,0,0,171,67,57,10,0,1274,120,1154
360470511003,36, New York,047, Kings County,209,95,33,0,62,40,40,0,0,40,169,55,33,0,22,933,233,700
360470512001,36, New York,047, Kings County,512,311,272,0,39,95,54,15,0,39,417,257,257,0,0,1175,235,940
360470512002,36, New York,047, Kings County,326,0,0,0,0,0,0,0,0,0,326,0,0,0,0,1569,213,1356
360470512003,36, New York,047, Kings County,482,199,120,0,79,0,0,0,0,0,482,199,120,0,79,821,18,803
360470512004,36, New York,047, Kings County,253,53,20,0,33,55,33,0,0,33,198,20,20,0,0,669,40,629
360470513001,36, New York,047, Kings County,214,79,38,41,0,65,41,0,41,0,149,38,38,0,0,1041,178,863
360470513002,36, New York,047, Kings County,114,95,18,0,77,59,40,0,0,40,55,55,18,0,37,529,199,330
360470513003,36, New York,047, Kings County,272,135,63,19,53,20,0,0,0,0,252,135,63,19,53,2060,128,1932
360470513004,36, New York,047, Kings County,206,0,0,0,0,48,0,0,0,0,158,0,0,0,0,702,214,488
360470514001,36, New York,047, Kings County,192,55,55,0,0,29,0,0,0,0,163,55,55,0,0,777,91,686
360470514002,36, New York,047, Kings County,608,277,168,0,109,0,0,0,0,0,608,277,168,0,109,1369,56,1313
360470514003,36, New York,047, Kings County,594,296,141,0,155,89,0,0,0,0,505,296,141,0,155,1650,362,1288
360470514004,36, New York,047, Kings County,498,209,129,30,50,21,21,0,0,21,477,188,129,30,29,1148,114,1034
360470515001,36, New York,047, Kings County,439,196,120,60,16,14,0,0,0,0,425,196,120,60,16,1991,200,1791
360470516011,36, New York,047, Kings County,249,86,14,0,72,83,26,0,0,26,166,60,14,0,46,801,98,703
360470516012,36, New York,047, Kings County,250,188,50,21,117,24,24,0,0,24,226,164,50,21,93,1062,61,1001
360470516013,36, New York,047, Kings County,483,336,79,0,257,117,117,47,0,70,366,219,32,0,187,1332,289,1043
360470516021,36, New York,047, Kings County,459,270,147,45,78,10,0,0,0,0,449,270,147,45,78,1129,31,1098
360470516022,36, New York,047, Kings County,403,164,42,0,122,97,77,20,0,57,306,87,22,0,65,1071,85,986
360470517001,36, New York,047, Kings County,168,54,54,0,0,0,0,0,0,0,168,54,54,0,0,749,69,680
360470517002,36, New York,047, Kings County,392,174,162,12,0,32,19,19,0,0,360,155,143,12,0,1006,41,965
360470518001,36, New York,047, Kings County,141,47,0,0,47,10,0,0,0,0,131,47,0,0,47,608,32,576
360470518002,36, New York,047, Kings County,302,153,108,5,40,30,20,20,0,0,272,133,88,5,40,1423,175,1248
360470518003,36, New York,047, Kings County,221,83,62,0,21,10,0,0,0,0,211,83,62,0,21,569,61,508
360470519001,36, New York,047, Kings County,377,77,77,0,0,0,0,0,0,0,377,77,77,0,0,2245,114,2131
360470519002,36, New York,047, Kings County,47,18,0,18,0,0,0,0,0,0,47,18,0,18,0,889,176,713
360470519003,36, New York,047, Kings County,226,97,85,0,12,0,0,0,0,0,226,97,85,0,12,1184,49,1135
360470520001,36, New York,047, Kings County,562,193,168,0,25,19,19,0,0,19,543,174,168,0,6,1474,42,1432
360470520002,36, New York,047, Kings County,191,96,88,0,8,17,17,17,0,0,174,79,71,0,8,531,73,458
360470520003,36, New York,047, Kings County,224,85,85,0,0,99,56,56,0,0,125,29,29,0,0,605,162,443
360470523001,36, New York,047, Kings County,370,167,28,74,65,93,74,0,74,0,277,93,28,0,65,1485,487,998
360470523002,36, New York,047, Kings County,252,81,22,0,59,43,0,0,0,0,209,81,22,0,59,663,114,549
360470523003,36, New York,047, Kings County,170,89,27,0,62,34,34,0,0,34,136,55,27,0,28,1071,74,997
360470523004,36, New York,047, Kings County,86,0,0,0,0,0,0,0,0,0,86,0,0,0,0,431,85,346
360470523005,36, New York,047, Kings County,64,12,0,12,0,0,0,0,0,0,64,12,0,12,0,396,180,216
360470525001,36, New York,047, Kings County,450,184,67,43,74,112,74,36,0,38,338,110,31,43,36,1554,402,1152
360470525002,36, New York,047, Kings County,186,158,158,0,0,84,70,70,0,0,102,88,88,0,0,609,239,370
360470526001,36, New York,047, Kings County,371,220,63,13,144,73,41,18,0,23,298,179,45,13,121,1153,216,937
360470526002,36, New York,047, Kings County,364,250,219,0,31,20,20,20,0,0,344,230,199,0,31,868,80,788
360470526003,36, New York,047, Kings County,297,84,45,0,39,22,22,14,0,8,275,62,31,0,31,828,96,732
360470527001,36, New York,047, Kings County,196,115,0,0,115,41,41,0,0,41,155,74,0,0,74,676,132,544
360470527002,36, New York,047, Kings County,198,87,59,0,28,23,23,23,0,0,175,64,36,0,28,381,44,337
360470527003,36, New York,047, Kings County,180,80,80,0,0,0,0,0,0,0,180,80,80,0,0,1113,111,1002
360470527004,36, New York,047, Kings County,202,125,52,0,73,49,49,0,0,49,153,76,52,0,24,600,90,510
360470527005,36, New York,047, Kings County,50,0,0,0,0,0,0,0,0,0,50,0,0,0,0,406,38,368
360470527006,36, New York,047, Kings County,232,190,116,42,32,42,42,0,42,0,190,148,116,0,32,792,77,715
360470527007,36, New York,047, Kings County,261,79,0,52,27,27,27,0,0,27,234,52,0,52,0,517,100,417
360470528001,36, New York,047, Kings County,205,120,86,28,6,12,12,0,12,0,193,108,86,16,6,699,4,695
360470528002,36, New York,047, Kings County,231,79,55,10,14,15,0,0,0,0,216,79,55,10,14,586,6,580
360470529001,36, New York,047, Kings County,134,45,45,0,0,90,30,30,0,0,44,15,15,0,0,279,192,87
360470529002,36, New York,047, Kings County,376,246,246,0,0,159,137,137,0,0,217,109,109,0,0,1192,410,782
360470529003,36, New York,047, Kings County,219,53,53,0,0,35,15,15,0,0,184,38,38,0,0,608,77,531
360470530001,36, New York,047, Kings County,251,71,48,0,23,24,8,0,0,8,227,63,48,0,15,475,127,348
360470530002,36, New York,047, Kings County,204,149,141,8,0,28,28,28,0,0,176,121,113,8,0,709,117,592
360470530003,36, New York,047, Kings County,237,107,88,0,19,64,51,36,0,15,173,56,52,0,4,826,248,578
360470531011,36, New York,047, Kings County,231,187,187,0,0,77,59,59,0,0,154,128,128,0,0,438,158,280
360470531012,36, New York,047, Kings County,334,164,164,0,0,258,161,161,0,0,76,3,3,0,0,667,521,146
360470531021,36, New York,047, Kings County,500,432,284,148,0,287,287,139,148,0,213,145,145,0,0,1282,583,699
360470531022,36, New York,047, Kings County,487,414,414,0,0,148,101,101,0,0,339,313,313,0,0,1302,416,886
360470532001,36, New York,047, Kings County,306,196,159,20,17,5,5,5,0,0,301,191,154,20,17,1056,52,1004
360470532002,36, New York,047, Kings County,233,94,91,0,3,54,39,39,0,0,179,55,52,0,3,580,102,478
360470533001,36, New York,047, Kings County,224,152,152,0,0,131,71,71,0,0,93,81,81,0,0,566,278,288
360470533002,36, New York,047, Kings County,315,224,192,0,32,65,65,33,0,32,250,159,159,0,0,652,112,540
360470533003,36, New York,047, Kings County,372,197,183,0,14,88,88,74,0,14,284,109,109,0,0,837,225,612
360470533004,36, New York,047, Kings County,295,189,189,0,0,128,111,111,0,0,167,78,78,0,0,696,339,357
360470533005,36, New York,047, Kings County,167,94,94,0,0,48,13,13,0,0,119,81,81,0,0,363,101,262
360470534001,36, New York,047, Kings County,309,240,232,0,8,31,8,0,0,8,278,232,232,0,0,764,97,667
360470534002,36, New York,047, Kings County,205,126,118,0,8,42,25,25,0,0,163,101,93,0,8,497,99,398
360470534003,36, New York,047, Kings County,238,160,104,16,40,22,22,22,0,0,216,138,82,16,40,965,223,742
360470534004,36, New York,047, Kings County,128,111,78,0,33,24,24,0,0,24,104,87,78,0,9,307,99,208
360470535001,36, New York,047, Kings County,188,121,121,0,0,69,69,69,0,0,119,52,52,0,0,451,139,312
360470535002,36, New York,047, Kings County,161,100,100,0,0,46,46,46,0,0,115,54,54,0,0,421,91,330
360470535003,36, New York,047, Kings County,180,119,119,0,0,119,119,119,0,0,61,0,0,0,0,431,293,138
360470535004,36, New York,047, Kings County,249,192,192,0,0,91,70,70,0,0,158,122,122,0,0,677,240,437
360470537001,36, New York,047, Kings County,233,115,115,0,0,11,11,11,0,0,222,104,104,0,0,504,22,482
360470537002,36, New York,047, Kings County,527,410,410,0,0,221,193,193,0,0,306,217,217,0,0,1157,519,638
360470538001,36, New York,047, Kings County,205,90,54,15,21,21,21,21,0,0,184,69,33,15,21,586,69,517
360470538002,36, New York,047, Kings County,720,295,276,0,19,19,19,0,0,19,701,276,276,0,0,1803,191,1612
360470538003,36, New York,047, Kings County,492,371,248,0,123,64,64,64,0,0,428,307,184,0,123,993,144,849
360470539001,36, New York,047, Kings County,93,35,35,0,0,23,23,23,0,0,70,12,12,0,0,198,47,151
360470539002,36, New York,047, Kings County,584,195,168,0,27,242,145,118,0,27,342,50,50,0,0,1421,565,856
360470542001,36, New York,047, Kings County,627,259,179,0,80,91,74,14,0,60,536,185,165,0,20,1148,135,1013
360470542002,36, New York,047, Kings County,258,180,111,14,55,59,59,59,0,0,199,121,52,14,55,599,133,466
360470542003,36, New York,047, Kings County,178,0,0,0,0,22,0,0,0,0,156,0,0,0,0,592,158,434
360470543001,36, New York,047, Kings County,0,0,0,0,0,0,0,0,0,0,0,0,0,0,0,0,0,0
360470544001,36, New York,047, Kings County,478,119,89,0,30,53,9,9,0,0,425,110,80,0,30,881,116,765
360470544002,36, New York,047, Kings County,212,150,150,0,0,45,44,44,0,0,167,106,106,0,0,579,65,514
360470544003,36, New York,047, Kings County,296,192,192,0,0,11,11,11,0,0,285,181,181,0,0,839,52,787
360470545001,36, New York,047, Kings County,56,56,56,0,0,0,0,0,0,0,56,56,56,0,0,116,0,116
360470545002,36, New York,047, Kings County,193,170,170,0,0,170,170,170,0,0,23,0,0,0,0,591,510,81
360470545003,36, New York,047, Kings County,290,30,24,6,0,0,0,0,0,0,290,30,24,6,0,734,90,644
360470545004,36, New York,047, Kings County,46,46,46,0,0,0,0,0,0,0,46,46,46,0,0,131,0,131
360470545005,36, New York,047, Kings County,827,426,77,0,349,319,241,77,0,164,508,185,0,0,185,2206,902,1304
360470545006,36, New York,047, Kings County,398,156,81,0,75,192,120,81,0,39,206,36,0,0,36,887,391,496
360470546001,36, New York,047, Kings County,298,149,111,10,28,28,28,0,0,28,270,121,111,10,0,884,64,820
360470546002,36, New York,047, Kings County,560,287,98,35,154,88,88,15,0,73,472,199,83,35,81,1428,619,809
360470546003,36, New York,047, Kings County,331,134,49,18,67,69,41,1,0,40,262,93,48,18,27,1077,155,922
360470547001,36, New York,047, Kings County,256,110,30,0,80,65,65,30,0,35,191,45,0,0,45,686,133,553
360470547002,36, New York,047, Kings County,282,154,154,0,0,122,76,76,0,0,160,78,78,0,0,920,481,439
360470547003,36, New York,047, Kings County,893,591,549,1,41,106,70,70,0,0,787,521,479,1,41,2492,316,2176
360470548001,36, New York,047, Kings County,372,256,113,0,143,35,0,0,0,0,337,256,113,0,143,867,209,658
360470548002,36, New York,047, Kings County,165,74,74,0,0,35,5,5,0,0,130,69,69,0,0,448,90,358
360470549001,36, New York,047, Kings County,392,214,117,12,85,114,114,93,12,9,278,100,24,0,76,1024,243,781
360470549002,36, New York,047, Kings County,401,151,81,0,70,0,0,0,0,0,401,151,81,0,70,1991,131,1860
360470550001,36, New York,047, Kings County,290,193,144,0,49,95,85,56,0,29,195,108,88,0,20,593,124,469
360470550002,36, New York,047, Kings County,263,55,55,0,0,0,0,0,0,0,263,55,55,0,0,691,92,599
360470550003,36, New York,047, Kings County,375,162,114,18,30,95,28,28,0,0,280,134,86,18,30,670,180,490
360470551001,36, New York,047, Kings County,656,322,225,22,75,75,75,0,0,75,581,247,225,22,0,1655,114,1541
360470551002,36, New York,047, Kings County,237,86,31,36,19,148,19,0,0,19,89,67,31,36,0,939,376,563
360470551003,36, New York,047, Kings County,232,162,70,11,81,0,0,0,0,0,232,162,70,11,81,1117,40,1077
360470551004,36, New York,047, Kings County,124,26,0,0,26,15,15,0,0,15,109,11,0,0,11,681,38,643
360470552001,36, New York,047, Kings County,416,122,102,12,8,41,15,15,0,0,375,107,87,12,8,1085,134,951
360470552002,36, New York,047, Kings County,365,146,146,0,0,11,0,0,0,0,354,146,146,0,0,943,50,893
360470552003,36, New York,047, Kings County,133,66,38,28,0,18,18,0,18,0,115,48,38,10,0,479,12,467
360470553001,36, New York,047, Kings County,97,23,23,0,0,0,0,0,0,0,97,23,23,0,0,609,64,545
360470553002,36, New York,047, Kings County,321,122,111,0,11,60,11,0,0,11,261,111,111,0,0,1188,465,723
360470553003,36, New York,047, Kings County,126,25,16,9,0,0,0,0,0,0,126,25,16,9,0,886,73,813
360470554001,36, New York,047, Kings County,533,290,152,21,117,81,42,25,0,17,452,248,127,21,100,1125,180,945
360470554002,36, New York,047, Kings County,332,76,42,0,34,22,8,0,0,8,310,68,42,0,26,660,58,602
360470554003,36, New York,047, Kings County,203,73,43,0,30,34,10,0,0,10,169,63,43,0,20,593,82,511
360470555001,36, New York,047, Kings County,2287,886,717,119,50,70,23,0,0,23,2217,863,717,119,27,6545,450,6095
360470556001,36, New York,047, Kings County,353,208,208,0,0,114,99,99,0,0,239,109,109,0,0,1031,457,574
360470556002,36, New York,047, Kings County,325,115,92,0,23,38,23,0,0,23,287,92,92,0,0,928,110,818
360470556003,36, New York,047, Kings County,119,83,83,0,0,38,38,38,0,0,81,45,45,0,0,308,110,198
360470557001,36, New York,047, Kings County,70,14,14,0,0,0,0,0,0,0,70,14,14,0,0,334,19,315
360470557002,36, New York,047, Kings County,322,116,57,28,31,0,0,0,0,0,322,116,57,28,31,819,65,754
360470558001,36, New York,047, Kings County,237,71,71,0,0,40,18,18,0,0,197,53,53,0,0,629,83,546
360470558002,36, New York,047, Kings County,377,158,104,7,47,41,29,7,7,15,336,129,97,0,32,936,170,766
360470560001,36, New York,047, Kings County,408,117,79,38,0,69,0,0,0,0,339,117,79,38,0,1046,196,850
360470560002,36, New York,047, Kings County,388,176,100,0,76,18,18,0,0,18,370,158,100,0,58,807,87,720
360470560003,36, New York,047, Kings County,151,60,50,0,10,6,0,0,0,0,145,60,50,0,10,458,81,377
360470561001,36, New York,047, Kings County,139,20,13,7,0,0,0,0,0,0,139,20,13,7,0,800,19,781
360470561002,36, New York,047, Kings County,174,77,77,0,0,0,0,0,0,0,174,77,77,0,0,571,23,548
360470561003,36, New York,047, Kings County,85,8,8,0,0,0,0,0,0,0,85,8,8,0,0,733,39,694
360470561004,36, New York,047, Kings County,226,56,32,24,0,14,14,14,0,0,212,42,18,24,0,761,40,721
360470562001,36, New York,047, Kings County,290,149,143,0,6,0,0,0,0,0,290,149,143,0,6,733,9,724
360470562002,36, New York,047, Kings County,194,66,66,0,0,0,0,0,0,0,194,66,66,0,0,465,6,459
360470563011,36, New York,047, Kings County,304,168,127,0,41,54,54,54,0,0,250,114,73,0,41,897,40,857
360470563012,36, New York,047, Kings County,136,48,23,25,0,0,0,0,0,0,136,48,23,25,0,601,60,541
360470563013,36, New York,047, Kings County,97,31,31,0,0,0,0,0,0,0,97,31,31,0,0,747,50,697
360470563014,36, New York,047, Kings County,309,92,77,0,15,0,0,0,0,0,309,92,77,0,15,764,53,711
360470563020,36, New York,047, Kings County,0,0,0,0,0,0,0,0,0,0,0,0,0,0,0,0,0,0
360470563021,36, New York,047, Kings County,9,9,0,0,9,9,9,0,0,9,0,0,0,0,0,183,136,47
360470563022,36, New York,047, Kings County,400,145,104,16,25,0,0,0,0,0,400,145,104,16,25,1038,30,1008
360470564001,36, New York,047, Kings County,356,121,107,6,8,17,2,2,0,0,339,119,105,6,8,1120,114,1006
360470564002,36, New York,047, Kings County,161,86,82,0,4,22,22,22,0,0,139,64,60,0,4,501,83,418
360470564003,36, New York,047, Kings County,59,8,8,0,0,0,0,0,0,0,59,8,8,0,0,188,0,188
360470565001,36, New York,047, Kings County,267,75,65,10,0,10,0,0,0,0,257,75,65,10,0,1256,124,1132
360470565002,36, New York,047, Kings County,131,53,53,0,0,0,0,0,0,0,131,53,53,0,0,613,38,575
360470565003,36, New York,047, Kings County,150,43,28,0,15,0,0,0,0,0,150,43,28,0,15,781,53,728
360470566001,36, New York,047, Kings County,306,124,91,20,13,19,0,0,0,0,287,124,91,20,13,1003,134,869
360470566002,36, New York,047, Kings County,257,66,38,9,19,67,7,7,0,0,190,59,31,9,19,864,353,511
360470568001,36, New York,047, Kings County,178,75,53,0,22,48,43,28,0,15,130,32,25,0,7,437,83,354
360470568002,36, New York,047, Kings County,216,58,52,0,6,18,18,18,0,0,198,40,34,0,6,568,37,531
360470569001,36, New York,047, Kings County,161,50,50,0,0,0,0,0,0,0,161,50,50,0,0,654,46,608
360470569002,36, New York,047, Kings County,269,62,56,0,6,0,0,0,0,0,269,62,56,0,6,726,4,722
360470570001,36, New York,047, Kings County,195,87,87,0,0,0,0,0,0,0,195,87,87,0,0,809,47,762
360470570002,36, New York,047, Kings County,178,41,41,0,0,0,0,0,0,0,178,41,41,0,0,664,10,654
360470570003,36, New York,047, Kings County,120,81,44,8,29,0,0,0,0,0,120,81,44,8,29,480,20,460
360470570004,36, New York,047, Kings County,294,111,59,15,37,44,39,2,0,37,250,72,57,15,0,752,22,730
360470571001,36, New York,047, Kings County,220,72,72,0,0,0,0,0,0,0,220,72,72,0,0,835,67,768
360470571002,36, New York,047, Kings County,221,149,133,0,16,0,0,0,0,0,221,149,133,0,16,789,20,769
360470571003,36, New York,047, Kings County,193,49,49,0,0,22,0,0,0,0,171,49,49,0,0,927,43,884
360470571004,36, New York,047, Kings County,238,98,52,46,0,46,0,0,0,0,192,98,52,46,0,442,38,404
360470572001,36, New York,047, Kings County,915,416,34,0,382,270,119,0,0,119,645,297,34,0,263,2012,709,1303
360470572002,36, New York,047, Kings County,636,258,17,75,166,180,45,0,0,45,456,213,17,75,121,1496,488,1008
360470573001,36, New York,047, Kings County,93,28,0,28,0,29,0,0,0,0,64,28,0,28,0,380,75,305
360470573002,36, New York,047, Kings County,120,41,32,0,9,9,9,0,0,9,111,32,32,0,0,638,86,552
360470573003,36, New York,047, Kings County,246,51,41,0,10,0,0,0,0,0,246,51,41,0,10,874,41,833
360470574001,36, New York,047, Kings County,471,177,140,17,20,91,68,40,13,15,380,109,100,4,5,944,143,801
360470574002,36, New York,047, Kings County,378,71,38,10,23,39,12,0,0,12,339,59,38,10,11,892,80,812
360470575001,36, New York,047, Kings County,276,85,55,0,30,30,30,30,0,0,246,55,25,0,30,985,115,870
360470575002,36, New York,047, Kings County,254,111,111,0,0,31,31,31,0,0,223,80,80,0,0,1003,75,928
360470575003,36, New York,047, Kings County,190,37,22,0,15,22,0,0,0,0,168,37,22,0,15,1029,65,964
360470575004,36, New York,047, Kings County,242,126,65,61,0,0,0,0,0,0,242,126,65,61,0,908,75,833
360470576001,36, New York,047, Kings County,443,127,85,0,42,47,12,0,0,12,396,115,85,0,30,768,83,685
360470576002,36, New York,047, Kings County,382,119,68,7,44,46,17,17,0,0,336,102,51,7,44,1085,83,1002
360470578001,36, New York,047, Kings County,418,122,105,0,17,57,41,24,0,17,361,81,81,0,0,1100,157,943
360470578002,36, New York,047, Kings County,339,117,117,0,0,90,30,30,0,0,249,87,87,0,0,961,229,732
360470579011,36, New York,047, Kings County,44,15,15,0,0,0,0,0,0,0,44,15,15,0,0,198,7,191
360470579012,36, New York,047, Kings County,103,16,16,0,0,21,0,0,0,0,82,16,16,0,0,871,251,620
360470579021,36, New York,047, Kings County,0,0,0,0,0,0,0,0,0,0,0,0,0,0,0,0,0,0
360470580001,36, New York,047, Kings County,416,201,201,0,0,135,57,57,0,0,281,144,144,0,0,1271,498,773
360470580002,36, New York,047, Kings County,275,84,77,0,7,44,5,5,0,0,231,79,72,0,7,1035,204,831
360470582001,36, New York,047, Kings County,220,96,91,0,5,23,0,0,0,0,197,96,91,0,5,529,101,428
360470582002,36, New York,047, Kings County,107,23,23,0,0,0,0,0,0,0,107,23,23,0,0,224,13,211
360470582003,36, New York,047, Kings County,195,76,56,0,20,0,0,0,0,0,195,76,56,0,20,516,86,430
360470584001,36, New York,047, Kings County,319,92,51,0,41,51,26,2,0,24,268,66,49,0,17,778,127,651
360470584002,36, New York,047, Kings County,577,341,270,0,71,0,0,0,0,0,577,341,270,0,71,1491,85,1406
360470586001,36, New York,047, Kings County,274,166,127,0,39,49,37,23,0,14,225,129,104,0,25,802,229,573
360470586002,36, New York,047, Kings County,300,92,80,0,12,21,7,1,0,6,279,85,79,0,6,728,59,669
360470588001,36, New York,047, Kings County,388,110,97,0,13,0,0,0,0,0,388,110,97,0,13,1224,56,1168
360470588002,36, New York,047, Kings County,381,118,82,0,36,31,0,0,0,0,350,118,82,0,36,1476,142,1334
360470589011,36, New York,047, Kings County,331,136,71,0,65,16,0,0,0,0,315,136,71,0,65,902,68,834
360470589012,36, New York,047, Kings County,125,74,71,3,0,4,0,0,0,0,121,74,71,3,0,460,25,435
360470589021,36, New York,047, Kings County,0,0,0,0,0,0,0,0,0,0,0,0,0,0,0,0,0,0
360470590001,36, New York,047, Kings County,436,172,148,24,0,113,50,31,19,0,323,122,117,5,0,1018,175,843
360470591001,36, New York,047, Kings County,136,46,46,0,0,0,0,0,0,0,136,46,46,0,0,716,73,643
360470591002,36, New York,047, Kings County,230,92,28,0,64,0,0,0,0,0,230,92,28,0,64,950,23,927
360470591003,36, New York,047, Kings County,242,84,64,0,20,0,0,0,0,0,242,84,64,0,20,713,33,680
360470591004,36, New York,047, Kings County,245,100,54,0,46,0,0,0,0,0,245,100,54,0,46,739,22,717
360470592001,36, New York,047, Kings County,363,204,71,14,119,0,0,0,0,0,363,204,71,14,119,685,69,616
360470592002,36, New York,047, Kings County,488,133,87,22,24,132,24,0,0,24,356,109,87,22,0,973,240,733
360470592003,36, New York,047, Kings County,299,90,80,0,10,10,0,0,0,0,289,90,80,0,10,625,83,542
360470593001,36, New York,047, Kings County,359,165,134,0,31,18,18,0,0,18,341,147,134,0,13,1122,49,1073
360470593002,36, New York,047, Kings County,183,98,78,8,12,34,22,2,8,12,149,76,76,0,0,616,72,544
360470594021,36, New York,047, Kings County,328,195,164,31,0,6,0,0,0,0,322,195,164,31,0,774,18,756
360470594022,36, New York,047, Kings County,416,124,114,10,0,51,8,8,0,0,365,116,106,10,0,941,142,799
360470594023,36, New York,047, Kings County,408,187,182,0,5,75,41,41,0,0,333,146,141,0,5,1103,209,894
360470594024,36, New York,047, Kings County,628,172,135,6,31,16,7,0,0,7,612,165,135,6,24,818,36,782
360470594031,36, New York,047, Kings County,291,99,87,0,12,0,0,0,0,0,291,99,87,0,12,603,14,589
360470594032,36, New York,047, Kings County,207,73,73,0,0,46,38,38,0,0,161,35,35,0,0,404,8,396
360470594033,36, New York,047, Kings County,241,117,73,20,24,0,0,0,0,0,241,117,73,20,24,801,116,685
360470594041,36, New York,047, Kings County,355,159,159,0,0,43,12,12,0,0,312,147,147,0,0,1021,92,929
360470594042,36, New York,047, Kings County,391,207,188,0,19,0,0,0,0,0,391,207,188,0,19,1187,75,1112
360470594043,36, New York,047, Kings County,362,87,57,0,30,81,18,0,0,18,281,69,57,0,12,786,144,642
360470596001,36, New York,047, Kings County,184,56,30,0,26,4,0,0,0,0,180,56,30,0,26,377,18,359
360470596002,36, New York,047, Kings County,153,44,44,0,0,0,0,0,0,0,153,44,44,0,0,723,72,651
360470596003,36, New York,047, Kings County,203,73,65,0,8,49,49,49,0,0,154,24,16,0,8,511,46,465
360470598001,36, New York,047, Kings County,577,279,262,0,17,100,21,21,0,0,477,258,241,0,17,1263,166,1097
360470598002,36, New York,047, Kings County,257,121,98,0,23,11,0,0,0,0,246,121,98,0,23,874,49,825
360470600001,36, New York,047, Kings County,386,170,149,15,6,37,37,31,0,6,349,133,118,15,0,814,126,688
360470600002,36, New York,047, Kings County,257,40,6,0,34,97,20,0,0,20,160,20,6,0,14,686,176,510
360470600003,36, New York,047, Kings County,645,141,100,0,41,1,0,0,0,0,644,141,100,0,41,1792,53,1739
360470600004,36, New York,047, Kings County,328,182,108,0,74,0,0,0,0,0,328,182,108,0,74,828,54,774
360470600005,36, New York,047, Kings County,217,11,11,0,0,21,0,0,0,0,196,11,11,0,0,748,166,582
360470606001,36, New York,047, Kings County,509,262,127,0,135,0,0,0,0,0,509,262,127,0,135,1345,123,1222
360470606002,36, New York,047, Kings County,227,48,26,10,12,10,10,0,10,0,217,38,26,0,12,650,72,578
360470608001,36, New York,047, Kings County,238,105,80,0,25,1,0,0,0,0,237,105,80,0,25,569,38,531
360470608002,36, New York,047, Kings County,512,196,115,67,14,56,28,0,14,14,456,168,115,53,0,1078,222,856
360470608003,36, New York,047, Kings County,372,93,79,0,14,64,14,0,0,14,308,79,79,0,0,957,218,739
360470610020,36, New York,047, Kings County,0,0,0,0,0,0,0,0,0,0,0,0,0,0,0,0,0,0
360470610021,36, New York,047, Kings County,455,26,26,0,0,0,0,0,0,0,455,26,26,0,0,817,0,817
360470610022,36, New York,047, Kings County,759,339,207,0,132,136,35,35,0,0,623,304,172,0,132,1667,296,1371
360470610023,36, New York,047, Kings County,376,48,32,0,16,53,13,13,0,0,323,35,19,0,16,1145,269,876
360470610031,36, New York,047, Kings County,95,88,65,0,23,67,63,52,0,11,28,25,13,0,12,178,105,73
360470610032,36, New York,047, Kings County,214,90,46,0,44,64,24,0,0,24,150,66,46,0,20,707,145,562
360470610041,36, New York,047, Kings County,444,175,175,0,0,44,0,0,0,0,400,175,175,0,0,807,210,597
360470610042,36, New York,047, Kings County,282,105,105,0,0,0,0,0,0,0,282,105,105,0,0,605,115,490
360470610043,36, New York,047, Kings County,113,17,17,0,0,34,0,0,0,0,79,17,17,0,0,282,55,227
360470610044,36, New York,047, Kings County,333,208,129,0,79,0,0,0,0,0,333,208,129,0,79,733,51,682
360470610045,36, New York,047, Kings County,241,104,84,0,20,0,0,0,0,0,241,104,84,0,20,984,258,726
360470612001,36, New York,047, Kings County,329,64,64,0,0,10,0,0,0,0,319,64,64,0,0,845,44,801
360470616000,36, New York,047, Kings County,0,0,0,0,0,0,0,0,0,0,0,0,0,0,0,0,0,0
360470616001,36, New York,047, Kings County,399,92,75,0,17,0,0,0,0,0,399,92,75,0,17,1010,26,984
360470620001,36, New York,047, Kings County,287,101,73,0,28,0,0,0,0,0,287,101,73,0,28,577,23,554
360470620002,36, New York,047, Kings County,232,90,71,0,19,19,19,0,0,19,213,71,71,0,0,562,6,556
360470622001,36, New York,047, Kings County,268,144,114,0,30,41,0,0,0,0,227,144,114,0,30,891,255,636
360470622002,36, New York,047, Kings County,432,179,130,0,49,41,41,0,0,41,391,138,130,0,8,1060,238,822
360470626001,36, New York,047, Kings County,199,99,79,9,11,9,9,9,0,0,190,90,70,9,11,485,75,410
360470626002,36, New York,047, Kings County,679,177,130,11,36,74,0,0,0,0,605,177,130,11,36,1747,205,1542
360470628001,36, New York,047, Kings County,345,105,96,0,9,5,5,0,0,5,340,100,96,0,4,1021,16,1005
360470628002,36, New York,047, Kings County,293,133,104,21,8,15,15,11,0,4,278,118,93,21,4,843,37,806
360470628003,36, New York,047, Kings County,216,59,49,0,10,7,0,0,0,0,209,59,49,0,10,589,25,564
360470628004,36, New York,047, Kings County,392,233,179,0,54,0,0,0,0,0,392,233,179,0,54,1045,47,998
360470632001,36, New York,047, Kings County,237,82,82,0,0,0,0,0,0,0,237,82,82,0,0,736,23,713
360470632002,36, New York,047, Kings County,169,47,12,8,27,18,0,0,0,0,151,47,12,8,27,495,58,437
360470636001,36, New York,047, Kings County,307,149,149,0,0,16,16,16,0,0,291,133,133,0,0,802,49,753
360470638001,36, New York,047, Kings County,231,142,142,0,0,17,17,17,0,0,214,125,125,0,0,650,9,641
360470638002,36, New York,047, Kings County,297,101,73,0,28,17,1,1,0,0,280,100,72,0,28,747,80,667
360470640001,36, New York,047, Kings County,216,116,106,3,7,0,0,0,0,0,216,116,106,3,7,635,0,635
360470640002,36, New York,047, Kings County,215,67,60,7,0,0,0,0,0,0,215,67,60,7,0,539,37,502
360470642001,36, New York,047, Kings County,261,191,186,0,5,20,20,20,0,0,241,171,166,0,5,745,30,715
360470642002,36, New York,047, Kings County,344,88,68,0,20,68,39,26,0,13,276,49,42,0,7,890,209,681
360470644001,36, New York,047, Kings County,337,136,128,0,8,33,23,23,0,0,304,113,105,0,8,812,51,761
360470644002,36, New York,047, Kings County,20,15,9,6,0,0,0,0,0,0,20,15,9,6,0,59,0,59
360470644003,36, New York,047, Kings County,249,135,47,0,88,88,88,0,0,88,161,47,47,0,0,589,75,514
360470646001,36, New York,047, Kings County,168,69,57,0,12,20,0,0,0,0,148,69,57,0,12,483,41,442
360470646002,36, New York,047, Kings County,455,322,316,0,6,26,0,0,0,0,429,322,316,0,6,880,8,872
360470648001,36, New York,047, Kings County,246,101,101,0,0,13,11,11,0,0,233,90,90,0,0,878,102,776
360470648002,36, New York,047, Kings County,269,104,86,0,18,20,13,13,0,0,249,91,73,0,18,634,64,570
360470650001,36, New York,047, Kings County,117,44,29,0,15,15,15,0,0,15,102,29,29,0,0,350,53,297
360470650002,36, New York,047, Kings County,220,64,34,30,0,0,0,0,0,0,220,64,34,30,0,712,17,695
360470652001,36, New York,047, Kings County,363,110,110,0,0,0,0,0,0,0,363,110,110,0,0,1008,17,991
360470654001,36, New York,047, Kings County,227,107,96,0,11,20,0,0,0,0,207,107,96,0,11,539,26,513
360470654002,36, New York,047, Kings County,228,103,92,0,11,3,0,0,0,0,225,103,92,0,11,714,9,705
360470656001,36, New York,047, Kings County,270,111,102,9,0,6,6,6,0,0,264,105,96,9,0,768,16,752
360470656002,36, New York,047, Kings County,248,81,63,0,18,3,0,0,0,0,245,81,63,0,18,525,3,522
360470658001,36, New York,047, Kings County,158,76,76,0,0,7,0,0,0,0,151,76,76,0,0,431,30,401
360470658002,36, New York,047, Kings County,265,142,112,0,30,49,49,31,0,18,216,93,81,0,12,681,92,589
360470660001,36, New York,047, Kings County,292,160,131,0,29,8,0,0,0,0,284,160,131,0,29,820,28,792
360470660002,36, New York,047, Kings County,207,85,79,0,6,31,6,6,0,0,176,79,73,0,6,652,52,600
360470662001,36, New York,047, Kings County,376,92,92,0,0,21,15,15,0,0,355,77,77,0,0,904,57,847
360470666000,36, New York,047, Kings County,0,0,0,0,0,0,0,0,0,0,0,0,0,0,0,0,0,0
360470666001,36, New York,047, Kings County,0,0,0,0,0,0,0,0,0,0,0,0,0,0,0,0,0,0
360470670001,36, New York,047, Kings County,244,166,35,11,120,14,14,0,0,14,230,152,35,11,106,660,35,625
360470670002,36, New York,047, Kings County,506,146,61,0,85,54,40,5,0,35,452,106,56,0,50,1308,87,1221
360470672001,36, New York,047, Kings County,416,134,129,0,5,5,0,0,0,0,411,134,129,0,5,1128,46,1082
360470674001,36, New York,047, Kings County,209,75,44,0,31,9,0,0,0,0,200,75,44,0,31,542,50,492
360470674002,36, New York,047, Kings County,261,77,46,12,19,10,10,10,0,0,251,67,36,12,19,833,47,786
360470676001,36, New York,047, Kings County,356,126,0,7,119,16,0,0,0,0,340,126,0,7,119,1017,75,942
360470676002,36, New York,047, Kings County,128,96,72,11,13,39,39,39,0,0,89,57,33,11,13,336,128,208
360470678001,36, New York,047, Kings County,371,102,64,8,30,54,8,0,8,0,317,94,64,0,30,1170,97,1073
360470678002,36, New York,047, Kings County,382,210,107,29,74,22,5,0,5,0,360,205,107,24,74,1004,85,919
360470680001,36, New York,047, Kings County,253,125,50,0,75,0,0,0,0,0,253,125,50,0,75,616,17,599
360470680002,36, New York,047, Kings County,189,99,83,0,16,0,0,0,0,0,189,99,83,0,16,638,13,625
360470682001,36, New York,047, Kings County,377,92,83,8,1,12,12,12,0,0,365,80,71,8,1,1075,34,1041
360470682002,36, New York,047, Kings County,405,55,44,0,11,65,0,0,0,0,340,55,44,0,11,850,144,706
360470686001,36, New York,047, Kings County,210,65,48,0,17,0,0,0,0,0,210,65,48,0,17,526,19,507
360470686002,36, New York,047, Kings County,231,148,103,18,27,0,0,0,0,0,231,148,103,18,27,599,40,559
360470688001,36, New York,047, Kings County,266,112,55,0,57,0,0,0,0,0,266,112,55,0,57,887,3,884
360470688002,36, New York,047, Kings County,180,100,86,0,14,14,14,0,0,14,166,86,86,0,0,399,12,387
360470690001,36, New York,047, Kings County,226,88,56,7,25,5,0,0,0,0,221,88,56,7,25,519,41,478
360470690002,36, New York,047, Kings County,253,145,97,0,48,24,24,0,0,24,229,121,97,0,24,575,25,550
360470692001,36, New York,047, Kings County,305,123,91,13,19,0,0,0,0,0,305,123,91,13,19,1015,42,973
360470692002,36, New York,047, Kings County,236,81,44,0,37,8,0,0,0,0,228,81,44,0,37,717,36,681
360470696011,36, New York,047, Kings County,346,25,12,0,13,37,0,0,0,0,309,25,12,0,13,844,40,804
360470696012,36, New York,047, Kings County,653,329,254,30,45,21,0,0,0,0,632,329,254,30,45,1522,46,1476
360470696021,36, New York,047, Kings County,94,0,0,0,0,0,0,0,0,0,94,0,0,0,0,437,21,416
360470696022,36, New York,047, Kings County,722,244,111,37,96,39,39,0,0,39,683,205,111,37,57,1974,138,1836
360470696023,36, New York,047, Kings County,557,246,246,0,0,74,28,28,0,0,483,218,218,0,0,1456,195,1261
360470698001,36, New York,047, Kings County,158,80,80,0,0,0,0,0,0,0,158,80,80,0,0,404,6,398
360470698002,36, New York,047, Kings County,174,76,76,0,0,0,0,0,0,0,174,76,76,0,0,442,25,417
360470700001,36, New York,047, Kings County,247,88,43,0,45,0,0,0,0,0,247,88,43,0,45,540,12,528
360470700002,36, New York,047, Kings County,119,35,27,0,8,0,0,0,0,0,119,35,27,0,8,542,42,500
360470702011,36, New York,047, Kings County,238,86,86,0,0,0,0,0,0,0,238,86,86,0,0,494,0,494
360470702012,36, New York,047, Kings County,280,146,95,51,0,0,0,0,0,0,280,146,95,51,0,599,0,599
360470702013,36, New York,047, Kings County,309,102,102,0,0,0,0,0,0,0,309,102,102,0,0,805,49,756
360470702014,36, New York,047, Kings County,543,195,178,17,0,0,0,0,0,0,543,195,178,17,0,1470,52,1418
360470702015,36, New York,047, Kings County,399,175,83,58,34,59,10,10,0,0,340,165,73,58,34,1299,120,1179
360470702020,36, New York,047, Kings County,0,0,0,0,0,0,0,0,0,0,0,0,0,0,0,0,0,0
360470702021,36, New York,047, Kings County,9,0,0,0,0,0,0,0,0,0,9,0,0,0,0,14,0,14
360470702030,36, New York,047, Kings County,0,0,0,0,0,0,0,0,0,0,0,0,0,0,0,0,0,0
360470702031,36, New York,047, Kings County,0,0,0,0,0,0,0,0,0,0,0,0,0,0,0,0,0,0
360470706011,36, New York,047, Kings County,201,120,120,0,0,10,0,0,0,0,191,120,120,0,0,588,20,568
360470706012,36, New York,047, Kings County,533,253,219,0,34,25,25,0,0,25,508,228,219,0,9,1453,49,1404
360470706020,36, New York,047, Kings County,0,0,0,0,0,0,0,0,0,0,0,0,0,0,0,0,0,0
360470706021,36, New York,047, Kings County,0,0,0,0,0,0,0,0,0,0,0,0,0,0,0,0,0,0
360470720001,36, New York,047, Kings County,545,274,86,0,188,144,86,0,0,86,401,188,86,0,102,1294,224,1070
360470722001,36, New York,047, Kings County,325,36,16,6,14,0,0,0,0,0,325,36,16,6,14,941,20,921
360470722002,36, New York,047, Kings County,479,171,107,27,37,198,15,0,0,15,281,156,107,27,22,782,40,742
360470724001,36, New York,047, Kings County,248,85,34,12,39,22,22,22,0,0,226,63,12,12,39,596,52,544
360470724002,36, New York,047, Kings County,260,100,59,0,41,31,31,0,0,31,229,69,59,0,10,918,121,797
360470726001,36, New York,047, Kings County,591,214,121,34,59,64,64,26,18,20,527,150,95,16,39,1790,210,1580
360470728001,36, New York,047, Kings County,793,411,219,0,192,74,18,0,0,18,719,393,219,0,174,2072,213,1859
360470728002,36, New York,047, Kings County,247,73,54,0,19,0,0,0,0,0,247,73,54,0,19,611,25,586
360470730001,36, New York,047, Kings County,416,175,92,0,83,15,0,0,0,0,401,175,92,0,83,1162,41,1121
360470730002,36, New York,047, Kings County,269,66,36,7,23,0,0,0,0,0,269,66,36,7,23,851,23,828
360470732001,36, New York,047, Kings County,247,89,62,16,11,13,7,0,0,7,234,82,62,16,4,661,58,603
360470732002,36, New York,047, Kings County,271,210,75,37,98,57,57,0,13,44,214,153,75,24,54,815,85,730
360470734001,36, New York,047, Kings County,196,39,32,0,7,0,0,0,0,0,196,39,32,0,7,520,0,520
360470734002,36, New York,047, Kings County,156,49,8,14,27,0,0,0,0,0,156,49,8,14,27,583,50,533
360470736001,36, New York,047, Kings County,241,68,13,0,55,13,0,0,0,0,228,68,13,0,55,747,53,694
360470736002,36, New York,047, Kings County,287,39,6,12,21,9,9,0,0,9,278,30,6,12,12,774,60,714
360470736003,36, New York,047, Kings County,260,116,98,0,18,49,35,35,0,0,211,81,63,0,18,565,82,483
360470738001,36, New York,047, Kings County,400,188,161,0,27,32,0,0,0,0,368,188,161,0,27,959,82,877
360470738002,36, New York,047, Kings County,116,50,50,0,0,0,0,0,0,0,116,50,50,0,0,407,75,332
360470738003,36, New York,047, Kings County,438,226,141,0,85,15,0,0,0,0,423,226,141,0,85,894,52,842
360470740001,36, New York,047, Kings County,424,296,260,19,17,94,84,72,0,12,330,212,188,19,5,828,150,678
360470740002,36, New York,047, Kings County,421,167,144,23,0,46,16,16,0,0,375,151,128,23,0,1292,152,1140
360470742001,36, New York,047, Kings County,397,136,111,0,25,48,48,32,0,16,349,88,79,0,9,1081,129,952
360470742002,36, New York,047, Kings County,321,209,166,18,25,34,0,0,0,0,287,209,166,18,25,910,102,808
360470744001,36, New York,047, Kings County,260,189,189,0,0,56,40,40,0,0,204,149,149,0,0,749,132,617
360470744002,36, New York,047, Kings County,304,140,124,0,16,29,0,0,0,0,275,140,124,0,16,922,74,848
360470746001,36, New York,047, Kings County,216,96,75,0,21,0,0,0,0,0,216,96,75,0,21,619,38,581
360470746002,36, New York,047, Kings County,284,145,128,0,17,17,17,0,0,17,267,128,128,0,0,724,105,619
360470748001,36, New York,047, Kings County,202,111,105,0,6,13,6,0,0,6,189,105,105,0,0,498,19,479
360470748002,36, New York,047, Kings County,151,93,57,36,0,23,18,0,18,0,128,75,57,18,0,586,145,441
360470750001,36, New York,047, Kings County,392,228,205,0,23,0,0,0,0,0,392,228,205,0,23,1067,29,1038
360470750002,36, New York,047, Kings County,299,129,85,0,44,20,0,0,0,0,279,129,85,0,44,832,65,767
360470752001,36, New York,047, Kings County,281,171,149,0,22,0,0,0,0,0,281,171,149,0,22,732,0,732
360470754001,36, New York,047, Kings County,158,98,65,0,33,0,0,0,0,0,158,98,65,0,33,489,19,470
360470754002,36, New York,047, Kings County,148,57,57,0,0,0,0,0,0,0,148,57,57,0,0,425,7,418
360470756001,36, New York,047, Kings County,250,94,93,0,1,40,0,0,0,0,210,94,93,0,1,757,86,671
360470756002,36, New York,047, Kings County,231,102,102,0,0,0,0,0,0,0,231,102,102,0,0,605,14,591
360470758001,36, New York,047, Kings County,91,0,0,0,0,0,0,0,0,0,91,0,0,0,0,198,0,198
360470758002,36, New York,047, Kings County,343,118,102,0,16,23,0,0,0,0,320,118,102,0,16,832,113,719
360470760001,36, New York,047, Kings County,123,52,52,0,0,0,0,0,0,0,123,52,52,0,0,284,0,284
360470760002,36, New York,047, Kings County,336,55,20,0,35,66,0,0,0,0,270,55,20,0,35,790,259,531
360470760003,36, New York,047, Kings County,333,125,58,23,44,7,0,0,0,0,326,125,58,23,44,811,71,740
360470762001,36, New York,047, Kings County,241,113,83,0,30,165,83,83,0,0,76,30,0,0,30,394,199,195
360470762002,36, New York,047, Kings County,334,100,43,54,3,56,26,0,26,0,278,74,43,28,3,999,220,779
360470762003,36, New York,047, Kings County,520,284,193,45,46,96,84,38,0,46,424,200,155,45,0,879,114,765
360470764001,36, New York,047, Kings County,350,218,177,13,28,14,8,8,0,0,336,210,169,13,28,908,49,859
360470764002,36, New York,047, Kings County,337,207,94,35,78,53,53,5,35,13,284,154,89,0,65,809,131,678
360470764003,36, New York,047, Kings County,204,99,30,11,58,25,25,14,11,0,179,74,16,0,58,777,83,694
360470766001,36, New York,047, Kings County,455,210,144,0,66,44,18,18,0,0,411,192,126,0,66,1567,142,1425
360470768001,36, New York,047, Kings County,241,173,162,0,11,21,11,0,0,11,220,162,162,0,0,695,175,520
360470768002,36, New York,047, Kings County,229,122,75,47,0,30,21,21,0,0,199,101,54,47,0,623,66,557
360470768003,36, New York,047, Kings County,383,241,202,0,39,43,35,35,0,0,340,206,167,0,39,890,185,705
360470770001,36, New York,047, Kings County,359,163,67,0,96,0,0,0,0,0,359,163,67,0,96,983,51,932
360470770002,36, New York,047, Kings County,353,171,68,0,103,55,55,0,0,55,298,116,68,0,48,604,64,540
360470772001,36, New York,047, Kings County,447,205,60,61,84,31,17,0,0,17,416,188,60,61,67,1259,128,1131
360470772002,36, New York,047, Kings County,341,101,65,0,36,67,36,0,0,36,274,65,65,0,0,1037,116,921
360470774001,36, New York,047, Kings County,139,43,0,0,43,0,0,0,0,0,139,43,0,0,43,732,136,596
360470774002,36, New York,047, Kings County,689,341,251,8,82,12,0,0,0,0,677,341,251,8,82,1575,64,1511
360470776001,36, New York,047, Kings County,264,109,109,0,0,0,0,0,0,0,264,109,109,0,0,799,64,735
360470776002,36, New York,047, Kings County,252,48,11,0,37,21,8,8,0,0,231,40,3,0,37,1026,58,968
360470776003,36, New York,047, Kings County,373,66,48,0,18,12,0,0,0,0,361,66,48,0,18,1147,38,1109
360470780001,36, New York,047, Kings County,231,74,66,0,8,0,0,0,0,0,231,74,66,0,8,808,38,770
360470780002,36, New York,047, Kings County,201,146,38,7,101,7,0,0,0,0,194,146,38,7,101,830,7,823
360470782001,36, New York,047, Kings County,470,119,79,0,40,41,0,0,0,0,429,119,79,0,40,1189,117,1072
360470782002,36, New York,047, Kings County,593,252,123,12,117,64,64,17,0,47,529,188,106,12,70,1564,207,1357
360470784001,36, New York,047, Kings County,332,36,15,16,5,0,0,0,0,0,332,36,15,16,5,1025,55,970
360470784002,36, New York,047, Kings County,334,153,79,0,74,46,33,25,0,8,288,120,54,0,66,859,82,777
360470786011,36, New York,047, Kings County,399,51,30,0,21,19,0,0,0,0,380,51,30,0,21,1114,90,1024
360470786012,36, New York,047, Kings County,231,155,86,29,40,37,23,23,0,0,194,132,63,29,40,628,77,551
360470786021,36, New York,047, Kings County,236,113,89,0,24,29,22,22,0,0,207,91,67,0,24,570,103,467
360470786022,36, New York,047, Kings County,267,149,74,3,72,36,18,0,3,15,231,131,74,0,57,858,180,678
360470788011,36, New York,047, Kings County,289,108,62,0,46,4,0,0,0,0,285,108,62,0,46,849,115,734
360470788012,36, New York,047, Kings County,280,113,11,36,66,11,11,11,0,0,269,102,0,36,66,578,40,538
360470788021,36, New York,047, Kings County,430,228,75,15,138,56,56,0,0,56,374,172,75,15,82,1116,206,910
360470790011,36, New York,047, Kings County,368,156,99,0,57,26,0,0,0,0,342,156,99,0,57,1244,101,1143
360470790021,36, New York,047, Kings County,315,189,106,0,83,0,0,0,0,0,315,189,106,0,83,956,37,919
360470790022,36, New York,047, Kings County,202,139,63,0,76,51,51,0,0,51,151,88,63,0,25,331,51,280
360470790023,36, New York,047, Kings County,215,82,17,0,65,22,0,0,0,0,193,82,17,0,65,535,100,435
360470792011,36, New York,047, Kings County,364,139,66,32,41,60,52,32,0,20,304,87,34,32,21,894,122,772
360470792021,36, New York,047, Kings County,298,161,46,44,71,40,40,0,31,9,258,121,46,13,62,1026,343,683
360470792022,36, New York,047, Kings County,197,123,20,13,90,47,6,4,0,2,150,117,16,13,88,497,94,403
360470794001,36, New York,047, Kings County,168,124,59,0,65,0,0,0,0,0,168,124,59,0,65,526,62,464
360470794002,36, New York,047, Kings County,249,116,51,23,42,17,17,0,0,17,232,99,51,23,25,965,330,635
360470794003,36, New York,047, Kings County,0,0,0,0,0,0,0,0,0,0,0,0,0,0,0,0,0,0
360470796011,36, New York,047, Kings County,294,165,56,0,109,18,18,0,0,18,276,147,56,0,91,1031,150,881
360470796012,36, New York,047, Kings County,303,108,85,12,11,47,24,13,0,11,256,84,72,12,0,1725,348,1377
360470796021,36, New York,047, Kings County,472,296,101,63,132,92,92,10,0,82,380,204,91,63,50,1418,321,1097
360470796022,36, New York,047, Kings County,870,468,162,124,182,72,0,0,0,0,798,468,162,124,182,2077,283,1794
360470798011,36, New York,047, Kings County,163,75,59,0,16,0,0,0,0,0,163,75,59,0,16,1142,57,1085
360470798012,36, New York,047, Kings County,371,201,119,9,73,24,0,0,0,0,347,201,119,9,73,1048,92,956
360470798021,36, New York,047, Kings County,326,69,16,0,53,53,53,0,0,53,273,16,16,0,0,1332,251,1081
360470798022,36, New York,047, Kings County,551,66,0,0,66,0,0,0,0,0,551,66,0,0,66,1735,155,1580
360470798023,36, New York,047, Kings County,192,90,41,49,0,0,0,0,0,0,192,90,41,49,0,798,96,702
360470800001,36, New York,047, Kings County,292,102,68,25,9,8,0,0,0,0,284,102,68,25,9,987,115,872
360470800002,36, New York,047, Kings County,191,58,37,0,21,10,0,0,0,0,181,58,37,0,21,613,117,496
360470800003,36, New York,047, Kings County,346,101,101,0,0,22,22,22,0,0,324,79,79,0,0,1196,99,1097
360470802001,36, New York,047, Kings County,301,77,40,0,37,12,0,0,0,0,289,77,40,0,37,1258,64,1194
360470802002,36, New York,047, Kings County,166,95,60,0,35,0,0,0,0,0,166,95,60,0,35,603,44,559
360470802003,36, New York,047, Kings County,437,171,73,23,75,49,49,28,0,21,388,122,45,23,54,1280,92,1188
360470804001,36, New York,047, Kings County,242,105,74,0,31,31,0,0,0,0,211,105,74,0,31,949,191,758
360470804002,36, New York,047, Kings County,325,64,27,0,37,43,0,0,0,0,282,64,27,0,37,1267,97,1170
360470804003,36, New York,047, Kings County,209,116,46,17,53,21,21,0,0,21,188,95,46,17,32,476,70,406
360470806001,36, New York,047, Kings County,410,133,104,0,29,64,22,22,0,0,346,111,82,0,29,1493,282,1211
360470806002,36, New York,047, Kings County,351,172,129,26,17,20,20,20,0,0,331,152,109,26,17,1005,59,946
360470808001,36, New York,047, Kings County,237,172,12,6,154,128,99,2,0,97,109,73,10,6,57,1065,711,354
360470810001,36, New York,047, Kings County,345,163,99,0,64,0,0,0,0,0,345,163,99,0,64,860,78,782
360470810002,36, New York,047, Kings County,288,72,15,0,57,46,46,0,0,46,242,26,15,0,11,586,106,480
360470814001,36, New York,047, Kings County,252,53,0,22,31,28,7,0,0,7,224,46,0,22,24,833,141,692
360470814002,36, New York,047, Kings County,384,133,27,0,106,32,15,0,0,15,352,118,27,0,91,1086,80,1006
360470816001,36, New York,047, Kings County,336,78,40,0,38,56,35,20,0,15,280,43,20,0,23,952,140,812
360470816002,36, New York,047, Kings County,414,151,91,6,54,19,6,0,0,6,395,145,91,6,48,1006,74,932
360470818001,36, New York,047, Kings County,590,159,82,0,77,45,0,0,0,0,545,159,82,0,77,1756,239,1517
360470818002,36, New York,047, Kings County,163,99,0,0,99,0,0,0,0,0,163,99,0,0,99,336,10,326
360470818003,36, New York,047, Kings County,205,123,105,0,18,71,71,54,0,17,134,52,51,0,1,559,177,382
360470820001,36, New York,047, Kings County,402,128,81,0,47,82,58,58,0,0,320,70,23,0,47,1076,253,823
360470820002,36, New York,047, Kings County,434,243,51,0,192,46,21,0,0,21,388,222,51,0,171,1787,247,1540
360470820003,36, New York,047, Kings County,194,74,41,0,33,73,34,21,0,13,121,40,20,0,20,689,361,328
360470822001,36, New York,047, Kings County,226,17,17,0,0,0,0,0,0,0,226,17,17,0,0,1126,114,1012
360470822002,36, New York,047, Kings County,453,170,37,34,99,0,0,0,0,0,453,170,37,34,99,1455,179,1276
360470822003,36, New York,047, Kings County,736,333,86,0,247,125,16,0,0,16,611,317,86,0,231,2021,321,1700
360470822004,36, New York,047, Kings County,306,139,59,4,76,0,0,0,0,0,306,139,59,4,76,976,139,837
360470824001,36, New York,047, Kings County,348,168,100,12,56,66,38,34,0,4,282,130,66,12,52,1083,159,924
360470824002,36, New York,047, Kings County,372,209,122,0,87,45,45,0,0,45,327,164,122,0,42,1059,271,788
360470824003,36, New York,047, Kings County,240,99,29,3,67,16,16,0,0,16,224,83,29,3,51,662,28,634
360470824004,36, New York,047, Kings County,267,76,38,0,38,0,0,0,0,0,267,76,38,0,38,539,45,494
360470826001,36, New York,047, Kings County,470,256,175,32,49,39,39,0,0,39,431,217,175,32,10,933,92,841
360470826002,36, New York,047, Kings County,175,56,0,0,56,49,49,0,0,49,126,7,0,0,7,412,109,303
360470826003,36, New York,047, Kings County,302,72,23,18,31,0,0,0,0,0,302,72,23,18,31,853,14,839
360470826004,36, New York,047, Kings County,352,113,24,0,89,19,0,0,0,0,333,113,24,0,89,1019,67,952
360470828001,36, New York,047, Kings County,320,125,4,0,121,42,31,0,0,31,278,94,4,0,90,819,146,673
360470828002,36, New York,047, Kings County,232,27,27,0,0,27,0,0,0,0,205,27,27,0,0,938,96,842
360470828003,36, New York,047, Kings County,325,136,74,23,39,11,0,0,0,0,314,136,74,23,39,913,33,880
360470830001,36, New York,047, Kings County,303,205,179,0,26,26,26,0,0,26,277,179,179,0,0,556,91,465
360470830002,36, New York,047, Kings County,559,73,73,0,0,38,0,0,0,0,521,73,73,0,0,1487,77,1410
360470830003,36, New York,047, Kings County,396,282,63,0,219,52,52,0,0,52,344,230,63,0,167,835,47,788
360470830004,36, New York,047, Kings County,320,274,128,0,146,45,45,0,0,45,275,229,128,0,101,795,138,657
360470832001,36, New York,047, Kings County,285,166,111,28,27,19,19,13,0,6,266,147,98,28,21,657,53,604
360470832002,36, New York,047, Kings County,331,121,85,20,16,20,20,0,20,0,311,101,85,0,16,893,27,866
360470834001,36, New York,047, Kings County,235,83,36,0,47,16,16,16,0,0,219,67,20,0,47,651,31,620
360470834002,36, New York,047, Kings County,252,78,32,0,46,26,0,0,0,0,226,78,32,0,46,576,68,508
360470836001,36, New York,047, Kings County,179,50,23,0,27,15,15,0,0,15,164,35,23,0,12,519,55,464
360470836002,36, New York,047, Kings County,311,160,80,16,64,4,0,0,0,0,307,160,80,16,64,844,44,800
360470838001,36, New York,047, Kings County,255,147,51,39,57,7,7,0,0,7,248,140,51,39,50,701,42,659
360470838002,36, New York,047, Kings County,286,37,7,0,30,71,0,0,0,0,215,37,7,0,30,824,271,553
360470840001,36, New York,047, Kings County,354,181,87,0,94,9,9,9,0,0,345,172,78,0,94,920,56,864
360470840002,36, New York,047, Kings County,288,129,36,46,47,33,26,0,26,0,255,103,36,20,47,745,74,671
360470846001,36, New York,047, Kings County,327,202,110,0,92,7,7,0,0,7,320,195,110,0,85,769,16,753
360470846002,36, New York,047, Kings County,167,5,0,0,5,0,0,0,0,0,167,5,0,0,5,496,25,471
360470848001,36, New York,047, Kings County,227,56,34,15,7,6,0,0,0,0,221,56,34,15,7,627,25,602
360470848002,36, New York,047, Kings County,215,62,49,0,13,50,0,0,0,0,165,62,49,0,13,538,44,494
360470850001,36, New York,047, Kings County,337,135,72,0,63,0,0,0,0,0,337,135,72,0,63,1254,16,1238
360470852001,36, New York,047, Kings County,3,3,3,0,0,0,0,0,0,0,3,3,3,0,0,12,0,12
360470854001,36, New York,047, Kings County,301,97,46,0,51,31,17,17,0,0,270,80,29,0,51,635,66,569
360470854002,36, New York,047, Kings County,277,88,35,0,53,21,21,0,0,21,256,67,35,0,32,773,89,684
360470856001,36, New York,047, Kings County,163,68,16,0,52,8,0,0,0,0,155,68,16,0,52,469,19,450
360470856002,36, New York,047, Kings County,235,167,93,0,74,54,54,0,0,54,181,113,93,0,20,481,36,445
360470856003,36, New York,047, Kings County,541,372,92,96,184,97,89,8,34,47,444,283,84,62,137,1216,321,895
360470858001,36, New York,047, Kings County,238,99,37,0,62,45,28,0,0,28,193,71,37,0,34,571,59,512
360470858002,36, New York,047, Kings County,269,101,43,44,14,14,0,0,0,0,255,101,43,44,14,778,35,743
360470860001,36, New York,047, Kings County,318,74,74,0,0,64,0,0,0,0,254,74,74,0,0,849,97,752
360470860002,36, New York,047, Kings County,288,179,70,0,109,0,0,0,0,0,288,179,70,0,109,386,29,357
360470860003,36, New York,047, Kings County,286,109,46,0,63,20,20,0,0,20,266,89,46,0,43,615,46,569
360470862001,36, New York,047, Kings County,287,73,44,0,29,39,12,12,0,0,248,61,32,0,29,814,165,649
360470862002,36, New York,047, Kings County,161,50,38,0,12,9,0,0,0,0,152,50,38,0,12,602,32,570
360470862003,36, New York,047, Kings County,365,246,89,19,138,81,81,0,19,62,284,165,89,0,76,775,136,639
360470864001,36, New York,047, Kings County,326,140,92,37,11,57,11,0,0,11,269,129,92,37,0,896,96,800
360470864002,36, New York,047, Kings County,271,118,81,0,37,40,23,10,0,13,231,95,71,0,24,967,237,730
360470866001,36, New York,047, Kings County,235,87,87,0,0,27,27,27,0,0,208,60,60,0,0,811,63,748
360470866002,36, New York,047, Kings County,168,66,6,0,60,48,31,6,0,25,120,35,0,0,35,386,78,308
360470866003,36, New York,047, Kings County,230,101,54,0,47,62,14,0,0,14,168,87,54,0,33,818,125,693
360470868001,36, New York,047, Kings County,232,85,19,0,66,0,0,0,0,0,232,85,19,0,66,642,55,587
360470868002,36, New York,047, Kings County,151,114,35,43,36,49,49,16,33,0,102,65,19,10,36,319,93,226
360470868003,36, New York,047, Kings County,423,259,119,0,140,79,79,0,0,79,344,180,119,0,61,736,55,681
360470870001,36, New York,047, Kings County,279,166,119,0,47,61,61,14,0,47,218,105,105,0,0,825,74,751
360470870002,36, New York,047, Kings County,343,151,72,54,25,47,47,26,0,21,296,104,46,54,4,907,124,783
360470870003,36, New York,047, Kings County,182,82,36,13,33,9,9,0,0,9,173,73,36,13,24,410,28,382
360470872001,36, New York,047, Kings County,175,29,0,0,29,0,0,0,0,0,175,29,0,0,29,460,0,460
360470872002,36, New York,047, Kings County,288,149,101,48,0,67,67,42,25,0,221,82,59,23,0,660,153,507
360470872003,36, New York,047, Kings County,344,209,62,0,147,37,37,0,0,37,307,172,62,0,110,907,119,788
360470874011,36, New York,047, Kings County,275,131,73,0,58,26,15,15,0,0,249,116,58,0,58,948,197,751
360470874012,36, New York,047, Kings County,628,385,66,0,319,123,100,0,0,100,505,285,66,0,219,1423,463,960
360470876001,36, New York,047, Kings County,230,172,62,0,110,46,37,14,0,23,184,135,48,0,87,619,168,451
360470876002,36, New York,047, Kings County,154,4,4,0,0,12,0,0,0,0,142,4,4,0,0,574,70,504
360470878001,36, New York,047, Kings County,103,21,10,0,11,6,6,0,0,6,97,15,10,0,5,432,81,351
360470878002,36, New York,047, Kings County,20,0,0,0,0,0,0,0,0,0,20,0,0,0,0,60,0,60
360470878003,36, New York,047, Kings County,484,162,53,17,92,90,54,0,0,54,394,108,53,17,38,988,152,836
360470880011,36, New York,047, Kings County,196,48,16,2,30,9,9,0,0,9,187,39,16,2,21,748,89,659
360470880012,36, New York,047, Kings County,274,99,33,0,66,24,9,0,0,9,250,90,33,0,57,640,67,573
360470880021,36, New York,047, Kings County,248,155,66,49,40,35,16,0,0,16,213,139,66,49,24,763,110,653
360470882001,36, New York,047, Kings County,476,323,147,55,121,69,25,0,0,25,407,298,147,55,96,1122,175,947
360470882002,36, New York,047, Kings County,371,118,0,0,118,0,0,0,0,0,371,118,0,0,118,766,65,701
360470882003,36, New York,047, Kings County,209,145,80,0,65,0,0,0,0,0,209,145,80,0,65,331,0,331
360470882004,36, New York,047, Kings County,400,77,14,0,63,14,14,14,0,0,386,63,0,0,63,1281,65,1216
360470884001,36, New York,047, Kings County,667,425,27,10,388,423,344,0,10,334,244,81,27,0,54,982,271,711
360470884002,36, New York,047, Kings County,361,223,33,0,190,29,29,0,0,29,332,194,33,0,161,1291,113,1178
360470884003,36, New York,047, Kings County,302,133,57,0,76,69,40,0,0,40,233,93,57,0,36,771,198,573
360470886001,36, New York,047, Kings County,152,50,18,0,32,0,0,0,0,0,152,50,18,0,32,666,119,547
360470886002,36, New York,047, Kings County,458,118,11,0,107,0,0,0,0,0,458,118,11,0,107,1194,151,1043
360470886003,36, New York,047, Kings County,288,154,58,0,96,41,41,0,0,41,247,113,58,0,55,916,130,786
360470888001,36, New York,047, Kings County,406,164,121,15,28,101,59,31,0,28,305,105,90,15,0,900,354,546
360470888002,36, New York,047, Kings County,351,61,0,0,61,56,0,0,0,0,295,61,0,0,61,1144,260,884
360470888003,36, New York,047, Kings County,320,162,59,18,85,34,34,0,0,34,286,128,59,18,51,582,14,568
360470890001,36, New York,047, Kings County,306,114,46,0,68,68,68,0,0,68,238,46,46,0,0,816,97,719
360470890002,36, New York,047, Kings County,374,139,0,0,139,112,39,0,0,39,262,100,0,0,100,868,176,692
360470890003,36, New York,047, Kings County,240,122,0,0,122,73,0,0,0,0,167,122,0,0,122,366,71,295
360470890004,36, New York,047, Kings County,522,170,79,0,91,0,0,0,0,0,522,170,79,0,91,1302,121,1181
360470890005,36, New York,047, Kings County,223,223,139,46,38,50,50,50,0,0,173,173,89,46,38,500,94,406
360470890006,36, New York,047, Kings County,43,0,0,0,0,0,0,0,0,0,43,0,0,0,0,130,0,130
360470892001,36, New York,047, Kings County,59,22,22,0,0,0,0,0,0,0,59,22,22,0,0,354,35,319
360470892002,36, New York,047, Kings County,81,0,0,0,0,0,0,0,0,0,81,0,0,0,0,427,155,272
360470892003,36, New York,047, Kings County,84,33,19,0,14,14,14,0,0,14,70,19,19,0,0,664,250,414
360470892004,36, New York,047, Kings County,387,159,47,0,112,209,39,0,0,39,178,120,47,0,73,870,564,306
360470894001,36, New York,047, Kings County,186,50,25,25,0,36,0,0,0,0,150,50,25,25,0,509,75,434
360470894002,36, New York,047, Kings County,230,140,0,0,140,18,18,0,0,18,212,122,0,0,122,489,29,460
360470894003,36, New York,047, Kings County,155,55,21,0,34,62,34,0,0,34,93,21,21,0,0,498,254,244
360470894004,36, New York,047, Kings County,173,121,22,0,99,98,98,22,0,76,75,23,0,0,23,553,337,216
360470896001,36, New York,047, Kings County,122,83,42,0,41,13,13,13,0,0,109,70,29,0,41,418,45,373
360470896002,36, New York,047, Kings County,336,80,17,0,63,66,0,0,0,0,270,80,17,0,63,1186,345,841
360470896003,36, New York,047, Kings County,326,155,10,0,145,110,86,0,0,86,216,69,10,0,59,508,196,312
360470898001,36, New York,047, Kings County,211,76,43,0,33,20,20,0,0,20,191,56,43,0,13,522,41,481
360470898002,36, New York,047, Kings County,297,170,51,33,86,31,19,0,8,11,266,151,51,25,75,688,144,544
360470900001,36, New York,047, Kings County,69,46,15,0,31,0,0,0,0,0,69,46,15,0,31,141,11,130
360470900002,36, New York,047, Kings County,43,30,0,0,30,30,30,0,0,30,13,0,0,0,0,119,72,47
360470900003,36, New York,047, Kings County,97,54,41,0,13,13,0,0,0,0,84,54,41,0,13,395,119,276
360470900004,36, New York,047, Kings County,292,82,58,0,24,130,24,0,0,24,162,58,58,0,0,939,402,537
360470900005,36, New York,047, Kings County,342,153,72,20,61,204,110,72,0,38,138,43,0,20,23,822,453,369
360470900006,36, New York,047, Kings County,58,16,0,0,16,0,0,0,0,0,58,16,0,0,16,258,0,258
360470900007,36, New York,047, Kings County,158,106,0,0,106,26,26,0,0,26,132,80,0,0,80,582,137,445
360470902001,36, New York,047, Kings County,279,144,32,0,112,76,49,0,0,49,203,95,32,0,63,901,221,680
360470902002,36, New York,047, Kings County,38,0,0,0,0,0,0,0,0,0,38,0,0,0,0,1025,625,400
360470902003,36, New York,047, Kings County,39,39,16,0,23,0,0,0,0,0,39,39,16,0,23,566,217,349
360470902004,36, New York,047, Kings County,107,30,17,0,13,0,0,0,0,0,107,30,17,0,13,339,121,218
360470902005,36, New York,047, Kings County,106,65,43,0,22,3,3,0,0,3,103,62,43,0,19,257,3,254
360470906001,36, New York,047, Kings County,319,263,28,32,203,76,65,28,0,37,243,198,0,32,166,769,225,544
360470906002,36, New York,047, Kings County,360,229,27,0,202,87,67,0,0,67,273,162,27,0,135,824,221,603
360470906003,36, New York,047, Kings County,404,255,32,0,223,211,138,32,0,106,193,117,0,0,117,898,508,390
360470908001,36, New York,047, Kings County,194,94,54,0,40,112,42,26,0,16,82,52,28,0,24,4008,2860,1148
360470908002,36, New York,047, Kings County,209,78,20,0,58,47,47,20,0,27,162,31,0,0,31,589,151,438
360470908003,36, New York,047, Kings County,108,66,54,0,12,33,12,0,0,12,75,54,54,0,0,493,141,352
360470910001,36, New York,047, Kings County,317,243,44,0,199,190,166,0,0,166,127,77,44,0,33,824,394,430
360470910002,36, New York,047, Kings County,261,233,72,0,161,140,140,45,0,95,121,93,27,0,66,643,345,298
360470910003,36, New York,047, Kings County,376,151,0,9,142,117,51,0,9,42,259,100,0,0,100,830,341,489
360470910004,36, New York,047, Kings County,116,116,0,0,116,116,116,0,0,116,0,0,0,0,0,596,307,289
360470912001,36, New York,047, Kings County,392,245,71,0,174,186,154,0,0,154,206,91,71,0,20,1390,786,604
360470912002,36, New York,047, Kings County,317,145,0,55,90,66,27,0,0,27,251,118,0,55,63,767,247,520
360470912003,36, New York,047, Kings County,957,436,41,38,357,361,342,0,38,304,596,94,41,0,53,1605,606,999
360470916001,36, New York,047, Kings County,402,302,30,93,179,161,111,0,0,111,241,191,30,93,68,1031,411,620
360470916002,36, New York,047, Kings County,174,80,30,20,30,51,30,0,0,30,123,50,30,20,0,707,287,420
360470916003,36, New York,047, Kings County,108,44,26,0,18,20,11,11,0,0,88,33,15,0,18,351,19,332
360470916004,36, New York,047, Kings County,209,93,15,0,78,62,34,0,0,34,147,59,15,0,44,486,161,325
360470918001,36, New York,047, Kings County,331,178,44,8,126,102,91,0,8,83,229,87,44,0,43,1032,427,605
360470918002,36, New York,047, Kings County,176,50,6,13,31,0,0,0,0,0,176,50,6,13,31,727,0,727
360470920001,36, New York,047, Kings County,25,0,0,0,0,0,0,0,0,0,25,0,0,0,0,148,64,84
360470920002,36, New York,047, Kings County,532,315,0,54,261,117,117,0,54,63,415,198,0,0,198,1211,287,924
360470920003,36, New York,047, Kings County,81,0,0,0,0,0,0,0,0,0,81,0,0,0,0,404,5,399
360470920004,36, New York,047, Kings County,0,0,0,0,0,0,0,0,0,0,0,0,0,0,0,0,0,0
360470922001,36, New York,047, Kings County,227,21,0,0,21,0,0,0,0,0,227,21,0,0,21,654,0,654
360470922002,36, New York,047, Kings County,564,230,96,37,97,12,12,0,12,0,552,218,96,25,97,1717,120,1597
360470924001,36, New York,047, Kings County,313,196,126,0,70,81,81,48,0,33,232,115,78,0,37,604,141,463
360470924002,36, New York,047, Kings County,158,83,13,23,47,0,0,0,0,0,158,83,13,23,47,511,61,450
360470924003,36, New York,047, Kings County,74,60,11,27,22,38,24,11,0,13,36,36,0,27,9,300,166,134
360470928001,36, New York,047, Kings County,211,48,20,0,28,16,0,0,0,0,195,48,20,0,28,710,46,664
360470928002,36, New York,047, Kings County,472,133,36,0,97,13,0,0,0,0,459,133,36,0,97,1387,88,1299
360470928003,36, New York,047, Kings County,0,0,0,0,0,0,0,0,0,0,0,0,0,0,0,22,19,3
360470930001,36, New York,047, Kings County,345,124,83,0,41,19,19,14,0,5,326,105,69,0,36,994,120,874
360470930002,36, New York,047, Kings County,380,159,89,17,53,35,0,0,0,0,345,159,89,17,53,1104,86,1018
360470932001,36, New York,047, Kings County,445,63,0,63,0,83,63,0,63,0,362,0,0,0,0,1321,202,1119
360470934001,36, New York,047, Kings County,307,130,44,16,70,24,20,9,0,11,283,110,35,16,59,815,70,745
360470934002,36, New York,047, Kings County,381,149,81,0,68,0,0,0,0,0,381,149,81,0,68,1146,44,1102
360470936001,36, New York,047, Kings County,242,104,55,9,40,20,1,0,0,1,222,103,55,9,39,585,86,499
360470936002,36, New York,047, Kings County,209,54,15,0,39,0,0,0,0,0,209,54,15,0,39,531,12,519
360470938001,36, New York,047, Kings County,353,113,36,4,73,14,14,0,0,14,339,99,36,4,59,702,49,653
360470938002,36, New York,047, Kings County,369,131,41,50,40,18,14,14,0,0,351,117,27,50,40,973,112,861
360470944011,36, New York,047, Kings County,180,39,23,16,0,23,23,23,0,0,157,16,0,16,0,531,95,436
360470944012,36, New York,047, Kings County,245,32,32,0,0,0,0,0,0,0,245,32,32,0,0,751,23,728
360470944013,36, New York,047, Kings County,192,135,105,8,22,20,20,20,0,0,172,115,85,8,22,750,156,594
360470944014,36, New York,047, Kings County,65,0,0,0,0,0,0,0,0,0,65,0,0,0,0,171,18,153
360470944021,36, New York,047, Kings County,897,493,44,51,398,321,214,0,0,214,576,279,44,51,184,2050,558,1492
360470946001,36, New York,047, Kings County,173,54,39,0,15,0,0,0,0,0,173,54,39,0,15,513,0,513
360470946002,36, New York,047, Kings County,131,61,61,0,0,0,0,0,0,0,131,61,61,0,0,415,8,407
360470946003,36, New York,047, Kings County,284,71,25,37,9,34,0,0,0,0,250,71,25,37,9,741,59,682
360470950001,36, New York,047, Kings County,381,108,46,36,26,12,6,6,0,0,369,102,40,36,26,1194,24,1170
360470950002,36, New York,047, Kings County,387,87,47,7,33,14,0,0,0,0,373,87,47,7,33,1154,43,1111
360470954001,36, New York,047, Kings County,397,133,77,0,56,52,22,0,0,22,345,111,77,0,34,1048,104,944
360470954002,36, New York,047, Kings County,461,211,62,28,121,0,0,0,0,0,461,211,62,28,121,1496,12,1484
360470954003,36, New York,047, Kings County,235,122,64,17,41,28,28,11,17,0,207,94,53,0,41,683,62,621
360470956001,36, New York,047, Kings County,541,199,105,20,74,20,20,0,0,20,521,179,105,20,54,1614,32,1582
360470956002,36, New York,047, Kings County,619,144,33,21,90,48,0,0,0,0,571,144,33,21,90,1715,258,1457
360470958001,36, New York,047, Kings County,244,81,72,0,9,0,0,0,0,0,244,81,72,0,9,783,37,746
360470958002,36, New York,047, Kings County,610,226,60,70,96,116,84,0,0,84,494,142,60,70,12,1742,186,1556
360470960001,36, New York,047, Kings County,0,0,0,0,0,0,0,0,0,0,0,0,0,0,0,0,0,0
360470962001,36, New York,047, Kings County,331,197,59,0,138,25,20,0,0,20,306,177,59,0,118,757,45,712
360470964001,36, New York,047, Kings County,360,138,78,13,47,19,0,0,0,0,341,138,78,13,47,888,71,817
360470964002,36, New York,047, Kings County,288,217,122,59,36,17,17,0,0,17,271,200,122,59,19,852,110,742
360470966001,36, New York,047, Kings County,359,179,101,12,66,40,22,0,0,22,319,157,101,12,44,1058,249,809
360470966002,36, New York,047, Kings County,209,151,34,0,117,51,41,10,0,31,158,110,24,0,86,441,84,357
360470968001,36, New York,047, Kings County,179,111,78,16,17,0,0,0,0,0,179,111,78,16,17,470,18,452
360470968002,36, New York,047, Kings County,226,49,4,6,39,24,24,0,6,18,202,25,4,0,21,589,54,535
360470970001,36, New York,047, Kings County,433,106,63,7,36,13,5,5,0,0,420,101,58,7,36,1000,38,962
360470970002,36, New York,047, Kings County,261,161,29,0,132,59,44,0,0,44,202,117,29,0,88,648,76,572
360470974001,36, New York,047, Kings County,264,139,62,0,77,47,47,15,0,32,217,92,47,0,45,1180,384,796
360470974002,36, New York,047, Kings County,206,78,19,0,59,12,12,0,0,12,194,66,19,0,47,482,11,471
360470982001,36, New York,047, Kings County,658,433,70,0,363,241,183,15,0,168,417,250,55,0,195,1432,510,922
360470982002,36, New York,047, Kings County,567,207,0,43,164,268,152,0,0,152,299,55,0,43,12,1274,479,795
360470984001,36, New York,047, Kings County,518,142,99,0,43,37,0,0,0,0,481,142,99,0,43,1512,104,1408
360470986001,36, New York,047, Kings County,282,141,62,0,79,51,16,0,0,16,231,125,62,0,63,604,161,443
360470986002,36, New York,047, Kings County,407,101,79,0,22,0,0,0,0,0,407,101,79,0,22,1005,16,989
360470988001,36, New York,047, Kings County,243,147,128,0,19,0,0,0,0,0,243,147,128,0,19,650,16,634
360470988002,36, New York,047, Kings County,403,184,64,60,60,0,0,0,0,0,403,184,64,60,60,1100,80,1020
360470990001,36, New York,047, Kings County,400,205,110,14,81,12,8,0,0,8,388,197,110,14,73,1126,93,1033
360470992001,36, New York,047, Kings County,526,265,118,32,115,27,22,0,0,22,499,243,118,32,93,1556,267,1289
360470994001,36, New York,047, Kings County,500,263,102,36,125,53,41,0,0,41,447,222,102,36,84,1278,108,1170
360470996001,36, New York,047, Kings County,334,197,55,42,100,42,42,0,42,0,292,155,55,0,100,917,95,822
360470996002,36, New York,047, Kings County,507,270,215,0,55,0,0,0,0,0,507,270,215,0,55,991,0,991
360470998001,36, New York,047, Kings County,557,336,208,32,96,44,22,0,0,22,513,314,208,32,74,1682,65,1617
360470998002,36, New York,047, Kings County,360,200,95,0,105,32,20,0,0,20,328,180,95,0,85,977,81,896
360471004001,36, New York,047, Kings County,677,357,173,0,184,34,33,0,0,33,643,324,173,0,151,1941,64,1877
360471006001,36, New York,047, Kings County,303,150,53,25,72,17,17,9,0,8,286,133,44,25,64,568,39,529
360471006002,36, New York,047, Kings County,404,144,55,0,89,13,0,0,0,0,391,144,55,0,89,1247,102,1145
360471008001,36, New York,047, Kings County,264,170,68,31,71,32,32,0,11,21,232,138,68,20,50,771,38,733
360471008002,36, New York,047, Kings County,251,120,71,15,34,9,0,0,0,0,242,120,71,15,34,706,34,672
360471010001,36, New York,047, Kings County,289,153,32,13,108,74,20,0,0,20,215,133,32,13,88,847,157,690
360471010002,36, New York,047, Kings County,258,128,69,0,59,8,2,2,0,0,250,126,67,0,59,995,175,820
360471012001,36, New York,047, Kings County,397,172,145,21,6,0,0,0,0,0,397,172,145,21,6,1150,34,1116
360471012002,36, New York,047, Kings County,154,70,36,8,26,24,8,0,0,8,130,62,36,8,18,309,39,270
360471014001,36, New York,047, Kings County,291,127,101,8,18,13,0,0,0,0,278,127,101,8,18,854,96,758
360471014002,36, New York,047, Kings County,187,70,17,0,53,13,8,0,0,8,174,62,17,0,45,495,55,440
360471016001,36, New York,047, Kings County,418,168,82,21,65,5,5,0,0,5,413,163,82,21,60,1040,10,1030
360471018001,36, New York,047, Kings County,450,103,95,0,8,0,0,0,0,0,450,103,95,0,8,1531,25,1506
360471020001,36, New York,047, Kings County,574,175,94,0,81,49,25,0,0,25,525,150,94,0,56,1325,81,1244
360471022001,36, New York,047, Kings County,613,329,229,30,70,23,23,0,8,15,590,306,229,22,55,1526,33,1493
360471024001,36, New York,047, Kings County,488,220,93,30,97,43,23,0,23,0,445,197,93,7,97,1227,74,1153
360471026001,36, New York,047, Kings County,844,343,179,43,121,44,44,25,0,19,800,299,154,43,102,2160,173,1987
360471028011,36, New York,047, Kings County,265,101,25,35,41,5,5,0,0,5,260,96,25,35,36,1004,98,906
360471028020,36, New York,047, Kings County,0,0,0,0,0,0,0,0,0,0,0,0,0,0,0,0,0,0
360471028021,36, New York,047, Kings County,0,0,0,0,0,0,0,0,0,0,0,0,0,0,0,0,0,0
360471034011,36, New York,047, Kings County,634,430,0,33,397,299,228,0,13,215,335,202,0,20,182,1765,822,943
360471034012,36, New York,047, Kings County,402,323,26,66,231,185,154,13,66,75,217,169,13,0,156,969,391,578
360471034020,36, New York,047, Kings County,0,0,0,0,0,0,0,0,0,0,0,0,0,0,0,0,0,0
360471034021,36, New York,047, Kings County,0,0,0,0,0,0,0,0,0,0,0,0,0,0,0,0,0,0
360471058011,36, New York,047, Kings County,557,137,0,0,137,306,77,0,0,77,251,60,0,0,60,1491,767,724
360471058012,36, New York,047, Kings County,548,303,22,12,269,76,41,0,0,41,472,262,22,12,228,2205,520,1685
360471058013,36, New York,047, Kings County,287,20,0,0,20,16,0,0,0,0,271,20,0,0,20,1460,420,1040
360471058041,36, New York,047, Kings County,38,0,0,0,0,0,0,0,0,0,38,0,0,0,0,277,0,277
360471058042,36, New York,047, Kings County,277,0,0,0,0,86,0,0,0,0,191,0,0,0,0,863,469,394
360471058043,36, New York,047, Kings County,698,462,128,58,276,16,16,15,0,1,682,446,113,58,275,1920,179,1741
360471058044,36, New York,047, Kings County,790,480,76,0,404,152,122,12,0,110,638,358,64,0,294,1871,335,1536
360471070011,36, New York,047, Kings County,1099,624,158,69,397,135,114,8,0,106,964,510,150,69,291,2874,376,2498
360471070020,36, New York,047, Kings County,0,0,0,0,0,0,0,0,0,0,0,0,0,0,0,0,0,0
360471070021,36, New York,047, Kings County,0,0,0,0,0,0,0,0,0,0,0,0,0,0,0,0,0,0
360471070031,36, New York,047, Kings County,0,0,0,0,0,0,0,0,0,0,0,0,0,0,0,0,0,0
360471078001,36, New York,047, Kings County,148,42,0,0,42,13,13,0,0,13,135,29,0,0,29,520,75,445
360471078002,36, New York,047, Kings County,376,200,134,9,57,70,0,0,0,0,306,200,134,9,57,1130,214,916
360471078003,36, New York,047, Kings County,269,105,47,0,58,16,0,0,0,0,253,105,47,0,58,924,16,908
360471078004,36, New York,047, Kings County,199,29,29,0,0,0,0,0,0,0,199,29,29,0,0,749,27,722
360471098001,36, New York,047, Kings County,0,0,0,0,0,0,0,0,0,0,0,0,0,0,0,0,0,0
360471098002,36, New York,047, Kings County,242,145,43,23,79,0,0,0,0,0,242,145,43,23,79,722,196,526
360471098003,36, New York,047, Kings County,0,0,0,0,0,0,0,0,0,0,0,0,0,0,0,0,0,0
360471098004,36, New York,047, Kings County,0,0,0,0,0,0,0,0,0,0,0,0,0,0,0,0,0,0
360471098005,36, New York,047, Kings County,287,172,52,13,107,50,37,37,0,0,237,135,15,13,107,856,190,666
360471104001,36, New York,047, Kings County,253,99,60,0,39,14,14,0,0,14,239,85,60,0,25,688,54,634
360471104002,36, New York,047, Kings County,228,176,47,0,129,88,88,30,0,58,140,88,17,0,71,706,298,408
360471104003,36, New York,047, Kings County,305,116,38,58,20,38,38,38,0,0,267,78,0,58,20,1089,128,961
360471104004,36, New York,047, Kings County,335,155,72,0,83,34,19,0,0,19,301,136,72,0,64,1075,198,877
360471106001,36, New York,047, Kings County,637,341,110,0,231,187,151,110,0,41,450,190,0,0,190,1773,510,1263
360471106002,36, New York,047, Kings County,582,274,0,0,274,230,133,0,0,133,352,141,0,0,141,1688,676,1012
360471110001,36, New York,047, Kings County,465,170,12,0,158,104,45,12,0,33,361,125,0,0,125,1317,383,934
360471110002,36, New York,047, Kings County,384,172,13,16,143,54,17,0,0,17,330,155,13,16,126,937,268,669
360471116001,36, New York,047, Kings County,698,580,142,37,401,58,17,0,0,17,640,563,142,37,384,1792,200,1592
360471116002,36, New York,047, Kings County,292,31,9,0,22,75,0,0,0,0,217,31,9,0,22,819,157,662
360471118001,36, New York,047, Kings County,682,570,237,260,73,65,65,33,0,32,617,505,204,260,41,1329,198,1131
360471118002,36, New York,047, Kings County,358,145,32,33,80,70,32,32,0,0,288,113,0,33,80,1076,174,902
360471120001,36, New York,047, Kings County,335,111,84,0,27,27,27,0,0,27,308,84,84,0,0,958,150,808
360471120002,36, New York,047, Kings County,592,271,197,0,74,59,0,0,0,0,533,271,197,0,74,1559,207,1352
360471122001,36, New York,047, Kings County,482,241,70,0,171,70,28,0,0,28,412,213,70,0,143,1282,335,947
360471122002,36, New York,047, Kings County,221,44,14,0,30,83,0,0,0,0,138,44,14,0,30,797,507,290
360471124001,36, New York,047, Kings County,225,138,55,0,83,0,0,0,0,0,225,138,55,0,83,626,167,459
360471124002,36, New York,047, Kings County,189,110,61,49,0,0,0,0,0,0,189,110,61,49,0,891,0,891
360471124003,36, New York,047, Kings County,227,94,19,0,75,75,75,0,0,75,152,19,19,0,0,609,110,499
360471126001,36, New York,047, Kings County,255,90,71,0,19,77,19,0,0,19,178,71,71,0,0,1368,557,811
360471126002,36, New York,047, Kings County,229,107,35,0,72,49,49,0,0,49,180,58,35,0,23,723,131,592
360471126003,36, New York,047, Kings County,357,210,60,0,150,72,29,0,0,29,285,181,60,0,121,1051,105,946
360471128001,36, New York,047, Kings County,216,66,0,0,66,48,16,0,0,16,168,50,0,0,50,644,87,557
360471128002,36, New York,047, Kings County,405,141,42,69,30,48,0,0,0,0,357,141,42,69,30,1327,129,1198
360471128003,36, New York,047, Kings County,278,227,113,0,114,93,93,93,0,0,185,134,20,0,114,670,111,559
360471130001,36, New York,047, Kings County,164,98,0,0,98,48,48,0,0,48,116,50,0,0,50,378,85,293
360471130002,36, New York,047, Kings County,193,115,37,0,78,21,21,0,0,21,172,94,37,0,57,624,84,540
360471130003,36, New York,047, Kings County,281,201,89,28,84,63,63,0,0,63,218,138,89,28,21,791,172,619
360471130004,36, New York,047, Kings County,328,77,0,0,77,0,0,0,0,0,328,77,0,0,77,1144,13,1131
360471132001,36, New York,047, Kings County,312,206,86,0,120,77,77,0,0,77,235,129,86,0,43,823,170,653
360471132002,36, New York,047, Kings County,222,154,14,0,140,48,48,0,0,48,174,106,14,0,92,593,96,497
360471132003,36, New York,047, Kings County,0,0,0,0,0,0,0,0,0,0,0,0,0,0,0,0,0,0
360471134001,36, New York,047, Kings County,140,63,19,0,44,20,20,0,0,20,120,43,19,0,24,595,291,304
360471134002,36, New York,047, Kings County,139,104,18,41,45,90,79,0,41,38,49,25,18,0,7,522,242,280
360471134003,36, New York,047, Kings County,307,182,70,0,112,67,67,0,0,67,240,115,70,0,45,758,151,607
360471142011,36, New York,047, Kings County,197,106,79,27,0,0,0,0,0,0,197,106,79,27,0,710,8,702
360471142012,36, New York,047, Kings County,105,67,58,9,0,18,0,0,0,0,87,67,58,9,0,310,61,249
360471142021,36, New York,047, Kings County,411,242,38,60,144,161,127,0,0,127,250,115,38,60,17,827,303,524
360471142022,36, New York,047, Kings County,283,148,70,6,72,34,34,0,0,34,249,114,70,6,38,774,73,701
360471144001,36, New York,047, Kings County,65,11,0,0,11,11,11,0,0,11,54,0,0,0,0,415,240,175
360471144002,36, New York,047, Kings County,230,129,85,13,31,44,33,0,2,31,186,96,85,11,0,541,136,405
360471144003,36, New York,047, Kings County,222,36,36,0,0,34,25,25,0,0,188,11,11,0,0,538,138,400
360471144004,36, New York,047, Kings County,92,61,17,0,44,49,49,17,0,32,43,12,0,0,12,317,182,135
360471146001,36, New York,047, Kings County,275,111,68,0,43,21,21,0,0,21,254,90,68,0,22,837,156,681
360471146002,36, New York,047, Kings County,316,252,119,0,133,35,35,0,0,35,281,217,119,0,98,836,89,747
360471150001,36, New York,047, Kings County,275,173,26,54,93,44,24,0,0,24,231,149,26,54,69,792,97,695
360471150002,36, New York,047, Kings County,128,46,19,0,27,34,34,14,0,20,94,12,5,0,7,442,77,365
360471150003,36, New York,047, Kings County,203,137,66,0,71,0,0,0,0,0,203,137,66,0,71,511,45,466
360471152001,36, New York,047, Kings County,197,197,89,78,30,0,0,0,0,0,197,197,89,78,30,600,108,492
360471152002,36, New York,047, Kings County,395,171,78,0,93,63,34,0,0,34,332,137,78,0,59,1173,265,908
360471152003,36, New York,047, Kings County,57,39,39,0,0,0,0,0,0,0,57,39,39,0,0,232,47,185
360471156001,36, New York,047, Kings County,374,241,93,0,148,168,97,0,0,97,206,144,93,0,51,848,347,501
360471156002,36, New York,047, Kings County,364,253,44,0,209,101,101,0,0,101,263,152,44,0,108,803,245,558
360471156003,36, New York,047, Kings County,187,64,0,0,64,17,0,0,0,0,170,64,0,0,64,402,43,359
360471156004,36, New York,047, Kings County,246,211,55,0,156,90,90,0,0,90,156,121,55,0,66,555,195,360
360471158001,36, New York,047, Kings County,196,146,92,0,54,19,18,0,0,18,177,128,92,0,36,434,75,359
360471158002,36, New York,047, Kings County,211,65,2,14,49,75,2,0,0,2,136,63,2,14,47,531,129,402
360471158003,36, New York,047, Kings County,268,119,31,20,68,43,29,0,20,9,225,90,31,0,59,679,125,554
360471160001,36, New York,047, Kings County,345,197,52,32,113,77,27,0,0,27,268,170,52,32,86,945,256,689
360471160002,36, New York,047, Kings County,92,60,8,17,35,17,17,0,17,0,75,43,8,0,35,284,108,176
360471160003,36, New York,047, Kings County,224,132,112,8,12,23,23,15,8,0,201,109,97,0,12,550,30,520
360471162001,36, New York,047, Kings County,76,36,14,0,22,11,0,0,0,0,65,36,14,0,22,322,123,199
360471162002,36, New York,047, Kings County,246,159,42,53,64,98,70,17,53,0,148,89,25,0,64,811,248,563
360471162003,36, New York,047, Kings County,243,133,67,56,10,21,21,21,0,0,222,112,46,56,10,749,9,740
360471164001,36, New York,047, Kings County,229,196,31,45,120,0,0,0,0,0,229,196,31,45,120,532,9,523
360471164002,36, New York,047, Kings County,310,213,132,25,56,0,0,0,0,0,310,213,132,25,56,835,29,806
360471164003,36, New York,047, Kings County,382,121,40,20,61,128,106,34,20,52,254,15,6,0,9,1063,237,826
360471166001,36, New York,047, Kings County,356,190,106,42,42,94,35,0,0,35,262,155,106,42,7,484,150,334
360471166002,36, New York,047, Kings County,305,101,39,0,62,11,0,0,0,0,294,101,39,0,62,858,108,750
360471166003,36, New York,047, Kings County,185,136,101,0,35,35,35,0,0,35,150,101,101,0,0,437,114,323
360471168001,36, New York,047, Kings County,360,244,105,0,139,68,68,3,0,65,292,176,102,0,74,1030,88,942
360471168002,36, New York,047, Kings County,201,96,39,0,57,7,7,0,0,7,194,89,39,0,50,421,8,413
360471170001,36, New York,047, Kings County,435,165,93,0,72,184,76,18,0,58,251,89,75,0,14,791,373,418
360471170002,36, New York,047, Kings County,40,28,28,0,0,0,0,0,0,0,40,28,28,0,0,285,185,100
360471172011,36, New York,047, Kings County,364,189,143,0,46,82,72,35,0,37,282,117,108,0,9,903,153,750
360471172012,36, New York,047, Kings County,225,104,61,0,43,44,37,0,0,37,181,67,61,0,6,563,123,440
360471172021,36, New York,047, Kings County,371,206,69,0,137,29,29,0,0,29,342,177,69,0,108,1085,235,850
360471172022,36, New York,047, Kings County,685,297,81,116,100,85,35,19,0,16,600,262,62,116,84,2013,266,1747
360471174001,36, New York,047, Kings County,378,195,55,15,125,40,21,0,0,21,338,174,55,15,104,1095,100,995
360471174002,36, New York,047, Kings County,612,273,133,15,125,146,146,64,0,82,466,127,69,15,43,1645,327,1318
360471176011,36, New York,047, Kings County,367,204,154,16,34,12,0,0,0,0,355,204,154,16,34,923,25,898
360471176012,36, New York,047, Kings County,449,228,117,0,111,65,58,16,0,42,384,170,101,0,69,1115,113,1002
360471176021,36, New York,047, Kings County,345,160,50,0,110,39,24,0,0,24,306,136,50,0,86,1216,105,1111
360471176022,36, New York,047, Kings County,340,186,96,0,90,77,63,0,0,63,263,123,96,0,27,656,159,497
360471178001,36, New York,047, Kings County,469,269,201,0,68,30,25,0,0,25,439,244,201,0,43,1131,113,1018
360471180001,36, New York,047, Kings County,0,0,0,0,0,0,0,0,0,0,0,0,0,0,0,0,0,0
360471182011,36, New York,047, Kings County,469,260,174,13,73,57,5,0,0,5,412,255,174,13,68,1265,122,1143
360471182012,36, New York,047, Kings County,296,184,108,41,35,28,28,21,0,7,268,156,87,41,28,543,101,442
360471182021,36, New York,047, Kings County,413,266,167,11,88,76,76,0,0,76,337,190,167,11,12,858,107,751
360471182022,36, New York,047, Kings County,362,276,123,0,153,80,80,23,0,57,282,196,100,0,96,703,143,560
360471184001,36, New York,047, Kings County,390,315,82,0,233,57,27,0,0,27,333,288,82,0,206,745,81,664
360471184002,36, New York,047, Kings County,253,176,120,56,0,56,28,28,0,0,197,148,92,56,0,544,94,450
360471184003,36, New York,047, Kings County,507,228,157,0,71,27,0,0,0,0,480,228,157,0,71,1534,126,1408
360471186001,36, New York,047, Kings County,380,186,161,11,14,0,0,0,0,0,380,186,161,11,14,1171,15,1156
360471186002,36, New York,047, Kings County,247,119,39,46,34,20,20,0,20,0,227,99,39,26,34,1023,140,883
360471188001,36, New York,047, Kings County,224,193,132,14,47,65,51,25,0,26,159,142,107,14,21,662,81,581
360471188002,36, New York,047, Kings County,352,132,96,0,36,129,0,0,0,0,223,132,96,0,36,940,265,675
360471188003,36, New York,047, Kings County,383,184,138,0,46,44,44,44,0,0,339,140,94,0,46,1259,172,1087
360471190001,36, New York,047, Kings County,245,91,25,0,66,28,28,0,0,28,217,63,25,0,38,745,56,689
360471190002,36, New York,047, Kings County,179,140,34,13,93,131,119,26,0,93,48,21,8,13,0,474,224,250
360471192001,36, New York,047, Kings County,275,188,146,0,42,87,0,0,0,0,188,188,146,0,42,521,203,318
360471192002,36, New York,047, Kings County,328,183,85,0,98,99,70,13,0,57,229,113,72,0,41,1041,161,880
360471192003,36, New York,047, Kings County,217,155,47,19,89,33,33,0,0,33,184,122,47,19,56,667,80,587
360471194001,36, New York,047, Kings County,241,173,143,0,30,0,0,0,0,0,241,173,143,0,30,921,34,887
360471194002,36, New York,047, Kings County,505,364,103,94,167,123,94,19,0,75,382,270,84,94,92,1051,388,663
360471194003,36, New York,047, Kings County,259,135,96,0,39,0,0,0,0,0,259,135,96,0,39,1155,48,1107
360471196001,36, New York,047, Kings County,268,193,101,30,62,87,69,14,30,25,181,124,87,0,37,961,391,570
360471196002,36, New York,047, Kings County,326,141,97,18,26,26,0,0,0,0,300,141,97,18,26,609,64,545
360471196003,36, New York,047, Kings County,418,250,214,0,36,145,63,35,0,28,273,187,179,0,8,1279,283,996
360471196004,36, New York,047, Kings County,255,128,128,0,0,46,46,46,0,0,209,82,82,0,0,933,250,683
360471198001,36, New York,047, Kings County,292,292,74,84,134,155,155,21,0,134,137,137,53,84,0,597,299,298
360471198002,36, New York,047, Kings County,353,191,169,0,22,108,65,65,0,0,245,126,104,0,22,944,193,751
360471198003,36, New York,047, Kings County,140,95,95,0,0,85,40,40,0,0,55,55,55,0,0,834,479,355
360471200001,36, New York,047, Kings County,213,130,107,0,23,26,26,26,0,0,187,104,81,0,23,664,67,597
360471200002,36, New York,047, Kings County,247,163,84,29,50,20,20,20,0,0,227,143,64,29,50,984,259,725
360471202001,36, New York,047, Kings County,303,80,33,0,47,48,14,14,0,0,255,66,19,0,47,889,151,738
360471202002,36, New York,047, Kings County,153,35,27,8,0,6,6,6,0,0,147,29,21,8,0,545,26,519
360471208011,36, New York,047, Kings County,181,143,49,15,79,31,31,0,0,31,150,112,49,15,48,684,131,553
360471208012,36, New York,047, Kings County,325,137,53,2,82,55,24,0,0,24,270,113,53,2,58,836,187,649
360471208013,36, New York,047, Kings County,383,241,149,0,92,43,43,0,0,43,340,198,149,0,49,1117,141,976
360471208014,36, New York,047, Kings County,197,122,99,0,23,0,0,0,0,0,197,122,99,0,23,549,171,378
360471208021,36, New York,047, Kings County,691,488,85,0,403,248,214,16,0,198,443,274,69,0,205,2268,618,1650
360471208022,36, New York,047, Kings County,272,242,192,18,32,51,51,33,18,0,221,191,159,0,32,514,91,423
360471208031,36, New York,047, Kings County,340,115,78,0,37,16,0,0,0,0,324,115,78,0,37,1478,138,1340
360471210001,36, New York,047, Kings County,388,252,16,0,236,187,166,0,0,166,201,86,16,0,70,882,460,422
360471210002,36, New York,047, Kings County,734,473,59,19,395,409,242,0,19,223,325,231,59,0,172,1510,801,709
360471214001,36, New York,047, Kings County,689,482,83,0,399,338,259,73,0,186,351,223,10,0,213,1873,812,1061
360471214002,36, New York,047, Kings County,360,217,51,77,89,209,147,0,77,70,151,70,51,0,19,1033,591,442
360471220001,36, New York,047, Kings County,690,489,139,95,255,113,48,0,0,48,577,441,139,95,207,1837,564,1273
360471220002,36, New York,047, Kings County,1139,736,392,72,272,153,153,0,0,153,986,583,392,72,119,2646,335,2311
360471237001,36, New York,047, Kings County,164,129,129,0,0,116,96,96,0,0,48,33,33,0,0,547,338,209
360471237002,36, New York,047, Kings County,673,673,608,0,65,278,278,249,0,29,395,395,359,0,36,1611,721,890
360471237003,36, New York,047, Kings County,338,320,320,0,0,138,138,138,0,0,200,182,182,0,0,899,338,561
360471502001,36, New York,047, Kings County,266,124,124,0,0,0,0,0,0,0,266,124,124,0,0,551,0,551
360471502002,36, New York,047, Kings County,288,240,210,0,30,0,0,0,0,0,288,240,210,0,30,625,9,616
360471502003,36, New York,047, Kings County,172,106,99,0,7,15,15,8,0,7,157,91,91,0,0,481,22,459
360471522001,36, New York,047, Kings County,311,193,129,64,0,0,0,0,0,0,311,193,129,64,0,1030,7,1023
360471522002,36, New York,047, Kings County,582,451,400,0,51,0,0,0,0,0,582,451,400,0,51,977,17,960
360471522003,36, New York,047, Kings County,218,35,35,0,0,31,0,0,0,0,187,35,35,0,0,647,85,562
360479901000,36, New York,047, Kings County,0,0,0,0,0,0,0,0,0,0,0,0,0,0,0,0,0,0
360670001001,36, New York,067, Onondaga County,151,36,11,0,25,22,22,2,0,20,129,14,9,0,5,966,90,876
360670002001,36, New York,067, Onondaga County,630,275,85,75,115,160,147,46,32,69,470,128,39,43,46,1763,331,1432
360670002002,36, New York,067, Onondaga County,327,161,10,49,102,128,120,0,39,81,199,41,10,10,21,970,197,773
360670003001,36, New York,067, Onondaga County,110,55,33,8,14,15,15,7,0,8,95,40,26,8,6,452,35,417
360670003002,36, New York,067, Onondaga County,194,83,38,0,45,32,32,7,0,25,162,51,31,0,20,618,167,451
360670004001,36, New York,067, Onondaga County,362,64,36,0,28,19,12,12,0,0,343,52,24,0,28,1313,77,1236
360670004002,36, New York,067, Onondaga County,257,174,145,29,0,14,14,0,14,0,243,160,145,15,0,954,161,793
360670004003,36, New York,067, Onondaga County,316,54,54,0,0,14,14,14,0,0,302,40,40,0,0,980,87,893
360670005011,36, New York,067, Onondaga County,263,216,102,0,114,98,71,32,0,39,165,145,70,0,75,560,254,306
360670005012,36, New York,067, Onondaga County,125,76,63,0,13,23,23,23,0,0,102,53,40,0,13,544,181,363
360670006001,36, New York,067, Onondaga County,266,198,91,31,76,17,12,0,0,12,249,186,91,31,64,862,126,736
360670006002,36, New York,067, Onondaga County,141,48,0,12,36,36,36,0,0,36,105,12,0,12,0,474,151,323
360670006003,36, New York,067, Onondaga County,190,109,0,23,86,113,54,0,0,54,77,55,0,23,32,501,195,306
360670007001,36, New York,067, Onondaga County,174,140,27,22,91,50,50,7,0,43,124,90,20,22,48,432,124,308
360670007002,36, New York,067, Onondaga County,234,60,2,4,54,9,9,0,4,5,225,51,2,0,49,453,77,376
360670008001,36, New York,067, Onondaga County,390,288,77,81,130,71,71,39,0,32,319,217,38,81,98,1099,279,820
360670008002,36, New York,067, Onondaga County,297,155,120,0,35,76,61,26,0,35,221,94,94,0,0,944,323,621
360670009001,36, New York,067, Onondaga County,283,176,78,26,72,52,52,0,26,26,231,124,78,0,46,748,93,655
360670009002,36, New York,067, Onondaga County,400,138,117,0,21,0,0,0,0,0,400,138,117,0,21,914,42,872
360670009003,36, New York,067, Onondaga County,231,87,76,0,11,11,11,0,0,11,220,76,76,0,0,966,36,930
360670010001,36, New York,067, Onondaga County,257,82,0,22,60,23,6,0,0,6,234,76,0,22,54,951,167,784
360670010002,36, New York,067, Onondaga County,212,84,44,0,40,31,31,0,0,31,181,53,44,0,9,879,137,742
360670010003,36, New York,067, Onondaga County,289,143,33,0,110,115,115,16,0,99,174,28,17,0,11,736,180,556
360670010004,36, New York,067, Onondaga County,106,42,2,0,40,48,19,0,0,19,58,23,2,0,21,643,125,518
360670014001,36, New York,067, Onondaga County,150,117,35,0,82,59,59,0,0,59,91,58,35,0,23,271,56,215
360670014002,36, New York,067, Onondaga County,254,222,74,34,114,163,156,42,0,114,91,66,32,34,0,603,251,352
360670014003,36, New York,067, Onondaga County,92,17,17,0,0,0,0,0,0,0,92,17,17,0,0,358,43,315
360670015001,36, New York,067, Onondaga County,292,189,50,12,127,67,67,10,12,45,225,122,40,0,82,997,178,819
360670015002,36, New York,067, Onondaga County,179,101,50,0,51,45,45,20,0,25,134,56,30,0,26,374,125,249
360670016001,36, New York,067, Onondaga County,126,29,12,17,0,17,17,0,17,0,109,12,12,0,0,1171,315,856
360670016002,36, New York,067, Onondaga County,186,45,0,45,0,36,10,0,10,0,150,35,0,35,0,1289,423,866
360670017011,36, New York,067, Onondaga County,212,109,25,18,66,60,60,0,0,60,152,49,25,18,6,837,118,719
360670017012,36, New York,067, Onondaga County,303,142,83,0,59,87,59,0,0,59,216,83,83,0,0,1255,141,1114
360670017021,36, New York,067, Onondaga County,259,168,35,0,133,44,44,0,0,44,215,124,35,0,89,821,76,745
360670017022,36, New York,067, Onondaga County,369,235,84,51,100,88,82,0,51,31,281,153,84,0,69,979,239,740
360670018001,36, New York,067, Onondaga County,149,97,58,39,0,0,0,0,0,0,149,97,58,39,0,818,254,564
360670018002,36, New York,067, Onondaga County,95,70,19,0,51,11,11,0,0,11,84,59,19,0,40,396,20,376
360670018003,36, New York,067, Onondaga County,302,123,79,31,13,30,30,30,0,0,272,93,49,31,13,1166,90,1076
360670019001,36, New York,067, Onondaga County,296,140,86,20,34,0,0,0,0,0,296,140,86,20,34,572,28,544
360670019002,36, New York,067, Onondaga County,110,23,23,0,0,6,0,0,0,0,104,23,23,0,0,657,76,581
360670019003,36, New York,067, Onondaga County,232,98,67,0,31,28,28,23,0,5,204,70,44,0,26,740,76,664
360670019004,36, New York,067, Onondaga County,234,103,76,0,27,9,0,0,0,0,225,103,76,0,27,851,60,791
360670019005,36, New York,067, Onondaga County,219,0,0,0,0,0,0,0,0,0,219,0,0,0,0,605,38,567
360670020001,36, New York,067, Onondaga County,227,91,32,14,45,29,29,9,0,20,198,62,23,14,25,736,98,638
360670020002,36, New York,067, Onondaga County,220,114,75,19,20,62,52,21,11,20,158,62,54,8,0,790,227,563
360670021011,36, New York,067, Onondaga County,143,137,12,19,106,70,70,12,19,39,73,67,0,0,67,443,200,243
360670021012,36, New York,067, Onondaga County,234,164,16,29,119,109,102,0,0,102,125,62,16,29,17,1028,344,684
360670021013,36, New York,067, Onondaga County,110,73,12,0,61,55,55,12,0,43,55,18,0,0,18,421,149,272
360670023001,36, New York,067, Onondaga County,98,92,17,0,75,60,60,4,0,56,38,32,13,0,19,276,93,183
360670023002,36, New York,067, Onondaga County,33,0,0,0,0,0,0,0,0,0,33,0,0,0,0,819,294,525
360670024001,36, New York,067, Onondaga County,239,157,131,0,26,88,88,67,0,21,151,69,64,0,5,580,221,359
360670024002,36, New York,067, Onondaga County,235,6,6,0,0,6,6,6,0,0,229,0,0,0,0,723,89,634
360670027001,36, New York,067, Onondaga County,163,73,10,0,63,84,63,0,0,63,79,10,10,0,0,555,191,364
360670027002,36, New York,067, Onondaga County,226,62,26,11,25,32,27,0,7,20,194,35,26,4,5,889,126,763
360670029011,36, New York,067, Onondaga County,391,203,143,0,60,76,60,0,0,60,315,143,143,0,0,1773,259,1514
360670029012,36, New York,067, Onondaga County,52,17,17,0,0,21,0,0,0,0,31,17,17,0,0,710,117,593
360670030001,36, New York,067, Onondaga County,130,95,13,8,74,63,63,12,0,51,67,32,1,8,23,543,246,297
360670030002,36, New York,067, Onondaga County,237,139,15,17,107,73,53,0,17,36,164,86,15,0,71,657,192,465
360670032001,36, New York,067, Onondaga County,125,15,15,0,0,0,0,0,0,0,125,15,15,0,0,1570,344,1226
360670032002,36, New York,067, Onondaga County,129,37,37,0,0,70,0,0,0,0,59,37,37,0,0,562,299,263
360670034001,36, New York,067, Onondaga County,23,7,0,3,4,4,4,0,0,4,19,3,0,3,0,400,255,145
360670034002,36, New York,067, Onondaga County,181,100,0,81,19,6,0,0,0,0,175,100,0,81,19,544,188,356
360670035001,36, New York,067, Onondaga County,371,165,22,13,130,56,56,10,0,46,315,109,12,13,84,1415,415,1000
360670035002,36, New York,067, Onondaga County,33,33,0,0,33,0,0,0,0,0,33,33,0,0,33,306,155,151
360670036011,36, New York,067, Onondaga County,327,146,3,23,120,40,40,0,0,40,287,106,3,23,80,855,232,623
360670036012,36, New York,067, Onondaga County,213,145,40,30,75,61,57,32,9,16,152,88,8,21,59,554,115,439
360670036021,36, New York,067, Onondaga County,319,181,29,0,152,106,88,11,0,77,213,93,18,0,75,951,216,735
360670036022,36, New York,067, Onondaga County,241,152,103,39,10,0,0,0,0,0,241,152,103,39,10,842,39,803
360670038001,36, New York,067, Onondaga County,325,211,0,70,141,190,145,0,33,112,135,66,0,37,29,681,243,438
360670038002,36, New York,067, Onondaga County,176,108,21,0,87,79,67,0,0,67,97,41,21,0,20,563,233,330
360670039001,36, New York,067, Onondaga County,300,274,15,17,242,230,230,0,0,230,70,44,15,17,12,733,569,164
360670039002,36, New York,067, Onondaga County,193,160,0,34,126,111,111,0,34,77,82,49,0,0,49,541,117,424
360670039003,36, New York,067, Onondaga County,252,177,35,0,142,116,107,0,0,107,136,70,35,0,35,716,209,507
360670040001,36, New York,067, Onondaga County,294,209,41,10,158,155,140,16,0,124,139,69,25,10,34,821,355,466
360670042001,36, New York,067, Onondaga County,430,393,0,19,374,389,357,0,19,338,41,36,0,0,36,658,533,125
360670042002,36, New York,067, Onondaga County,280,166,29,0,137,151,89,0,0,89,129,77,29,0,48,878,583,295
360670043011,36, New York,067, Onondaga County,107,52,0,4,48,33,19,0,0,19,74,33,0,4,29,574,353,221
360670043021,36, New York,067, Onondaga County,3,0,0,0,0,0,0,0,0,0,3,0,0,0,0,203,127,76
360670043022,36, New York,067, Onondaga County,0,0,0,0,0,0,0,0,0,0,0,0,0,0,0,192,192,0
360670043023,36, New York,067, Onondaga County,22,9,9,0,0,9,9,9,0,0,13,0,0,0,0,585,345,240
360670043024,36, New York,067, Onondaga County,0,0,0,0,0,0,0,0,0,0,0,0,0,0,0,0,0,0
360670044011,36, New York,067, Onondaga County,65,51,40,0,11,11,11,0,0,11,54,40,40,0,0,470,228,242
360670044012,36, New York,067, Onondaga County,89,20,20,0,0,22,0,0,0,0,67,20,20,0,0,646,293,353
360670044013,36, New York,067, Onondaga County,384,176,44,107,25,52,25,0,0,25,332,151,44,107,0,1323,303,1020
360670045001,36, New York,067, Onondaga County,133,46,46,0,0,0,0,0,0,0,133,46,46,0,0,525,64,461
360670045002,36, New York,067, Onondaga County,67,13,13,0,0,0,0,0,0,0,67,13,13,0,0,386,179,207
360670045003,36, New York,067, Onondaga County,144,79,57,0,22,22,22,0,0,22,122,57,57,0,0,820,329,491
360670046001,36, New York,067, Onondaga County,209,48,27,21,0,21,21,0,21,0,188,27,27,0,0,775,28,747
360670046002,36, New York,067, Onondaga County,194,72,72,0,0,0,0,0,0,0,194,72,72,0,0,916,73,843
360670046003,36, New York,067, Onondaga County,221,102,102,0,0,0,0,0,0,0,221,102,102,0,0,621,40,581
360670046004,36, New York,067, Onondaga County,248,81,81,0,0,0,0,0,0,0,248,81,81,0,0,827,0,827
360670046005,36, New York,067, Onondaga County,98,25,25,0,0,0,0,0,0,0,98,25,25,0,0,332,5,327
360670048001,36, New York,067, Onondaga County,166,51,42,0,9,7,0,0,0,0,159,51,42,0,9,604,22,582
360670048002,36, New York,067, Onondaga County,201,44,24,20,0,0,0,0,0,0,201,44,24,20,0,690,43,647
360670049001,36, New York,067, Onondaga County,183,145,23,0,122,56,52,0,0,52,127,93,23,0,70,540,139,401
360670049002,36, New York,067, Onondaga County,298,117,63,0,54,34,34,0,0,34,264,83,63,0,20,708,91,617
360670050001,36, New York,067, Onondaga County,372,230,80,0,150,78,78,0,0,78,294,152,80,0,72,1012,131,881
360670050002,36, New York,067, Onondaga County,368,102,92,0,10,26,0,0,0,0,342,102,92,0,10,969,103,866
360670051001,36, New York,067, Onondaga County,120,104,0,24,80,50,50,0,0,50,70,54,0,24,30,243,90,153
360670051002,36, New York,067, Onondaga County,279,196,19,0,177,146,146,0,0,146,133,50,19,0,31,732,382,350
360670051003,36, New York,067, Onondaga County,108,67,35,0,32,42,32,0,0,32,66,35,35,0,0,532,139,393
360670052001,36, New York,067, Onondaga County,360,266,128,50,88,47,47,20,0,27,313,219,108,50,61,1022,253,769
360670052002,36, New York,067, Onondaga County,96,76,9,0,67,13,13,0,0,13,83,63,9,0,54,261,39,222
360670053001,36, New York,067, Onondaga County,137,76,76,0,0,0,0,0,0,0,137,76,76,0,0,336,0,336
360670053002,36, New York,067, Onondaga County,310,149,45,29,75,175,88,18,29,41,135,61,27,0,34,810,329,481
360670054001,36, New York,067, Onondaga County,271,174,18,22,134,147,126,0,22,104,124,48,18,0,30,686,331,355
360670054002,36, New York,067, Onondaga County,421,255,10,8,237,92,70,0,8,62,329,185,10,0,175,859,279,580
360670055001,36, New York,067, Onondaga County,88,5,5,0,0,23,5,5,0,0,65,0,0,0,0,505,129,376
360670055002,36, New York,067, Onondaga County,210,133,58,0,75,24,24,8,0,16,186,109,50,0,59,842,108,734
360670055003,36, New York,067, Onondaga County,297,129,48,0,81,10,0,0,0,0,287,129,48,0,81,1112,236,876
360670056011,36, New York,067, Onondaga County,337,119,82,25,12,18,18,0,18,0,319,101,82,7,12,1284,137,1147
360670056021,36, New York,067, Onondaga County,22,6,6,0,0,0,0,0,0,0,22,6,6,0,0,171,105,66
360670057001,36, New York,067, Onondaga County,265,115,61,0,54,18,6,0,0,6,247,109,61,0,48,760,117,643
360670057002,36, New York,067, Onondaga County,242,158,62,45,51,112,70,0,36,34,130,88,62,9,17,666,235,431
360670058001,36, New York,067, Onondaga County,146,91,8,0,83,51,51,8,0,43,95,40,0,0,40,384,145,239
360670058002,36, New York,067, Onondaga County,105,27,0,0,27,27,27,0,0,27,78,0,0,0,0,390,95,295
360670058003,36, New York,067, Onondaga County,346,267,31,34,202,214,207,15,34,158,132,60,16,0,44,630,301,329
360670059001,36, New York,067, Onondaga County,179,54,21,0,33,42,12,12,0,0,137,42,9,0,33,552,163,389
360670059002,36, New York,067, Onondaga County,291,201,0,22,179,32,22,0,22,0,259,179,0,0,179,472,61,411
360670060001,36, New York,067, Onondaga County,100,56,32,24,0,10,10,10,0,0,90,46,22,24,0,505,55,450
360670060002,36, New York,067, Onondaga County,136,35,35,0,0,9,0,0,0,0,127,35,35,0,0,432,62,370
360670060003,36, New York,067, Onondaga County,239,78,0,0,78,0,0,0,0,0,239,78,0,0,78,798,36,762
360670060004,36, New York,067, Onondaga County,323,255,144,0,111,146,146,63,0,83,177,109,81,0,28,725,211,514
360670061011,36, New York,067, Onondaga County,239,151,33,0,118,94,94,0,0,94,145,57,33,0,24,874,359,515
360670061012,36, New York,067, Onondaga County,171,67,17,13,37,37,37,0,0,37,134,30,17,13,0,472,125,347
360670061013,36, New York,067, Onondaga County,468,361,48,98,215,155,155,0,52,103,313,206,48,46,112,1079,329,750
360670061021,36, New York,067, Onondaga County,15,0,0,0,0,3,0,0,0,0,12,0,0,0,0,846,216,630
360670061022,36, New York,067, Onondaga County,202,91,58,0,33,40,21,0,0,21,162,70,58,0,12,637,91,546
360670061031,36, New York,067, Onondaga County,427,138,115,23,0,0,0,0,0,0,427,138,115,23,0,1517,31,1486
360670061032,36, New York,067, Onondaga County,56,1,1,0,0,15,0,0,0,0,41,1,1,0,0,328,117,211
360670101001,36, New York,067, Onondaga County,253,122,101,7,14,7,7,0,7,0,246,115,101,0,14,691,28,663
360670101002,36, New York,067, Onondaga County,500,176,138,8,30,17,0,0,0,0,483,176,138,8,30,1413,85,1328
360670102001,36, New York,067, Onondaga County,299,133,121,12,0,0,0,0,0,0,299,133,121,12,0,916,13,903
360670102002,36, New York,067, Onondaga County,350,102,54,23,25,0,0,0,0,0,350,102,54,23,25,862,0,862
360670102003,36, New York,067, Onondaga County,550,132,68,38,26,0,0,0,0,0,550,132,68,38,26,1367,28,1339
360670102004,36, New York,067, Onondaga County,588,402,81,112,209,203,203,0,17,186,385,199,81,95,23,1287,321,966
360670103011,36, New York,067, Onondaga County,222,109,68,21,20,0,0,0,0,0,222,109,68,21,20,582,14,568
360670103012,36, New York,067, Onondaga County,184,47,12,35,0,12,12,12,0,0,172,35,0,35,0,524,59,465
360670103013,36, New York,067, Onondaga County,440,135,100,0,35,30,19,0,0,19,410,116,100,0,16,1179,58,1121
360670103014,36, New York,067, Onondaga County,243,82,0,23,59,24,24,0,0,24,219,58,0,23,35,845,70,775
360670103015,36, New York,067, Onondaga County,468,202,89,0,113,44,44,0,0,44,424,158,89,0,69,1246,95,1151
360670103211,36, New York,067, Onondaga County,305,102,102,0,0,0,0,0,0,0,305,102,102,0,0,992,15,977
360670103212,36, New York,067, Onondaga County,530,274,260,0,14,0,0,0,0,0,530,274,260,0,14,1295,0,1295
360670103221,36, New York,067, Onondaga County,440,161,119,1,41,11,11,0,0,11,429,150,119,1,30,1106,18,1088
360670103222,36, New York,067, Onondaga County,321,205,171,13,21,0,0,0,0,0,321,205,171,13,21,852,11,841
360670103223,36, New York,067, Onondaga County,219,88,88,0,0,0,0,0,0,0,219,88,88,0,0,560,5,555
360670104001,36, New York,067, Onondaga County,473,231,178,7,46,43,10,10,0,0,430,221,168,7,46,1259,159,1100
360670104002,36, New York,067, Onondaga County,630,341,312,11,18,23,11,11,0,0,607,330,301,11,18,1672,73,1599
360670105001,36, New York,067, Onondaga County,389,215,195,6,14,5,0,0,0,0,384,215,195,6,14,1015,31,984
360670105002,36, New York,067, Onondaga County,312,102,71,13,18,17,0,0,0,0,295,102,71,13,18,837,50,787
360670106001,36, New York,067, Onondaga County,256,57,27,0,30,15,15,0,0,15,241,42,27,0,15,774,23,751
360670106002,36, New York,067, Onondaga County,362,70,41,15,14,40,6,0,0,6,322,64,41,15,8,1104,121,983
360670107001,36, New York,067, Onondaga County,195,105,37,39,29,25,18,0,18,0,170,87,37,21,29,608,89,519
360670107002,36, New York,067, Onondaga County,318,75,49,18,8,0,0,0,0,0,318,75,49,18,8,1038,115,923
360670108001,36, New York,067, Onondaga County,149,72,34,0,38,27,27,0,0,27,122,45,34,0,11,767,207,560
360670108002,36, New York,067, Onondaga County,91,56,56,0,0,29,29,29,0,0,62,27,27,0,0,719,62,657
360670108003,36, New York,067, Onondaga County,432,111,60,51,0,64,0,0,0,0,368,111,60,51,0,1357,183,1174
360670108004,36, New York,067, Onondaga County,353,208,74,0,134,33,21,0,0,21,320,187,74,0,113,869,173,696
360670109001,36, New York,067, Onondaga County,344,104,47,19,38,42,42,15,6,21,302,62,32,13,17,883,96,787
360670109002,36, New York,067, Onondaga County,389,151,93,44,14,43,38,9,29,0,346,113,84,15,14,1180,110,1070
360670110111,36, New York,067, Onondaga County,221,67,36,0,31,31,31,0,0,31,190,36,36,0,0,554,95,459
360670110112,36, New York,067, Onondaga County,155,22,22,0,0,0,0,0,0,0,155,22,22,0,0,504,34,470
360670110113,36, New York,067, Onondaga County,298,103,59,44,0,9,0,0,0,0,289,103,59,44,0,1094,146,948
360670110114,36, New York,067, Onondaga County,210,82,23,32,27,0,0,0,0,0,210,82,23,32,27,1020,47,973
360670110121,36, New York,067, Onondaga County,293,139,116,13,10,14,14,14,0,0,279,125,102,13,10,734,62,672
360670110122,36, New York,067, Onondaga County,349,159,149,0,10,0,0,0,0,0,349,159,149,0,10,1035,27,1008
360670110123,36, New York,067, Onondaga County,306,152,64,39,49,0,0,0,0,0,306,152,64,39,49,1316,74,1242
360670110211,36, New York,067, Onondaga County,291,166,24,97,45,57,45,0,0,45,234,121,24,97,0,703,109,594
360670110212,36, New York,067, Onondaga County,503,184,161,11,12,44,32,32,0,0,459,152,129,11,12,1401,145,1256
360670110221,36, New York,067, Onondaga County,379,108,31,31,46,17,17,0,0,17,362,91,31,31,29,1128,103,1025
360670110222,36, New York,067, Onondaga County,555,123,99,7,17,10,10,10,0,0,545,113,89,7,17,1613,86,1527
360670111011,36, New York,067, Onondaga County,293,105,105,0,0,0,0,0,0,0,293,105,105,0,0,820,24,796
360670111012,36, New York,067, Onondaga County,299,165,85,29,51,0,0,0,0,0,299,165,85,29,51,1009,165,844
360670111013,36, New York,067, Onondaga County,327,161,111,9,41,39,0,0,0,0,288,161,111,9,41,883,101,782
360670111014,36, New York,067, Onondaga County,161,72,72,0,0,0,0,0,0,0,161,72,72,0,0,470,0,470
360670111015,36, New York,067, Onondaga County,374,166,141,16,9,50,0,0,0,0,324,166,141,16,9,1008,140,868
360670111021,36, New York,067, Onondaga County,244,209,10,146,53,140,140,0,106,34,104,69,10,40,19,628,149,479
360670111022,36, New York,067, Onondaga County,365,163,83,65,15,0,0,0,0,0,365,163,83,65,15,1495,86,1409
360670111023,36, New York,067, Onondaga County,157,89,37,0,52,21,0,0,0,0,136,89,37,0,52,423,55,368
360670112011,36, New York,067, Onondaga County,287,238,35,13,190,109,109,0,0,109,178,129,35,13,81,585,126,459
360670112012,36, New York,067, Onondaga County,321,192,75,17,100,112,112,58,17,37,209,80,17,0,63,803,198,605
360670112013,36, New York,067, Onondaga County,398,172,160,0,12,0,0,0,0,0,398,172,160,0,12,1027,11,1016
360670112014,36, New York,067, Onondaga County,195,16,16,0,0,0,0,0,0,0,195,16,16,0,0,914,76,838
360670112021,36, New York,067, Onondaga County,449,237,178,11,48,12,12,0,0,12,437,225,178,11,36,1350,24,1326
360670112022,36, New York,067, Onondaga County,504,181,174,0,7,0,0,0,0,0,504,181,174,0,7,1339,8,1331
360670112023,36, New York,067, Onondaga County,147,40,22,0,18,10,0,0,0,0,137,40,22,0,18,600,92,508
360670112311,36, New York,067, Onondaga County,248,112,112,0,0,0,0,0,0,0,248,112,112,0,0,717,5,712
360670112312,36, New York,067, Onondaga County,460,238,179,18,41,22,9,0,9,0,438,229,179,9,41,1443,111,1332
360670112313,36, New York,067, Onondaga County,389,170,107,30,33,0,0,0,0,0,389,170,107,30,33,1290,230,1060
360670112321,36, New York,067, Onondaga County,493,232,189,9,34,21,5,0,0,5,472,227,189,9,29,1334,130,1204
360670112322,36, New York,067, Onondaga County,350,165,146,7,12,0,0,0,0,0,350,165,146,7,12,994,31,963
360670112323,36, New York,067, Onondaga County,365,92,92,0,0,0,0,0,0,0,365,92,92,0,0,1078,7,1071
360670112411,36, New York,067, Onondaga County,201,98,81,8,9,0,0,0,0,0,201,98,81,8,9,493,5,488
360670112412,36, New York,067, Onondaga County,528,187,162,11,14,5,5,0,0,5,523,182,162,11,9,1346,17,1329
360670112421,36, New York,067, Onondaga County,171,61,61,0,0,0,0,0,0,0,171,61,61,0,0,488,3,485
360670112422,36, New York,067, Onondaga County,203,137,111,7,19,0,0,0,0,0,203,137,111,7,19,610,36,574
360670112423,36, New York,067, Onondaga County,748,320,225,81,14,0,0,0,0,0,748,320,225,81,14,1696,14,1682
360670112424,36, New York,067, Onondaga County,600,307,269,12,26,0,0,0,0,0,600,307,269,12,26,1699,61,1638
360670113001,36, New York,067, Onondaga County,136,83,83,0,0,0,0,0,0,0,136,83,83,0,0,376,0,376
360670113002,36, New York,067, Onondaga County,383,139,118,12,9,0,0,0,0,0,383,139,118,12,9,1137,28,1109
360670113003,36, New York,067, Onondaga County,184,49,49,0,0,0,0,0,0,0,184,49,49,0,0,627,48,579
360670113004,36, New York,067, Onondaga County,347,130,130,0,0,0,0,0,0,0,347,130,130,0,0,1141,46,1095
360670114011,36, New York,067, Onondaga County,256,0,0,0,0,0,0,0,0,0,256,0,0,0,0,704,0,704
360670114012,36, New York,067, Onondaga County,273,151,76,0,75,77,53,0,0,53,196,98,76,0,22,993,230,763
360670114013,36, New York,067, Onondaga County,237,98,98,0,0,12,0,0,0,0,225,98,98,0,0,777,71,706
360670114014,36, New York,067, Onondaga County,584,312,312,0,0,10,0,0,0,0,574,312,312,0,0,1377,19,1358
360670114015,36, New York,067, Onondaga County,574,242,242,0,0,0,0,0,0,0,574,242,242,0,0,1552,21,1531
360670114021,36, New York,067, Onondaga County,304,97,43,0,54,54,54,0,0,54,250,43,43,0,0,788,86,702
360670114022,36, New York,067, Onondaga County,200,111,78,23,10,26,0,0,0,0,174,111,78,23,10,525,63,462
360670114023,36, New York,067, Onondaga County,435,174,127,20,27,0,0,0,0,0,435,174,127,20,27,1070,0,1070
360670114024,36, New York,067, Onondaga County,357,148,136,0,12,0,0,0,0,0,357,148,136,0,12,805,31,774
360670115001,36, New York,067, Onondaga County,577,228,104,38,86,0,0,0,0,0,577,228,104,38,86,1548,0,1548
360670115002,36, New York,067, Onondaga County,551,279,146,0,133,84,0,0,0,0,467,279,146,0,133,1506,280,1226
360670115003,36, New York,067, Onondaga County,573,336,298,0,38,17,0,0,0,0,556,336,298,0,38,1199,34,1165
360670115004,36, New York,067, Onondaga County,143,61,61,0,0,16,0,0,0,0,127,61,61,0,0,351,31,320
360670116001,36, New York,067, Onondaga County,265,29,29,0,0,22,0,0,0,0,243,29,29,0,0,677,71,606
360670116002,36, New York,067, Onondaga County,494,273,273,0,0,0,0,0,0,0,494,273,273,0,0,1564,43,1521
360670116003,36, New York,067, Onondaga County,576,363,294,42,27,0,0,0,0,0,576,363,294,42,27,1461,59,1402
360670116004,36, New York,067, Onondaga County,130,74,25,13,36,13,13,0,13,0,117,61,25,0,36,450,63,387
360670117001,36, New York,067, Onondaga County,618,269,203,37,29,66,66,0,37,29,552,203,203,0,0,2056,234,1822
360670117002,36, New York,067, Onondaga County,419,205,128,35,42,22,22,11,0,11,397,183,117,35,31,1315,67,1248
360670118001,36, New York,067, Onondaga County,272,32,8,12,12,0,0,0,0,0,272,32,8,12,12,853,21,832
360670118002,36, New York,067, Onondaga County,343,153,72,15,66,28,28,0,0,28,315,125,72,15,38,1194,135,1059
360670118003,36, New York,067, Onondaga County,213,96,53,22,21,34,21,0,0,21,179,75,53,22,0,970,96,874
360670118004,36, New York,067, Onondaga County,258,137,59,6,72,49,49,0,0,49,209,88,59,6,23,853,71,782
360670118005,36, New York,067, Onondaga County,385,87,23,0,64,14,0,0,0,0,371,87,23,0,64,1176,167,1009
360670119001,36, New York,067, Onondaga County,338,200,115,7,78,9,9,0,0,9,329,191,115,7,69,794,47,747
360670119002,36, New York,067, Onondaga County,260,58,58,0,0,0,0,0,0,0,260,58,58,0,0,736,9,727
360670119003,36, New York,067, Onondaga County,297,133,74,0,59,0,0,0,0,0,297,133,74,0,59,755,0,755
360670119004,36, New York,067, Onondaga County,203,78,50,0,28,7,0,0,0,0,196,78,50,0,28,451,15,436
360670120001,36, New York,067, Onondaga County,129,27,27,0,0,0,0,0,0,0,129,27,27,0,0,403,0,403
360670120002,36, New York,067, Onondaga County,521,193,144,10,39,27,24,10,0,14,494,169,134,10,25,1469,123,1346
360670120003,36, New York,067, Onondaga County,381,137,0,0,137,101,101,0,0,101,280,36,0,0,36,1069,274,795
360670120004,36, New York,067, Onondaga County,572,303,194,8,101,53,53,0,0,53,519,250,194,8,48,1416,145,1271
360670121001,36, New York,067, Onondaga County,425,316,281,0,35,41,16,16,0,0,384,300,265,0,35,1004,57,947
360670121002,36, New York,067, Onondaga County,258,103,94,0,9,0,0,0,0,0,258,103,94,0,9,564,21,543
360670121003,36, New York,067, Onondaga County,549,193,175,18,0,0,0,0,0,0,549,193,175,18,0,1336,67,1269
360670121004,36, New York,067, Onondaga County,187,70,60,10,0,10,10,0,10,0,177,60,60,0,0,649,56,593
360670122001,36, New York,067, Onondaga County,230,118,67,16,35,36,29,7,6,16,194,89,60,10,19,1014,105,909
360670123001,36, New York,067, Onondaga County,296,192,186,6,0,0,0,0,0,0,296,192,186,6,0,710,2,708
360670123002,36, New York,067, Onondaga County,718,206,156,25,25,23,6,0,0,6,695,200,156,25,19,2166,86,2080
360670124001,36, New York,067, Onondaga County,381,68,24,16,28,52,17,0,0,17,329,51,24,16,11,1201,146,1055
360670124002,36, New York,067, Onondaga County,186,48,23,25,0,8,0,0,0,0,178,48,23,25,0,583,57,526
360670124003,36, New York,067, Onondaga County,348,90,78,12,0,21,7,7,0,0,327,83,71,12,0,875,76,799
360670124004,36, New York,067, Onondaga County,194,104,104,0,0,0,0,0,0,0,194,104,104,0,0,765,198,567
360670125001,36, New York,067, Onondaga County,281,93,43,26,24,25,0,0,0,0,256,93,43,26,24,776,68,708
360670125002,36, New York,067, Onondaga County,427,123,78,9,36,54,35,24,0,11,373,88,54,9,25,1170,98,1072
360670125003,36, New York,067, Onondaga County,263,147,59,12,76,33,33,0,0,33,230,114,59,12,43,907,56,851
360670126001,36, New York,067, Onondaga County,250,64,42,0,22,36,22,0,0,22,214,42,42,0,0,764,49,715
360670126002,36, New York,067, Onondaga County,561,343,223,0,120,0,0,0,0,0,561,343,223,0,120,1491,0,1491
360670126003,36, New York,067, Onondaga County,213,59,44,0,15,0,0,0,0,0,213,59,44,0,15,871,22,849
360670126004,36, New York,067, Onondaga County,375,163,163,0,0,0,0,0,0,0,375,163,163,0,0,1050,64,986
360670127001,36, New York,067, Onondaga County,216,31,23,0,8,4,0,0,0,0,212,31,23,0,8,600,18,582
360670127002,36, New York,067, Onondaga County,344,162,97,0,65,36,31,0,0,31,308,131,97,0,34,1178,109,1069
360670128001,36, New York,067, Onondaga County,277,130,121,9,0,0,0,0,0,0,277,130,121,9,0,860,10,850
360670128002,36, New York,067, Onondaga County,181,85,85,0,0,0,0,0,0,0,181,85,85,0,0,624,42,582
360670128003,36, New York,067, Onondaga County,260,69,25,13,31,0,0,0,0,0,260,69,25,13,31,795,34,761
360670129001,36, New York,067, Onondaga County,365,247,73,0,174,8,0,0,0,0,357,247,73,0,174,931,90,841
360670129002,36, New York,067, Onondaga County,300,222,39,95,88,56,56,0,0,56,244,166,39,95,32,626,104,522
360670130001,36, New York,067, Onondaga County,247,73,73,0,0,0,0,0,0,0,247,73,73,0,0,621,0,621
360670130002,36, New York,067, Onondaga County,215,100,49,0,51,78,78,38,0,40,137,22,11,0,11,684,164,520
360670130003,36, New York,067, Onondaga County,480,205,153,41,11,17,6,6,0,0,463,199,147,41,11,1153,60,1093
360670130004,36, New York,067, Onondaga County,130,24,24,0,0,0,0,0,0,0,130,24,24,0,0,576,55,521
360670131001,36, New York,067, Onondaga County,267,64,64,0,0,0,0,0,0,0,267,64,64,0,0,770,20,750
360670131002,36, New York,067, Onondaga County,278,118,84,0,34,9,0,0,0,0,269,118,84,0,34,766,38,728
360670131003,36, New York,067, Onondaga County,447,234,171,10,53,0,0,0,0,0,447,234,171,10,53,1084,9,1075
360670131004,36, New York,067, Onondaga County,284,121,63,37,21,0,0,0,0,0,284,121,63,37,21,794,26,768
360670132001,36, New York,067, Onondaga County,315,112,42,0,70,25,0,0,0,0,290,112,42,0,70,936,117,819
360670132002,36, New York,067, Onondaga County,520,228,153,13,62,7,7,7,0,0,513,221,146,13,62,1351,43,1308
360670133001,36, New York,067, Onondaga County,145,58,33,3,22,27,19,0,0,19,118,39,33,3,3,504,80,424
360670133002,36, New York,067, Onondaga County,174,70,57,5,8,28,28,25,0,3,146,42,32,5,5,544,81,463
360670133003,36, New York,067, Onondaga County,279,94,70,4,20,7,7,0,0,7,272,87,70,4,13,819,30,789
360670134001,36, New York,067, Onondaga County,186,35,35,0,0,18,0,0,0,0,168,35,35,0,0,565,91,474
360670134002,36, New York,067, Onondaga County,480,219,196,23,0,0,0,0,0,0,480,219,196,23,0,1958,98,1860
360670134003,36, New York,067, Onondaga County,269,96,76,0,20,0,0,0,0,0,269,96,76,0,20,657,0,657
360670134004,36, New York,067, Onondaga County,388,173,78,0,95,49,49,0,0,49,339,124,78,0,46,1227,135,1092
360670135001,36, New York,067, Onondaga County,222,95,36,21,38,0,0,0,0,0,222,95,36,21,38,720,53,667
360670135002,36, New York,067, Onondaga County,604,191,191,0,0,26,0,0,0,0,578,191,191,0,0,1650,52,1598
360670135003,36, New York,067, Onondaga County,302,157,94,52,11,11,11,0,0,11,291,146,94,52,0,1015,69,946
360670135004,36, New York,067, Onondaga County,61,0,0,0,0,0,0,0,0,0,61,0,0,0,0,421,13,408
360670136001,36, New York,067, Onondaga County,217,108,75,0,33,0,0,0,0,0,217,108,75,0,33,832,38,794
360670136002,36, New York,067, Onondaga County,169,56,0,0,56,24,24,0,0,24,145,32,0,0,32,805,176,629
360670136003,36, New York,067, Onondaga County,256,165,81,18,66,71,71,22,0,49,185,94,59,18,17,939,209,730
360670137011,36, New York,067, Onondaga County,187,76,0,0,76,0,0,0,0,0,187,76,0,0,76,570,52,518
360670137012,36, New York,067, Onondaga County,417,161,115,0,46,16,16,0,0,16,401,145,115,0,30,1786,71,1715
360670137013,36, New York,067, Onondaga County,158,73,41,0,32,31,0,0,0,0,127,73,41,0,32,373,106,267
360670137014,36, New York,067, Onondaga County,195,56,56,0,0,0,0,0,0,0,195,56,56,0,0,824,0,824
360670138001,36, New York,067, Onondaga County,228,138,96,16,26,13,13,13,0,0,215,125,83,16,26,788,126,662
360670138002,36, New York,067, Onondaga County,253,65,42,14,9,6,6,6,0,0,247,59,36,14,9,855,81,774
360670139001,36, New York,067, Onondaga County,384,224,146,19,59,23,23,0,0,23,361,201,146,19,36,1226,62,1164
360670139002,36, New York,067, Onondaga County,232,93,62,31,0,25,16,16,0,0,207,77,46,31,0,710,93,617
360670140001,36, New York,067, Onondaga County,326,121,47,18,56,0,0,0,0,0,326,121,47,18,56,1011,86,925
360670140002,36, New York,067, Onondaga County,287,126,52,11,63,18,18,0,0,18,269,108,52,11,45,1051,69,982
360670140003,36, New York,067, Onondaga County,187,106,75,14,17,0,0,0,0,0,187,106,75,14,17,589,109,480
360670142001,36, New York,067, Onondaga County,337,130,77,0,53,40,33,0,0,33,297,97,77,0,20,968,52,916
360670142002,36, New York,067, Onondaga County,262,143,78,20,45,31,20,0,20,0,231,123,78,0,45,943,55,888
360670142003,36, New York,067, Onondaga County,476,252,79,36,137,106,106,47,0,59,370,146,32,36,78,1344,194,1150
360670143001,36, New York,067, Onondaga County,245,115,42,13,60,12,12,0,0,12,233,103,42,13,48,1041,141,900
360670143002,36, New York,067, Onondaga County,172,36,18,11,7,8,8,8,0,0,164,28,10,11,7,592,31,561
360670143003,36, New York,067, Onondaga County,264,177,120,15,42,29,28,0,0,28,235,149,120,15,14,787,30,757
360670144001,36, New York,067, Onondaga County,175,83,37,20,26,17,13,0,0,13,158,70,37,20,13,578,27,551
360670144002,36, New York,067, Onondaga County,92,26,8,18,0,0,0,0,0,0,92,26,8,18,0,382,113,269
360670144003,36, New York,067, Onondaga County,180,77,65,11,1,1,1,0,0,1,179,76,65,11,0,653,60,593
360670145001,36, New York,067, Onondaga County,231,89,63,17,9,9,9,0,0,9,222,80,63,17,0,549,9,540
360670145002,36, New York,067, Onondaga County,484,191,132,9,50,44,26,14,0,12,440,165,118,9,38,1832,221,1611
360670145003,36, New York,067, Onondaga County,175,48,0,0,48,27,13,0,0,13,148,35,0,0,35,869,60,809
360670146001,36, New York,067, Onondaga County,501,388,131,45,212,77,66,10,0,56,424,322,121,45,156,1378,210,1168
360670146002,36, New York,067, Onondaga County,127,70,34,0,36,0,0,0,0,0,127,70,34,0,36,361,33,328
360670146003,36, New York,067, Onondaga County,150,62,44,7,11,0,0,0,0,0,150,62,44,7,11,380,25,355
360670146004,36, New York,067, Onondaga County,199,97,67,0,30,0,0,0,0,0,199,97,67,0,30,598,10,588
360670147001,36, New York,067, Onondaga County,255,135,135,0,0,0,0,0,0,0,255,135,135,0,0,672,5,667
360670147002,36, New York,067, Onondaga County,394,114,114,0,0,0,0,0,0,0,394,114,114,0,0,1323,16,1307
360670147003,36, New York,067, Onondaga County,310,71,35,16,20,91,0,0,0,0,219,71,35,16,20,723,173,550
360670147004,36, New York,067, Onondaga County,443,162,150,0,12,0,0,0,0,0,443,162,150,0,12,1166,15,1151
360670147005,36, New York,067, Onondaga County,370,263,224,25,14,37,31,17,0,14,333,232,207,25,0,973,90,883
360670148001,36, New York,067, Onondaga County,175,62,53,0,9,0,0,0,0,0,175,62,53,0,9,508,0,508
360670148002,36, New York,067, Onondaga County,426,195,179,0,16,10,10,0,0,10,416,185,179,0,6,1209,135,1074
360670148003,36, New York,067, Onondaga County,339,134,119,0,15,9,0,0,0,0,330,134,119,0,15,977,53,924
360670149001,36, New York,067, Onondaga County,468,214,201,8,5,23,10,10,0,0,445,204,191,8,5,1278,102,1176
360670150001,36, New York,067, Onondaga County,171,94,47,9,38,8,8,0,0,8,163,86,47,9,30,541,71,470
360670150002,36, New York,067, Onondaga County,241,122,98,19,5,0,0,0,0,0,241,122,98,19,5,607,16,591
360670150003,36, New York,067, Onondaga County,382,220,163,12,45,0,0,0,0,0,382,220,163,12,45,1113,17,1096
360670150004,36, New York,067, Onondaga County,460,230,186,12,32,9,0,0,0,0,451,230,186,12,32,981,27,954
360670151001,36, New York,067, Onondaga County,340,114,114,0,0,0,0,0,0,0,340,114,114,0,0,1050,0,1050
360670151002,36, New York,067, Onondaga County,172,112,112,0,0,0,0,0,0,0,172,112,112,0,0,509,0,509
360670151003,36, New York,067, Onondaga County,407,133,77,43,13,44,44,31,0,13,363,89,46,43,0,1430,101,1329
360670151004,36, New York,067, Onondaga County,289,154,121,0,33,17,17,0,0,17,272,137,121,0,16,961,86,875
360670151005,36, New York,067, Onondaga County,306,147,54,53,40,0,0,0,0,0,306,147,54,53,40,826,29,797
360670152011,36, New York,067, Onondaga County,552,232,176,25,31,0,0,0,0,0,552,232,176,25,31,1324,30,1294
360670152012,36, New York,067, Onondaga County,532,110,91,0,19,37,0,0,0,0,495,110,91,0,19,1386,100,1286
360670152021,36, New York,067, Onondaga County,749,399,355,15,29,32,19,19,0,0,717,380,336,15,29,1753,108,1645
360670152022,36, New York,067, Onondaga County,514,217,168,14,35,11,11,11,0,0,503,206,157,14,35,1441,83,1358
360670152031,36, New York,067, Onondaga County,369,207,184,15,8,0,0,0,0,0,369,207,184,15,8,785,32,753
360670152032,36, New York,067, Onondaga County,516,161,161,0,0,0,0,0,0,0,516,161,161,0,0,1347,29,1318
360670154001,36, New York,067, Onondaga County,474,233,160,17,56,15,15,0,0,15,459,218,160,17,41,1177,72,1105
360670154002,36, New York,067, Onondaga County,426,174,128,17,29,15,15,0,0,15,411,159,128,17,14,1376,80,1296
360670154003,36, New York,067, Onondaga County,325,123,92,31,0,15,15,0,15,0,310,108,92,16,0,1020,31,989
360670154004,36, New York,067, Onondaga County,339,133,87,34,12,0,0,0,0,0,339,133,87,34,12,843,34,809
360670155001,36, New York,067, Onondaga County,467,166,123,0,43,9,0,0,0,0,458,166,123,0,43,1222,52,1170
360670155002,36, New York,067, Onondaga County,412,107,78,0,29,6,0,0,0,0,406,107,78,0,29,1127,36,1091
360670156011,36, New York,067, Onondaga County,320,120,61,49,10,0,0,0,0,0,320,120,61,49,10,879,40,839
360670156012,36, New York,067, Onondaga County,339,130,63,12,55,0,0,0,0,0,339,130,63,12,55,772,10,762
360670156021,36, New York,067, Onondaga County,284,223,201,7,15,0,0,0,0,0,284,223,201,7,15,714,40,674
360670156022,36, New York,067, Onondaga County,173,32,32,0,0,0,0,0,0,0,173,32,32,0,0,470,7,463
360670157011,36, New York,067, Onondaga County,571,87,57,0,30,0,0,0,0,0,571,87,57,0,30,1380,6,1374
360670157012,36, New York,067, Onondaga County,181,77,63,14,0,0,0,0,0,0,181,77,63,14,0,538,18,520
360670157021,36, New York,067, Onondaga County,601,320,309,11,0,0,0,0,0,0,601,320,309,11,0,1684,10,1674
360670157022,36, New York,067, Onondaga County,300,0,0,0,0,0,0,0,0,0,300,0,0,0,0,781,87,694
360670157023,36, New York,067, Onondaga County,228,29,12,17,0,0,0,0,0,0,228,29,12,17,0,567,0,567
360670157024,36, New York,067, Onondaga County,260,148,145,3,0,14,14,14,0,0,246,134,131,3,0,642,37,605
360670158001,36, New York,067, Onondaga County,518,262,208,29,25,0,0,0,0,0,518,262,208,29,25,1876,72,1804
360670158002,36, New York,067, Onondaga County,189,109,78,0,31,0,0,0,0,0,189,109,78,0,31,572,7,565
360670158003,36, New York,067, Onondaga County,325,122,122,0,0,0,0,0,0,0,325,122,122,0,0,879,41,838
360670158004,36, New York,067, Onondaga County,244,72,31,0,41,23,0,0,0,0,221,72,31,0,41,521,51,470
360670160011,36, New York,067, Onondaga County,520,179,161,0,18,13,5,5,0,0,507,174,156,0,18,1266,68,1198
360670160012,36, New York,067, Onondaga County,135,22,22,0,0,0,0,0,0,0,135,22,22,0,0,587,33,554
360670160013,36, New York,067, Onondaga County,316,105,75,11,19,18,18,7,11,0,298,87,68,0,19,848,33,815
360670160021,36, New York,067, Onondaga County,397,161,139,0,22,0,0,0,0,0,397,161,139,0,22,1071,12,1059
360670160022,36, New York,067, Onondaga County,441,127,124,3,0,0,0,0,0,0,441,127,124,3,0,1172,8,1164
360670161001,36, New York,067, Onondaga County,649,328,296,9,23,9,9,0,0,9,640,319,296,9,14,1524,45,1479
360670162001,36, New York,067, Onondaga County,187,110,71,26,13,6,0,0,0,0,181,110,71,26,13,578,49,529
360670162002,36, New York,067, Onondaga County,429,213,94,39,80,19,19,10,0,9,410,194,84,39,71,1155,88,1067
360670163001,36, New York,067, Onondaga County,281,171,171,0,0,0,0,0,0,0,281,171,171,0,0,900,0,900
360670163002,36, New York,067, Onondaga County,364,126,126,0,0,0,0,0,0,0,364,126,126,0,0,888,0,888
360670163003,36, New York,067, Onondaga County,84,52,34,0,18,0,0,0,0,0,84,52,34,0,18,486,29,457
360670163004,36, New York,067, Onondaga County,66,19,0,0,19,0,0,0,0,0,66,19,0,0,19,584,69,515
360670163005,36, New York,067, Onondaga County,606,182,146,0,36,0,0,0,0,0,606,182,146,0,36,1557,0,1557
360670163006,36, New York,067, Onondaga County,360,185,151,34,0,1,0,0,0,0,359,185,151,34,0,892,30,862
360670164001,36, New York,067, Onondaga County,163,105,56,49,0,0,0,0,0,0,163,105,56,49,0,496,45,451
360670164002,36, New York,067, Onondaga County,367,179,145,8,26,0,0,0,0,0,367,179,145,8,26,912,8,904
360670164003,36, New York,067, Onondaga County,486,264,134,26,104,0,0,0,0,0,486,264,134,26,104,1580,90,1490
360670165011,36, New York,067, Onondaga County,489,196,167,13,16,18,18,10,0,8,471,178,157,13,8,1433,90,1343
360670165021,36, New York,067, Onondaga County,245,181,104,38,39,7,7,0,0,7,238,174,104,38,32,735,80,655
360670165022,36, New York,067, Onondaga County,390,93,51,20,22,8,0,0,0,0,382,93,51,20,22,1086,43,1043
360670165023,36, New York,067, Onondaga County,229,86,38,13,35,13,13,0,0,13,216,73,38,13,22,761,47,714
360670165024,36, New York,067, Onondaga County,336,69,61,0,8,0,0,0,0,0,336,69,61,0,8,855,18,837
360670166001,36, New York,067, Onondaga County,219,85,77,0,8,0,0,0,0,0,219,85,77,0,8,722,18,704
360670166002,36, New York,067, Onondaga County,431,205,150,0,55,19,19,0,0,19,412,186,150,0,36,1266,63,1203
360670166003,36, New York,067, Onondaga County,532,184,126,13,45,8,8,0,0,8,524,176,126,13,37,1459,69,1390
360670167001,36, New York,067, Onondaga County,415,47,35,0,12,13,0,0,0,0,402,47,35,0,12,1037,41,996
360670167002,36, New York,067, Onondaga County,190,132,110,0,22,16,16,9,0,7,174,116,101,0,15,480,43,437
360670167003,36, New York,067, Onondaga County,184,51,45,0,6,0,0,0,0,0,184,51,45,0,6,494,27,467
360670168011,36, New York,067, Onondaga County,337,108,94,11,3,6,0,0,0,0,331,108,94,11,3,958,29,929
360670168012,36, New York,067, Onondaga County,228,47,36,0,11,2,2,0,0,2,226,45,36,0,9,536,8,528
360670168021,36, New York,067, Onondaga County,225,66,53,0,13,10,10,10,0,0,215,56,43,0,13,632,47,585
360670168022,36, New York,067, Onondaga County,448,183,177,6,0,6,6,0,6,0,442,177,177,0,0,1271,38,1233
360670169011,36, New York,067, Onondaga County,204,101,78,12,11,0,0,0,0,0,204,101,78,12,11,464,23,441
360670169012,36, New York,067, Onondaga County,302,107,71,0,36,16,0,0,0,0,286,107,71,0,36,771,58,713
360670169013,36, New York,067, Onondaga County,215,110,75,14,21,21,11,4,0,7,194,99,71,14,14,786,102,684
360670169021,36, New York,067, Onondaga County,310,71,43,9,19,17,3,0,0,3,293,68,43,9,16,852,73,779
360670169022,36, New York,067, Onondaga County,309,103,62,4,37,2,2,0,0,2,307,101,62,4,35,837,41,796
360679400001,36, New York,067, Onondaga County,86,44,0,20,24,24,24,0,0,24,62,20,0,20,0,316,78,238
360379401001,36, New York,037, Genesee County,86,20,0,12,8,8,8,0,0,8,78,12,0,12,0,305,65,240
360379501001,36, New York,037, Genesee County,233,101,54,47,0,0,0,0,0,0,233,101,54,47,0,674,14,660
360379501002,36, New York,037, Genesee County,377,136,133,0,3,29,3,0,0,3,348,133,133,0,0,1078,113,965
360379501003,36, New York,037, Genesee County,254,122,81,10,31,18,16,4,0,12,236,106,77,10,19,777,82,695
360379501004,36, New York,037, Genesee County,157,64,54,10,0,3,0,0,0,0,154,64,54,10,0,448,17,431
360379501005,36, New York,037, Genesee County,177,74,52,15,7,17,0,0,0,0,160,74,52,15,7,465,59,406
360379501006,36, New York,037, Genesee County,173,89,80,9,0,0,0,0,0,0,173,89,80,9,0,473,11,462
360379502001,36, New York,037, Genesee County,398,166,114,27,25,22,18,0,13,5,376,148,114,14,20,975,48,927
360379502002,36, New York,037, Genesee County,184,86,62,15,9,8,7,0,7,0,176,79,62,8,9,494,30,464
360379502003,36, New York,037, Genesee County,223,106,69,14,23,15,12,8,0,4,208,94,61,14,19,757,120,637
360379502004,36, New York,037, Genesee County,659,259,102,113,44,93,93,0,93,0,566,166,102,20,44,1687,310,1377
360379503011,36, New York,037, Genesee County,530,153,36,33,84,68,47,0,0,47,462,106,36,33,37,1649,207,1442
360379503012,36, New York,037, Genesee County,255,67,67,0,0,1,0,0,0,0,254,67,67,0,0,880,70,810
360379503021,36, New York,037, Genesee County,250,78,63,10,5,9,9,7,0,2,241,69,56,10,3,719,65,654
360379503022,36, New York,037, Genesee County,220,122,62,35,25,16,9,0,6,3,204,113,62,29,22,639,71,568
360379503023,36, New York,037, Genesee County,399,109,104,3,2,33,0,0,0,0,366,109,104,3,2,1162,109,1053
360379504011,36, New York,037, Genesee County,391,194,138,28,28,47,47,19,0,28,344,147,119,28,0,1351,166,1185
360379504012,36, New York,037, Genesee County,270,115,86,0,29,16,16,0,0,16,254,99,86,0,13,928,131,797
360379504021,36, New York,037, Genesee County,224,93,93,0,0,0,0,0,0,0,224,93,93,0,0,585,6,579
360379504022,36, New York,037, Genesee County,154,111,101,10,0,0,0,0,0,0,154,111,101,10,0,520,24,496
360379504023,36, New York,037, Genesee County,721,208,104,0,104,79,39,0,0,39,642,169,104,0,65,1588,166,1422
360379505011,36, New York,037, Genesee County,340,134,93,14,27,3,3,0,3,0,337,131,93,11,27,1102,145,957
360379505021,36, New York,037, Genesee County,304,138,86,0,52,18,0,0,0,0,286,138,86,0,52,796,101,695
360379506001,36, New York,037, Genesee County,200,66,46,7,13,6,6,0,0,6,194,60,46,7,7,655,48,607
360379506002,36, New York,037, Genesee County,170,55,27,0,28,3,0,0,0,0,167,55,27,0,28,774,166,608
360379507001,36, New York,037, Genesee County,107,53,41,0,12,4,4,0,0,4,103,49,41,0,8,1067,215,852
360379507002,36, New York,037, Genesee County,280,100,48,0,52,31,31,0,0,31,249,69,48,0,21,761,76,685
360379508001,36, New York,037, Genesee County,244,80,31,34,15,11,0,0,0,0,233,80,31,34,15,895,46,849
360379508002,36, New York,037, Genesee County,120,67,17,9,41,0,0,0,0,0,120,67,17,9,41,424,44,380
360379508003,36, New York,037, Genesee County,447,199,96,86,17,33,0,0,0,0,414,199,96,86,17,1136,145,991
360379509001,36, New York,037, Genesee County,314,157,120,0,37,16,16,0,0,16,298,141,120,0,21,1261,129,1132
360379509002,36, New York,037, Genesee County,229,28,19,0,9,0,0,0,0,0,229,28,19,0,9,1000,135,865
360379510001,36, New York,037, Genesee County,331,80,39,15,26,27,21,0,0,21,304,59,39,15,5,1172,246,926
360379510002,36, New York,037, Genesee County,344,144,94,0,50,71,12,0,0,12,273,132,94,0,38,1062,206,856
360379511001,36, New York,037, Genesee County,473,143,102,41,0,0,0,0,0,0,473,143,102,41,0,1232,21,1211
360379511002,36, New York,037, Genesee County,345,216,170,38,8,0,0,0,0,0,345,216,170,38,8,996,16,980
360379511003,36, New York,037, Genesee County,234,103,56,21,26,21,18,0,0,18,213,85,56,21,8,525,38,487
360379511004,36, New York,037, Genesee County,433,169,127,10,32,0,0,0,0,0,433,169,127,10,32,1187,119,1068
360379512001,36, New York,037, Genesee County,226,122,91,1,30,34,14,14,0,0,192,108,77,1,30,713,140,573
360379512002,36, New York,037, Genesee County,572,207,180,0,27,14,0,0,0,0,558,207,180,0,27,1535,62,1473
360379512003,36, New York,037, Genesee County,213,107,84,0,23,12,12,0,0,12,201,95,84,0,11,775,233,542
360379512004,36, New York,037, Genesee County,185,73,26,0,47,9,9,0,0,9,176,64,26,0,38,719,98,621
360379513001,36, New York,037, Genesee County,216,97,69,12,16,7,7,7,0,0,209,90,62,12,16,663,77,586
360379513002,36, New York,037, Genesee County,196,92,68,16,8,20,20,15,0,5,176,72,53,16,3,530,43,487
360379513003,36, New York,037, Genesee County,278,145,80,19,46,31,24,0,14,10,247,121,80,5,36,642,91,551
360379513004,36, New York,037, Genesee County,380,122,65,24,33,20,16,0,0,16,360,106,65,24,17,1081,91,990
360379514001,36, New York,037, Genesee County,386,210,182,0,28,6,2,2,0,0,380,208,180,0,28,1004,41,963
360379514002,36, New York,037, Genesee County,268,148,114,16,18,19,15,3,7,5,249,133,111,9,13,842,55,787
360379514003,36, New York,037, Genesee County,383,84,84,0,0,0,0,0,0,0,383,84,84,0,0,1049,13,1036
360379514004,36, New York,037, Genesee County,267,92,92,0,0,0,0,0,0,0,267,92,92,0,0,793,13,780
360379514005,36, New York,037, Genesee County,224,75,53,22,0,0,0,0,0,0,224,75,53,22,0,593,14,579
360359701001,36, New York,035, Fulton County,270,49,44,0,5,12,0,0,0,0,258,49,44,0,5,866,89,777
360359701002,36, New York,035, Fulton County,189,68,52,0,16,9,5,0,0,5,180,63,52,0,11,504,35,469
360359701003,36, New York,035, Fulton County,278,75,71,0,4,34,28,28,0,0,244,47,43,0,4,821,129,692
360359702001,36, New York,035, Fulton County,365,152,84,3,65,28,28,2,2,24,337,124,82,1,41,1108,98,1010
360359702002,36, New York,035, Fulton County,17,13,9,4,0,8,8,4,4,0,9,5,5,0,0,48,25,23
360359702003,36, New York,035, Fulton County,156,27,22,5,0,19,6,6,0,0,137,21,16,5,0,668,57,611
360359702004,36, New York,035, Fulton County,90,78,78,0,0,58,46,46,0,0,32,32,32,0,0,291,173,118
360359703001,36, New York,035, Fulton County,330,194,83,20,91,20,16,0,0,16,310,178,83,20,75,1095,88,1007
360359703002,36, New York,035, Fulton County,134,44,44,0,0,0,0,0,0,0,134,44,44,0,0,358,18,340
360359703003,36, New York,035, Fulton County,607,122,56,24,42,185,0,0,0,0,422,122,56,24,42,1488,353,1135
360359704001,36, New York,035, Fulton County,263,40,15,16,9,15,0,0,0,0,248,40,15,16,9,779,75,704
360359704002,36, New York,035, Fulton County,216,76,42,16,18,11,0,0,0,0,205,76,42,16,18,647,48,599
360359705001,36, New York,035, Fulton County,290,79,66,11,2,35,11,0,11,0,255,68,66,0,2,847,91,756
360359705002,36, New York,035, Fulton County,104,45,31,0,14,19,14,0,0,14,85,31,31,0,0,319,35,284
360359705003,36, New York,035, Fulton County,174,65,45,12,8,25,15,7,0,8,149,50,38,12,0,645,155,490
360359705004,36, New York,035, Fulton County,243,120,90,7,23,39,24,7,5,12,204,96,83,2,11,702,104,598
360359705005,36, New York,035, Fulton County,230,106,99,0,7,11,0,0,0,0,219,106,99,0,7,628,50,578
360359706011,36, New York,035, Fulton County,226,67,67,0,0,9,0,0,0,0,217,67,67,0,0,598,37,561
360359706012,36, New York,035, Fulton County,278,130,54,64,12,12,12,0,0,12,266,118,54,64,0,610,38,572
360359706013,36, New York,035, Fulton County,322,155,83,28,44,15,0,0,0,0,307,155,83,28,44,873,77,796
360359706014,36, New York,035, Fulton County,75,75,0,0,75,75,75,0,0,75,0,0,0,0,0,350,202,148
360359706021,36, New York,035, Fulton County,16,0,0,0,0,0,0,0,0,0,16,0,0,0,0,31,0,31
360359706022,36, New York,035, Fulton County,261,131,109,0,22,0,0,0,0,0,261,131,109,0,22,605,8,597
360359706023,36, New York,035, Fulton County,664,256,249,7,0,7,0,0,0,0,657,256,249,7,0,1646,73,1573
360359707001,36, New York,035, Fulton County,103,39,39,0,0,0,0,0,0,0,103,39,39,0,0,330,13,317
360359707002,36, New York,035, Fulton County,313,122,42,57,23,57,41,18,0,23,256,81,24,57,0,960,211,749
360359707003,36, New York,035, Fulton County,176,38,38,0,0,27,10,10,0,0,149,28,28,0,0,691,116,575
360359707004,36, New York,035, Fulton County,215,184,83,21,80,16,16,0,9,7,199,168,83,12,73,673,168,505
360359708001,36, New York,035, Fulton County,141,79,30,0,49,8,8,0,0,8,133,71,30,0,41,423,50,373
360359708002,36, New York,035, Fulton County,286,162,21,20,121,110,101,0,0,101,176,61,21,20,20,757,265,492
360359708003,36, New York,035, Fulton County,44,2,0,0,2,18,2,0,0,2,26,0,0,0,0,206,85,121
360359708004,36, New York,035, Fulton County,251,173,43,0,130,12,12,0,0,12,239,161,43,0,118,703,90,613
360359709001,36, New York,035, Fulton County,231,151,69,71,11,71,71,0,71,0,160,80,69,0,11,725,145,580
360359709002,36, New York,035, Fulton County,183,47,47,0,0,0,0,0,0,0,183,47,47,0,0,495,0,495
360359709003,36, New York,035, Fulton County,315,103,93,0,10,104,56,56,0,0,211,47,37,0,10,1090,467,623
360359709004,36, New York,035, Fulton County,195,74,0,0,74,54,46,0,0,46,141,28,0,0,28,634,140,494
360359710001,36, New York,035, Fulton County,242,47,38,0,9,0,0,0,0,0,242,47,38,0,9,936,114,822
360359710002,36, New York,035, Fulton County,210,60,60,0,0,0,0,0,0,0,210,60,60,0,0,490,0,490
360359710003,36, New York,035, Fulton County,178,74,29,34,11,0,0,0,0,0,178,74,29,34,11,588,73,515
360359711001,36, New York,035, Fulton County,198,61,0,0,61,40,20,0,0,20,158,41,0,0,41,630,83,547
360359711002,36, New York,035, Fulton County,216,113,90,0,23,35,25,25,0,0,181,88,65,0,23,649,104,545
360359711003,36, New York,035, Fulton County,251,128,34,24,70,19,5,0,5,0,232,123,34,19,70,710,128,582
360359712001,36, New York,035, Fulton County,234,96,66,14,16,0,0,0,0,0,234,96,66,14,16,979,150,829
360359712002,36, New York,035, Fulton County,245,105,75,0,30,10,0,0,0,0,235,105,75,0,30,739,119,620
360359712003,36, New York,035, Fulton County,240,140,35,69,36,69,69,0,69,0,171,71,35,0,36,850,76,774
360359712004,36, New York,035, Fulton County,130,82,25,7,50,0,0,0,0,0,130,82,25,7,50,630,107,523
360359713001,36, New York,035, Fulton County,211,109,27,82,0,0,0,0,0,0,211,109,27,82,0,543,19,524
360359713002,36, New York,035, Fulton County,183,37,6,0,31,0,0,0,0,0,183,37,6,0,31,565,20,545
360359713003,36, New York,035, Fulton County,291,133,41,39,53,19,19,0,0,19,272,114,41,39,34,791,19,772
360359713004,36, New York,035, Fulton County,353,112,91,0,21,0,0,0,0,0,353,112,91,0,21,1013,34,979
360359713005,36, New York,035, Fulton County,141,95,57,0,38,0,0,0,0,0,141,95,57,0,38,498,97,401
360359714001,36, New York,035, Fulton County,279,96,42,0,54,51,51,0,0,51,228,45,42,0,3,940,200,740
360359714002,36, New York,035, Fulton County,276,139,93,21,25,6,6,0,0,6,270,133,93,21,19,728,53,675
360359714003,36, New York,035, Fulton County,354,220,168,30,22,16,16,0,7,9,338,204,168,23,13,929,24,905
360359715011,36, New York,035, Fulton County,450,162,83,0,79,0,0,0,0,0,450,162,83,0,79,1136,15,1121
360359715012,36, New York,035, Fulton County,443,224,139,37,48,17,13,0,0,13,426,211,139,37,35,1309,84,1225
360359715021,36, New York,035, Fulton County,32,0,0,0,0,0,0,0,0,0,32,0,0,0,0,187,21,166
360359715022,36, New York,035, Fulton County,205,67,44,23,0,23,23,0,23,0,182,44,44,0,0,784,93,691
360359715023,36, New York,035, Fulton County,104,33,17,0,16,25,16,0,0,16,79,17,17,0,0,236,51,185
360359715024,36, New York,035, Fulton County,201,54,7,47,0,17,0,0,0,0,184,54,7,47,0,615,49,566
360610001001,36, New York,061, New York County,0,0,0,0,0,0,0,0,0,0,0,0,0,0,0,0,0,0
360610002010,36, New York,061, New York County,0,0,0,0,0,0,0,0,0,0,0,0,0,0,0,0,0,0
360610002011,36, New York,061, New York County,239,122,9,26,87,71,71,9,26,36,168,51,0,0,51,536,77,459
360610002012,36, New York,061, New York County,353,204,58,20,126,152,120,0,0,120,201,84,58,20,6,802,291,511
360610002020,36, New York,061, New York County,0,0,0,0,0,0,0,0,0,0,0,0,0,0,0,0,0,0
360610002021,36, New York,061, New York County,209,34,12,0,22,29,22,0,0,22,180,12,12,0,0,569,165,404
360610002022,36, New York,061, New York County,497,249,0,0,249,265,116,0,0,116,232,133,0,0,133,1246,597,649
360610002023,36, New York,061, New York County,177,45,0,0,45,46,29,0,0,29,131,16,0,0,16,640,328,312
360610002024,36, New York,061, New York County,373,133,121,0,12,15,0,0,0,0,358,133,121,0,12,1482,135,1347
360610002025,36, New York,061, New York County,0,0,0,0,0,0,0,0,0,0,0,0,0,0,0,0,0,0
360610002026,36, New York,061, New York County,314,118,70,0,48,0,0,0,0,0,314,118,70,0,48,1450,363,1087
360610005000,36, New York,061, New York County,0,0,0,0,0,0,0,0,0,0,0,0,0,0,0,0,0,0
360610005001,36, New York,061, New York County,0,0,0,0,0,0,0,0,0,0,0,0,0,0,0,0,0,0
360610005002,36, New York,061, New York County,0,0,0,0,0,0,0,0,0,0,0,0,0,0,0,0,0,0
360610006000,36, New York,061, New York County,0,0,0,0,0,0,0,0,0,0,0,0,0,0,0,0,0,0
360610006001,36, New York,061, New York County,292,117,86,17,14,237,88,71,17,0,55,29,15,0,14,1153,570,583
360610006002,36, New York,061, New York County,673,188,63,0,125,198,39,0,0,39,475,149,63,0,86,2624,889,1735
360610006003,36, New York,061, New York County,70,0,0,0,0,25,0,0,0,0,45,0,0,0,0,418,0,418
360610006004,36, New York,061, New York County,191,131,131,0,0,30,30,30,0,0,161,101,101,0,0,432,171,261
360610006005,36, New York,061, New York County,457,117,0,0,117,262,90,0,0,90,195,27,0,0,27,1119,593,526
360610006006,36, New York,061, New York County,755,127,37,22,68,43,43,0,0,43,712,84,37,22,25,2047,701,1346
360610007000,36, New York,061, New York County,0,0,0,0,0,0,0,0,0,0,0,0,0,0,0,0,0,0
360610007001,36, New York,061, New York County,42,0,0,0,0,0,0,0,0,0,42,0,0,0,0,243,0,243
360610007002,36, New York,061, New York County,301,208,161,0,47,0,0,0,0,0,301,208,161,0,47,1325,75,1250
360610007003,36, New York,061, New York County,94,46,0,0,46,0,0,0,0,0,94,46,0,0,46,582,0,582
360610007004,36, New York,061, New York County,457,158,158,0,0,0,0,0,0,0,457,158,158,0,0,1290,5,1285
360610007005,36, New York,061, New York County,94,0,0,0,0,0,0,0,0,0,94,0,0,0,0,1663,34,1629
360610007006,36, New York,061, New York County,205,163,84,0,79,0,0,0,0,0,205,163,84,0,79,1112,36,1076
360610007007,36, New York,061, New York County,5,0,0,0,0,0,0,0,0,0,5,0,0,0,0,543,230,313
360610007008,36, New York,061, New York County,0,0,0,0,0,0,0,0,0,0,0,0,0,0,0,0,0,0
360610007009,36, New York,061, New York County,0,0,0,0,0,0,0,0,0,0,0,0,0,0,0,0,0,0
360610008000,36, New York,061, New York County,0,0,0,0,0,0,0,0,0,0,0,0,0,0,0,0,0,0
360610008001,36, New York,061, New York County,278,62,50,0,12,62,62,50,0,12,216,0,0,0,0,664,139,525
360610008002,36, New York,061, New York County,223,27,0,13,14,54,0,0,0,0,169,27,0,13,14,855,134,721
360610008003,36, New York,061, New York County,405,173,0,0,173,12,0,0,0,0,393,173,0,0,173,752,67,685
360610008004,36, New York,061, New York County,454,88,88,0,0,137,0,0,0,0,317,88,88,0,0,1007,314,693
360610008005,36, New York,061, New York County,487,149,75,33,41,165,60,0,33,27,322,89,75,0,14,1528,532,996
360610008006,36, New York,061, New York County,737,132,132,0,0,535,1,1,0,0,202,131,131,0,0,739,214,525
360610009000,36, New York,061, New York County,0,0,0,0,0,0,0,0,0,0,0,0,0,0,0,0,0,0
360610009001,36, New York,061, New York County,353,173,140,22,11,13,13,13,0,0,340,160,127,22,11,1435,116,1319
360610009002,36, New York,061, New York County,0,0,0,0,0,0,0,0,0,0,0,0,0,0,0,0,0,0
360610010010,36, New York,061, New York County,0,0,0,0,0,0,0,0,0,0,0,0,0,0,0,0,0,0
360610010011,36, New York,061, New York County,453,196,176,6,14,0,0,0,0,0,453,196,176,6,14,1334,16,1318
360610010020,36, New York,061, New York County,0,0,0,0,0,0,0,0,0,0,0,0,0,0,0,0,0,0
360610010021,36, New York,061, New York County,394,111,0,0,111,195,83,0,0,83,199,28,0,0,28,1491,674,817
360610010022,36, New York,061, New York County,350,53,0,0,53,71,53,0,0,53,279,0,0,0,0,1224,142,1082
360610010023,36, New York,061, New York County,0,0,0,0,0,0,0,0,0,0,0,0,0,0,0,0,0,0
360610010024,36, New York,061, New York County,0,0,0,0,0,0,0,0,0,0,0,0,0,0,0,286,215,71
360610010025,36, New York,061, New York County,578,396,25,52,319,332,275,21,0,254,246,121,4,52,65,1271,644,627
360610012001,36, New York,061, New York County,323,105,10,25,70,133,67,0,14,53,190,38,10,11,17,846,289,557
360610012002,36, New York,061, New York County,374,219,193,0,26,26,26,0,0,26,348,193,193,0,0,1038,87,951
360610012003,36, New York,061, New York County,429,122,122,0,0,0,0,0,0,0,429,122,122,0,0,1021,40,981
360610013001,36, New York,061, New York County,247,116,91,0,25,0,0,0,0,0,247,116,91,0,25,734,0,734
360610013002,36, New York,061, New York County,313,116,89,0,27,0,0,0,0,0,313,116,89,0,27,996,0,996
360610013003,36, New York,061, New York County,224,101,60,22,19,11,0,0,0,0,213,101,60,22,19,1010,63,947
360610013004,36, New York,061, New York County,221,43,43,0,0,12,0,0,0,0,209,43,43,0,0,693,41,652
360610013005,36, New York,061, New York County,0,0,0,0,0,0,0,0,0,0,0,0,0,0,0,0,0,0
360610014011,36, New York,061, New York County,454,177,131,0,46,11,11,0,0,11,443,166,131,0,35,1485,96,1389
360610014012,36, New York,061, New York County,318,81,59,22,0,0,0,0,0,0,318,81,59,22,0,1151,49,1102
360610014021,36, New York,061, New York County,284,32,32,0,0,37,0,0,0,0,247,32,32,0,0,1305,281,1024
360610014022,36, New York,061, New York County,381,225,148,0,77,131,114,114,0,0,250,111,34,0,77,1157,215,942
360610015010,36, New York,061, New York County,0,0,0,0,0,0,0,0,0,0,0,0,0,0,0,0,0,0
360610015011,36, New York,061, New York County,757,427,375,0,52,13,13,13,0,0,744,414,362,0,52,1880,115,1765
360610015012,36, New York,061, New York County,878,195,77,0,118,95,0,0,0,0,783,195,77,0,118,3003,216,2787
360610015013,36, New York,061, New York County,114,48,33,15,0,1,0,0,0,0,113,48,33,15,0,423,147,276
360610015020,36, New York,061, New York County,0,0,0,0,0,0,0,0,0,0,0,0,0,0,0,0,0,0
360610015021,36, New York,061, New York County,96,96,96,0,0,0,0,0,0,0,96,96,96,0,0,379,25,354
360610015022,36, New York,061, New York County,330,112,64,0,48,33,33,0,0,33,297,79,64,0,15,1488,153,1335
360610015023,36, New York,061, New York County,256,148,97,0,51,54,54,54,0,0,202,94,43,0,51,1961,244,1717
360610015024,36, New York,061, New York County,187,51,0,11,40,0,0,0,0,0,187,51,0,11,40,2166,148,2018
360610015025,36, New York,061, New York County,33,0,0,0,0,0,0,0,0,0,33,0,0,0,0,875,11,864
360610015026,36, New York,061, New York County,0,0,0,0,0,0,0,0,0,0,0,0,0,0,0,26,26,0
360610015027,36, New York,061, New York County,0,0,0,0,0,0,0,0,0,0,0,0,0,0,0,0,0,0
360610015028,36, New York,061, New York County,0,0,0,0,0,0,0,0,0,0,0,0,0,0,0,0,0,0
360610016001,36, New York,061, New York County,563,94,93,0,1,88,1,0,0,1,475,93,93,0,0,2305,390,1915
360610016002,36, New York,061, New York County,139,55,55,0,0,0,0,0,0,0,139,55,55,0,0,447,45,402
360610016003,36, New York,061, New York County,920,259,137,2,120,44,26,26,0,0,876,233,111,2,120,1257,72,1185
360610016004,36, New York,061, New York County,271,78,63,15,0,0,0,0,0,0,271,78,63,15,0,741,55,686
360610016005,36, New York,061, New York County,152,36,9,8,19,0,0,0,0,0,152,36,9,8,19,690,89,601
360610018001,36, New York,061, New York County,120,65,27,0,38,61,21,0,0,21,59,44,27,0,17,699,146,553
360610018002,36, New York,061, New York County,114,15,15,0,0,0,0,0,0,0,114,15,15,0,0,879,0,879
360610018003,36, New York,061, New York County,61,11,11,0,0,0,0,0,0,0,61,11,11,0,0,787,208,579
360610018004,36, New York,061, New York County,190,34,0,0,34,3,0,0,0,0,187,34,0,0,34,449,56,393
360610018005,36, New York,061, New York County,81,16,16,0,0,11,0,0,0,0,70,16,16,0,0,470,155,315
360610018006,36, New York,061, New York County,202,70,70,0,0,0,0,0,0,0,202,70,70,0,0,909,123,786
360610018007,36, New York,061, New York County,212,29,29,0,0,0,0,0,0,0,212,29,29,0,0,732,52,680
360610020000,36, New York,061, New York County,0,0,0,0,0,0,0,0,0,0,0,0,0,0,0,0,0,0
360610020001,36, New York,061, New York County,481,239,65,0,174,226,134,0,0,134,255,105,65,0,40,1136,397,739
360610020002,36, New York,061, New York County,471,174,25,60,89,98,46,0,22,24,373,128,25,38,65,1520,385,1135
360610020003,36, New York,061, New York County,259,91,0,24,67,139,72,0,24,48,120,19,0,0,19,767,433,334
360610021001,36, New York,061, New York County,389,255,255,0,0,0,0,0,0,0,389,255,255,0,0,1125,0,1125
360610021002,36, New York,061, New York County,285,96,96,0,0,0,0,0,0,0,285,96,96,0,0,1365,21,1344
360610021003,36, New York,061, New York County,497,332,316,16,0,0,0,0,0,0,497,332,316,16,0,1393,0,1393
360610021004,36, New York,061, New York County,352,244,228,16,0,0,0,0,0,0,352,244,228,16,0,916,41,875
360610022011,36, New York,061, New York County,269,127,25,0,102,166,127,25,0,102,103,0,0,0,0,1312,480,832
360610022012,36, New York,061, New York County,142,49,49,0,0,24,0,0,0,0,118,49,49,0,0,944,405,539
360610022013,36, New York,061, New York County,345,110,0,0,110,126,110,0,0,110,219,0,0,0,0,986,221,765
360610022014,36, New York,061, New York County,531,128,128,0,0,21,0,0,0,0,510,128,128,0,0,1938,164,1774
360610022021,36, New York,061, New York County,233,110,98,0,12,12,12,0,0,12,221,98,98,0,0,2062,204,1858
360610024000,36, New York,061, New York County,0,0,0,0,0,0,0,0,0,0,0,0,0,0,0,0,0,0
360610024001,36, New York,061, New York County,537,330,68,48,214,266,225,39,48,138,271,105,29,0,76,1155,432,723
360610024002,36, New York,061, New York County,0,0,0,0,0,0,0,0,0,0,0,0,0,0,0,0,0,0
360610024003,36, New York,061, New York County,383,162,14,0,148,180,86,8,0,78,203,76,6,0,70,1410,716,694
360610025000,36, New York,061, New York County,0,0,0,0,0,0,0,0,0,0,0,0,0,0,0,0,0,0
360610025001,36, New York,061, New York County,212,118,9,0,109,136,118,9,0,109,76,0,0,0,0,564,337,227
360610025002,36, New York,061, New York County,89,77,13,0,64,64,64,0,0,64,25,13,13,0,0,524,371,153
360610025003,36, New York,061, New York County,195,90,31,0,59,71,38,10,0,28,124,52,21,0,31,603,179,424
360610025004,36, New York,061, New York County,687,210,39,0,171,252,154,14,0,140,435,56,25,0,31,1845,536,1309
360610026011,36, New York,061, New York County,442,126,10,63,53,159,76,0,63,13,283,50,10,0,40,1961,794,1167
360610026012,36, New York,061, New York County,388,178,67,41,70,68,46,0,22,24,320,132,67,19,46,1776,438,1338
360610026021,36, New York,061, New York County,263,130,57,0,73,0,0,0,0,0,263,130,57,0,73,1077,159,918
360610026022,36, New York,061, New York County,70,32,15,0,17,17,17,0,0,17,53,15,15,0,0,665,181,484
360610026023,36, New York,061, New York County,234,41,41,0,0,21,21,21,0,0,213,20,20,0,0,940,169,771
360610027001,36, New York,061, New York County,394,206,175,6,25,41,18,0,5,13,353,188,175,1,12,935,97,838
360610028001,36, New York,061, New York County,51,25,23,0,2,2,2,0,0,2,49,23,23,0,0,389,116,273
360610028002,36, New York,061, New York County,357,112,69,16,27,94,57,30,0,27,263,55,39,16,0,1525,470,1055
360610028003,36, New York,061, New York County,479,172,137,0,35,97,0,0,0,0,382,172,137,0,35,1538,246,1292
360610028004,36, New York,061, New York County,372,128,91,13,24,107,60,23,13,24,265,68,68,0,0,1485,322,1163
360610029011,36, New York,061, New York County,0,0,0,0,0,0,0,0,0,0,0,0,0,0,0,4,2,2
360610029012,36, New York,061, New York County,0,0,0,0,0,0,0,0,0,0,0,0,0,0,0,0,0,0
360610029013,36, New York,061, New York County,26,0,0,0,0,14,0,0,0,0,12,0,0,0,0,118,95,23
360610029021,36, New York,061, New York County,252,25,0,14,11,83,14,0,14,0,169,11,0,0,11,871,284,587
360610029022,36, New York,061, New York County,264,31,31,0,0,47,0,0,0,0,217,31,31,0,0,752,127,625
360610029023,36, New York,061, New York County,133,37,37,0,0,21,0,0,0,0,112,37,37,0,0,468,74,394
360610029024,36, New York,061, New York County,0,0,0,0,0,0,0,0,0,0,0,0,0,0,0,0,0,0
360610029025,36, New York,061, New York County,264,117,79,0,38,99,67,29,0,38,165,50,50,0,0,846,426,420
360610030011,36, New York,061, New York County,202,39,0,0,39,0,0,0,0,0,202,39,0,0,39,1016,132,884
360610030012,36, New York,061, New York County,46,0,0,0,0,0,0,0,0,0,46,0,0,0,0,870,80,790
360610030013,36, New York,061, New York County,87,64,13,37,14,37,14,0,0,14,50,50,13,37,0,1058,78,980
360610030014,36, New York,061, New York County,37,0,0,0,0,0,0,0,0,0,37,0,0,0,0,356,0,356
360610030021,36, New York,061, New York County,372,82,71,0,11,78,0,0,0,0,294,82,71,0,11,1717,338,1379
360610030022,36, New York,061, New York County,154,68,0,0,68,89,42,0,0,42,65,26,0,0,26,721,347,374
360610031001,36, New York,061, New York County,198,82,63,11,8,23,13,7,6,0,175,69,56,5,8,1147,131,1016
360610031002,36, New York,061, New York County,13,7,0,7,0,0,0,0,0,0,13,7,0,7,0,20,7,13
360610032001,36, New York,061, New York County,290,116,49,67,0,68,67,0,67,0,222,49,49,0,0,1478,221,1257
360610032002,36, New York,061, New York County,113,0,0,0,0,29,0,0,0,0,84,0,0,0,0,761,185,576
360610032003,36, New York,061, New York County,556,298,271,27,0,0,0,0,0,0,556,298,271,27,0,1769,145,1624
360610032004,36, New York,061, New York County,89,0,0,0,0,0,0,0,0,0,89,0,0,0,0,571,122,449
360610032005,36, New York,061, New York County,22,0,0,0,0,22,0,0,0,0,0,0,0,0,0,298,128,170
360610032006,36, New York,061, New York County,32,32,0,0,32,0,0,0,0,0,32,32,0,0,32,1124,223,901
360610032007,36, New York,061, New York County,39,20,20,0,0,0,0,0,0,0,39,20,20,0,0,451,69,382
360610033001,36, New York,061, New York County,253,123,71,0,52,1,0,0,0,0,252,123,71,0,52,614,2,612
360610033002,36, New York,061, New York County,485,155,155,0,0,0,0,0,0,0,485,155,155,0,0,1044,0,1044
360610033003,36, New York,061, New York County,508,187,187,0,0,8,0,0,0,0,500,187,187,0,0,1370,64,1306
360610033004,36, New York,061, New York County,440,193,99,21,73,0,0,0,0,0,440,193,99,21,73,1084,0,1084
360610034001,36, New York,061, New York County,325,81,81,0,0,84,0,0,0,0,241,81,81,0,0,1927,370,1557
360610034002,36, New York,061, New York County,150,61,61,0,0,34,34,34,0,0,116,27,27,0,0,972,347,625
360610034003,36, New York,061, New York County,213,0,0,0,0,0,0,0,0,0,213,0,0,0,0,1687,32,1655
360610034004,36, New York,061, New York County,174,0,0,0,0,150,0,0,0,0,24,0,0,0,0,1419,446,973
360610036011,36, New York,061, New York County,123,16,0,0,16,2,0,0,0,0,121,16,0,0,16,614,99,515
360610036012,36, New York,061, New York County,263,81,32,41,8,27,0,0,0,0,236,81,32,41,8,1030,132,898
360610036013,36, New York,061, New York County,204,59,24,0,35,28,0,0,0,0,176,59,24,0,35,736,223,513
360610036021,36, New York,061, New York County,196,108,10,0,98,0,0,0,0,0,196,108,10,0,98,1103,201,902
360610036022,36, New York,061, New York County,148,41,7,0,34,0,0,0,0,0,148,41,7,0,34,1558,491,1067
360610037000,36, New York,061, New York County,0,0,0,0,0,0,0,0,0,0,0,0,0,0,0,0,0,0
360610037001,36, New York,061, New York County,649,449,439,0,10,10,10,0,0,10,639,439,439,0,0,1211,33,1178
360610037002,36, New York,061, New York County,216,66,38,28,0,0,0,0,0,0,216,66,38,28,0,806,65,741
360610037003,36, New York,061, New York County,136,84,52,22,10,0,0,0,0,0,136,84,52,22,10,643,0,643
360610038001,36, New York,061, New York County,242,40,40,0,0,129,0,0,0,0,113,40,40,0,0,1205,462,743
360610038002,36, New York,061, New York County,61,0,0,0,0,0,0,0,0,0,61,0,0,0,0,417,0,417
360610038003,36, New York,061, New York County,157,0,0,0,0,0,0,0,0,0,157,0,0,0,0,1399,273,1126
360610038004,36, New York,061, New York County,105,73,73,0,0,0,0,0,0,0,105,73,73,0,0,1285,272,1013
360610038005,36, New York,061, New York County,66,0,0,0,0,0,0,0,0,0,66,0,0,0,0,1537,348,1189
360610038006,36, New York,061, New York County,92,0,0,0,0,0,0,0,0,0,92,0,0,0,0,759,37,722
360610038007,36, New York,061, New York County,25,0,0,0,0,0,0,0,0,0,25,0,0,0,0,516,78,438
360610039000,36, New York,061, New York County,0,0,0,0,0,0,0,0,0,0,0,0,0,0,0,0,0,0
360610039001,36, New York,061, New York County,964,789,685,42,62,26,26,0,26,0,938,763,685,16,62,1815,154,1661
360610039002,36, New York,061, New York County,234,53,40,13,0,61,0,0,0,0,173,53,40,13,0,1376,259,1117
360610039003,36, New York,061, New York County,538,134,105,0,29,29,29,0,0,29,509,105,105,0,0,1199,29,1170
360610039004,36, New York,061, New York County,254,110,96,0,14,0,0,0,0,0,254,110,96,0,14,729,76,653
360610040011,36, New York,061, New York County,18,0,0,0,0,0,0,0,0,0,18,0,0,0,0,465,0,465
360610040012,36, New York,061, New York County,71,0,0,0,0,0,0,0,0,0,71,0,0,0,0,673,37,636
360610040013,36, New York,061, New York County,208,66,66,0,0,0,0,0,0,0,208,66,66,0,0,1215,89,1126
360610040021,36, New York,061, New York County,27,0,0,0,0,0,0,0,0,0,27,0,0,0,0,1137,612,525
360610040022,36, New York,061, New York County,45,45,45,0,0,0,0,0,0,0,45,45,45,0,0,667,45,622
360610040023,36, New York,061, New York County,107,107,94,0,13,0,0,0,0,0,107,107,94,0,13,811,23,788
360610040024,36, New York,061, New York County,107,57,57,0,0,0,0,0,0,0,107,57,57,0,0,764,37,727
360610041001,36, New York,061, New York County,298,226,226,0,0,16,0,0,0,0,282,226,226,0,0,1132,31,1101
360610041002,36, New York,061, New York County,155,49,34,15,0,34,34,34,0,0,121,15,0,15,0,497,81,416
360610041003,36, New York,061, New York County,355,135,27,63,45,0,0,0,0,0,355,135,27,63,45,1098,217,881
360610041004,36, New York,061, New York County,169,51,51,0,0,0,0,0,0,0,169,51,51,0,0,739,90,649
360610041005,36, New York,061, New York County,179,83,83,0,0,12,12,12,0,0,167,71,71,0,0,1153,95,1058
360610041006,36, New York,061, New York County,92,50,50,0,0,11,0,0,0,0,81,50,50,0,0,582,46,536
360610042001,36, New York,061, New York County,219,66,66,0,0,0,0,0,0,0,219,66,66,0,0,962,199,763
360610042002,36, New York,061, New York County,114,79,68,11,0,0,0,0,0,0,114,79,68,11,0,630,21,609
360610042003,36, New York,061, New York County,93,12,12,0,0,0,0,0,0,0,93,12,12,0,0,378,50,328
360610043001,36, New York,061, New York County,104,0,0,0,0,19,0,0,0,0,85,0,0,0,0,1353,306,1047
360610043002,36, New York,061, New York County,188,61,0,23,38,40,0,0,0,0,148,61,0,23,38,867,216,651
360610043003,36, New York,061, New York County,79,0,0,0,0,0,0,0,0,0,79,0,0,0,0,893,39,854
360610044000,36, New York,061, New York County,0,0,0,0,0,0,0,0,0,0,0,0,0,0,0,0,0,0
360610044001,36, New York,061, New York County,318,78,45,0,33,0,0,0,0,0,318,78,45,0,33,2137,284,1853
360610044002,36, New York,061, New York County,0,0,0,0,0,0,0,0,0,0,0,0,0,0,0,0,0,0
360610044003,36, New York,061, New York County,110,110,0,0,110,0,0,0,0,0,110,110,0,0,110,303,52,251
360610044004,36, New York,061, New York County,533,261,261,0,0,0,0,0,0,0,533,261,261,0,0,2042,0,2042
360610044005,36, New York,061, New York County,482,102,102,0,0,31,0,0,0,0,451,102,102,0,0,1275,124,1151
360610044006,36, New York,061, New York County,622,325,0,325,0,0,0,0,0,0,622,325,0,325,0,1956,251,1705
360610044007,36, New York,061, New York County,510,290,290,0,0,0,0,0,0,0,510,290,290,0,0,1787,138,1649
360610044008,36, New York,061, New York County,254,165,165,0,0,0,0,0,0,0,254,165,165,0,0,1244,56,1188
360610044009,36, New York,061, New York County,214,0,0,0,0,0,0,0,0,0,214,0,0,0,0,1873,80,1793
360610045001,36, New York,061, New York County,282,97,73,13,11,5,0,0,0,0,277,97,73,13,11,864,124,740
360610047001,36, New York,061, New York County,84,19,11,0,8,0,0,0,0,0,84,19,11,0,8,445,27,418
360610047002,36, New York,061, New York County,347,151,151,0,0,8,8,8,0,0,339,143,143,0,0,1142,65,1077
360610048001,36, New York,061, New York County,290,148,148,0,0,0,0,0,0,0,290,148,148,0,0,893,9,884
360610048002,36, New York,061, New York County,311,100,84,0,16,0,0,0,0,0,311,100,84,0,16,1068,80,988
360610048003,36, New York,061, New York County,64,19,19,0,0,0,0,0,0,0,64,19,19,0,0,425,0,425
360610048004,36, New York,061, New York County,184,19,0,0,19,19,19,0,0,19,165,0,0,0,0,880,101,779
360610048005,36, New York,061, New York County,65,21,21,0,0,0,0,0,0,0,65,21,21,0,0,660,91,569
360610048006,36, New York,061, New York County,77,77,61,16,0,16,16,0,16,0,61,61,61,0,0,471,83,388
360610048007,36, New York,061, New York County,0,0,0,0,0,0,0,0,0,0,0,0,0,0,0,0,0,0
360610049001,36, New York,061, New York County,685,272,221,20,31,23,23,23,0,0,662,249,198,20,31,1553,74,1479
360610049002,36, New York,061, New York County,205,0,0,0,0,0,0,0,0,0,205,0,0,0,0,1070,32,1038
360610049003,36, New York,061, New York County,108,30,0,0,30,30,30,0,0,30,78,0,0,0,0,774,79,695
360610050001,36, New York,061, New York County,103,101,101,0,0,0,0,0,0,0,103,101,101,0,0,495,84,411
360610050002,36, New York,061, New York County,203,86,86,0,0,0,0,0,0,0,203,86,86,0,0,669,0,669
360610050003,36, New York,061, New York County,108,54,25,29,0,0,0,0,0,0,108,54,25,29,0,721,60,661
360610050004,36, New York,061, New York County,168,60,60,0,0,0,0,0,0,0,168,60,60,0,0,1203,68,1135
360610050005,36, New York,061, New York County,195,118,118,0,0,0,0,0,0,0,195,118,118,0,0,735,0,735
360610052001,36, New York,061, New York County,177,53,7,11,35,39,39,4,0,35,138,14,3,11,0,592,60,532
360610052002,36, New York,061, New York County,315,116,85,8,23,0,0,0,0,0,315,116,85,8,23,1213,42,1171
360610054001,36, New York,061, New York County,376,153,153,0,0,0,0,0,0,0,376,153,153,0,0,1013,64,949
360610054002,36, New York,061, New York County,246,19,19,0,0,0,0,0,0,0,246,19,19,0,0,1158,163,995
360610054003,36, New York,061, New York County,436,112,112,0,0,0,0,0,0,0,436,112,112,0,0,1497,33,1464
360610055011,36, New York,061, New York County,244,80,80,0,0,15,0,0,0,0,229,80,80,0,0,865,130,735
360610055012,36, New York,061, New York County,437,189,132,17,40,32,17,0,17,0,405,172,132,0,40,1125,121,1004
360610055013,36, New York,061, New York County,342,83,83,0,0,0,0,0,0,0,342,83,83,0,0,955,0,955
360610055021,36, New York,061, New York County,139,74,63,11,0,0,0,0,0,0,139,74,63,11,0,351,22,329
360610055022,36, New York,061, New York County,267,56,48,1,7,14,1,0,1,0,253,55,48,0,7,1209,174,1035
360610056001,36, New York,061, New York County,314,109,109,0,0,0,0,0,0,0,314,109,109,0,0,1859,625,1234
360610056002,36, New York,061, New York County,117,59,48,0,11,0,0,0,0,0,117,59,48,0,11,616,18,598
360610056003,36, New York,061, New York County,257,104,98,0,6,0,0,0,0,0,257,104,98,0,6,878,21,857
360610057001,36, New York,061, New York County,313,116,116,0,0,0,0,0,0,0,313,116,116,0,0,881,47,834
360610057002,36, New York,061, New York County,335,68,60,0,8,0,0,0,0,0,335,68,60,0,8,1670,58,1612
360610058001,36, New York,061, New York County,295,126,100,0,26,100,100,100,0,0,195,26,0,0,26,1089,168,921
360610058002,36, New York,061, New York County,344,163,119,0,44,0,0,0,0,0,344,163,119,0,44,1253,75,1178
360610058003,36, New York,061, New York County,165,45,24,21,0,0,0,0,0,0,165,45,24,21,0,871,0,871
360610059001,36, New York,061, New York County,353,76,76,0,0,0,0,0,0,0,353,76,76,0,0,1082,12,1070
360610059002,36, New York,061, New York County,75,25,0,25,0,0,0,0,0,0,75,25,0,25,0,239,0,239
360610059003,36, New York,061, New York County,273,57,57,0,0,0,0,0,0,0,273,57,57,0,0,991,0,991
360610059004,36, New York,061, New York County,139,19,0,0,19,0,0,0,0,0,139,19,0,0,19,454,27,427
360610059005,36, New York,061, New York County,153,30,30,0,0,0,0,0,0,0,153,30,30,0,0,760,64,696
360610060000,36, New York,061, New York County,0,0,0,0,0,0,0,0,0,0,0,0,0,0,0,0,0,0
360610060001,36, New York,061, New York County,483,286,268,0,18,0,0,0,0,0,483,286,268,0,18,1266,17,1249
360610060002,36, New York,061, New York County,578,173,132,0,41,45,0,0,0,0,533,173,132,0,41,1502,113,1389
360610060003,36, New York,061, New York County,400,316,222,0,94,0,0,0,0,0,400,316,222,0,94,840,0,840
360610061001,36, New York,061, New York County,246,80,80,0,0,0,0,0,0,0,246,80,80,0,0,1450,105,1345
360610061002,36, New York,061, New York County,106,0,0,0,0,0,0,0,0,0,106,0,0,0,0,801,32,769
360610061003,36, New York,061, New York County,387,230,210,20,0,0,0,0,0,0,387,230,210,20,0,1131,0,1131
360610062000,36, New York,061, New York County,0,0,0,0,0,0,0,0,0,0,0,0,0,0,0,0,0,0
360610062001,36, New York,061, New York County,46,17,17,0,0,0,0,0,0,0,46,17,17,0,0,970,559,411
360610062002,36, New York,061, New York County,467,155,137,0,18,2,0,0,0,0,465,155,137,0,18,1454,172,1282
360610062003,36, New York,061, New York County,0,0,0,0,0,0,0,0,0,0,0,0,0,0,0,0,0,0
360610063001,36, New York,061, New York County,332,138,127,11,0,0,0,0,0,0,332,138,127,11,0,1408,56,1352
360610063002,36, New York,061, New York County,139,66,66,0,0,0,0,0,0,0,139,66,66,0,0,627,11,616
360610063003,36, New York,061, New York County,262,98,98,0,0,0,0,0,0,0,262,98,98,0,0,1320,21,1299
360610063004,36, New York,061, New York County,119,52,35,0,17,0,0,0,0,0,119,52,35,0,17,708,0,708
360610063005,36, New York,061, New York County,31,0,0,0,0,0,0,0,0,0,31,0,0,0,0,587,117,470
360610064001,36, New York,061, New York County,205,113,113,0,0,0,0,0,0,0,205,113,113,0,0,1220,28,1192
360610064002,36, New York,061, New York County,290,179,68,0,111,111,111,0,0,111,179,68,68,0,0,951,294,657
360610064003,36, New York,061, New York County,49,0,0,0,0,0,0,0,0,0,49,0,0,0,0,360,1,359
360610064004,36, New York,061, New York County,333,198,0,0,198,198,198,0,0,198,135,0,0,0,0,1376,474,902
360610064005,36, New York,061, New York County,411,85,85,0,0,0,0,0,0,0,411,85,85,0,0,1307,43,1264
360610064006,36, New York,061, New York County,134,45,45,0,0,0,0,0,0,0,134,45,45,0,0,593,0,593
360610065001,36, New York,061, New York County,261,163,73,0,90,0,0,0,0,0,261,163,73,0,90,994,67,927
360610065002,36, New York,061, New York County,30,29,29,0,0,0,0,0,0,0,30,29,29,0,0,811,99,712
360610065003,36, New York,061, New York County,68,0,0,0,0,0,0,0,0,0,68,0,0,0,0,801,79,722
360610065004,36, New York,061, New York County,114,0,0,0,0,11,0,0,0,0,103,0,0,0,0,956,69,887
360610065005,36, New York,061, New York County,119,0,0,0,0,0,0,0,0,0,119,0,0,0,0,804,0,804
360610066001,36, New York,061, New York County,144,20,20,0,0,0,0,0,0,0,144,20,20,0,0,1505,31,1474
360610066002,36, New York,061, New York County,433,0,0,0,0,0,0,0,0,0,433,0,0,0,0,1068,31,1037
360610066003,36, New York,061, New York County,108,108,108,0,0,0,0,0,0,0,108,108,108,0,0,785,0,785
360610066004,36, New York,061, New York County,625,0,0,0,0,0,0,0,0,0,625,0,0,0,0,1825,0,1825
360610066005,36, New York,061, New York County,0,0,0,0,0,0,0,0,0,0,0,0,0,0,0,753,51,702
360610066006,36, New York,061, New York County,74,74,0,0,74,0,0,0,0,0,74,74,0,0,74,620,78,542
360610066007,36, New York,061, New York County,665,376,173,93,110,14,14,14,0,0,651,362,159,93,110,1676,14,1662
360610066008,36, New York,061, New York County,0,0,0,0,0,0,0,0,0,0,0,0,0,0,0,464,45,419
360610066009,36, New York,061, New York County,80,21,0,0,21,0,0,0,0,0,80,21,0,0,21,1017,239,778
360610067001,36, New York,061, New York County,296,0,0,0,0,0,0,0,0,0,296,0,0,0,0,1628,17,1611
360610067002,36, New York,061, New York County,260,13,13,0,0,0,0,0,0,0,260,13,13,0,0,1239,56,1183
360610067003,36, New York,061, New York County,38,0,0,0,0,0,0,0,0,0,38,0,0,0,0,816,4,812
360610067004,36, New York,061, New York County,147,18,1,17,0,0,0,0,0,0,147,18,1,17,0,717,36,681
360610068001,36, New York,061, New York County,227,115,0,115,0,0,0,0,0,0,227,115,0,115,0,1021,106,915
360610068002,36, New York,061, New York County,27,0,0,0,0,0,0,0,0,0,27,0,0,0,0,517,24,493
360610068003,36, New York,061, New York County,236,62,62,0,0,0,0,0,0,0,236,62,62,0,0,780,62,718
360610068004,36, New York,061, New York County,101,0,0,0,0,0,0,0,0,0,101,0,0,0,0,570,167,403
360610068005,36, New York,061, New York County,269,84,84,0,0,0,0,0,0,0,269,84,84,0,0,973,128,845
360610068006,36, New York,061, New York County,180,75,75,0,0,0,0,0,0,0,180,75,75,0,0,1281,85,1196
360610069000,36, New York,061, New York County,0,0,0,0,0,0,0,0,0,0,0,0,0,0,0,0,0,0
360610069001,36, New York,061, New York County,254,39,39,0,0,0,0,0,0,0,254,39,39,0,0,825,99,726
360610069002,36, New York,061, New York County,316,119,95,16,8,0,0,0,0,0,316,119,95,16,8,975,15,960
360610069003,36, New York,061, New York County,0,0,0,0,0,0,0,0,0,0,0,0,0,0,0,0,0,0
360610069004,36, New York,061, New York County,0,0,0,0,0,0,0,0,0,0,0,0,0,0,0,0,0,0
360610070011,36, New York,061, New York County,90,0,0,0,0,1,0,0,0,0,89,0,0,0,0,434,2,432
360610070012,36, New York,061, New York County,199,77,77,0,0,0,0,0,0,0,199,77,77,0,0,1286,37,1249
360610070013,36, New York,061, New York County,80,29,29,0,0,0,0,0,0,0,80,29,29,0,0,502,12,490
360610070014,36, New York,061, New York County,307,186,186,0,0,0,0,0,0,0,307,186,186,0,0,886,43,843
360610070021,36, New York,061, New York County,142,35,35,0,0,0,0,0,0,0,142,35,35,0,0,732,15,717
360610070022,36, New York,061, New York County,42,0,0,0,0,0,0,0,0,0,42,0,0,0,0,841,158,683
360610070023,36, New York,061, New York County,200,66,66,0,0,0,0,0,0,0,200,66,66,0,0,1070,130,940
360610070024,36, New York,061, New York County,75,15,15,0,0,0,0,0,0,0,75,15,15,0,0,532,15,517
360610071001,36, New York,061, New York County,146,65,29,0,36,0,0,0,0,0,146,65,29,0,36,593,199,394
360610071002,36, New York,061, New York County,214,62,41,0,21,0,0,0,0,0,214,62,41,0,21,1161,0,1161
360610071003,36, New York,061, New York County,103,40,40,0,0,0,0,0,0,0,103,40,40,0,0,610,19,591
360610071004,36, New York,061, New York County,65,13,0,0,13,0,0,0,0,0,65,13,0,0,13,871,97,774
360610071005,36, New York,061, New York County,137,37,37,0,0,0,0,0,0,0,137,37,37,0,0,815,0,815
360610072001,36, New York,061, New York County,134,0,0,0,0,0,0,0,0,0,134,0,0,0,0,735,33,702
360610072002,36, New York,061, New York County,56,28,28,0,0,0,0,0,0,0,56,28,28,0,0,726,0,726
360610072003,36, New York,061, New York County,115,60,60,0,0,0,0,0,0,0,115,60,60,0,0,934,94,840
360610072004,36, New York,061, New York County,180,0,0,0,0,29,0,0,0,0,151,0,0,0,0,969,230,739
360610072005,36, New York,061, New York County,222,30,26,0,4,0,0,0,0,0,222,30,26,0,4,1184,65,1119
360610072006,36, New York,061, New York County,33,0,0,0,0,0,0,0,0,0,33,0,0,0,0,343,0,343
360610072007,36, New York,061, New York County,152,84,84,0,0,0,0,0,0,0,152,84,84,0,0,523,51,472
360610073001,36, New York,061, New York County,159,55,55,0,0,0,0,0,0,0,159,55,55,0,0,566,0,566
360610073002,36, New York,061, New York County,216,15,15,0,0,0,0,0,0,0,216,15,15,0,0,558,0,558
360610073003,36, New York,061, New York County,106,0,0,0,0,0,0,0,0,0,106,0,0,0,0,754,126,628
360610073004,36, New York,061, New York County,81,59,59,0,0,0,0,0,0,0,81,59,59,0,0,761,75,686
360610073005,36, New York,061, New York County,149,94,94,0,0,0,0,0,0,0,149,94,94,0,0,687,0,687
360610073006,36, New York,061, New York County,244,56,56,0,0,0,0,0,0,0,244,56,56,0,0,1295,258,1037
360610074001,36, New York,061, New York County,43,0,0,0,0,0,0,0,0,0,43,0,0,0,0,638,36,602
360610074002,36, New York,061, New York County,277,163,132,0,31,0,0,0,0,0,277,163,132,0,31,839,0,839
360610074003,36, New York,061, New York County,157,14,14,0,0,0,0,0,0,0,157,14,14,0,0,655,130,525
360610074004,36, New York,061, New York County,136,0,0,0,0,0,0,0,0,0,136,0,0,0,0,613,18,595
360610074005,36, New York,061, New York County,161,34,34,0,0,34,34,34,0,0,127,0,0,0,0,843,158,685
360610075000,36, New York,061, New York County,0,0,0,0,0,0,0,0,0,0,0,0,0,0,0,0,0,0
360610075001,36, New York,061, New York County,313,59,59,0,0,14,0,0,0,0,299,59,59,0,0,1381,168,1213
360610075002,36, New York,061, New York County,313,57,42,0,15,0,0,0,0,0,313,57,42,0,15,1300,48,1252
360610075003,36, New York,061, New York County,115,15,0,15,0,0,0,0,0,0,115,15,0,15,0,426,63,363
360610076001,36, New York,061, New York County,166,61,32,0,29,29,29,0,0,29,137,32,32,0,0,1348,202,1146
360610076002,36, New York,061, New York County,165,81,16,0,65,0,0,0,0,0,165,81,16,0,65,295,0,295
360610077001,36, New York,061, New York County,202,68,50,0,18,18,18,0,0,18,184,50,50,0,0,1080,149,931
360610077002,36, New York,061, New York County,160,79,22,0,57,0,0,0,0,0,160,79,22,0,57,777,72,705
360610077003,36, New York,061, New York County,145,86,86,0,0,0,0,0,0,0,145,86,86,0,0,965,73,892
360610077004,36, New York,061, New York County,313,33,33,0,0,0,0,0,0,0,313,33,33,0,0,1213,0,1213
360610077005,36, New York,061, New York County,75,1,0,0,1,12,0,0,0,0,63,1,0,0,1,749,38,711
360610078001,36, New York,061, New York County,268,21,21,0,0,0,0,0,0,0,268,21,21,0,0,1022,23,999
360610078002,36, New York,061, New York County,24,0,0,0,0,0,0,0,0,0,24,0,0,0,0,647,0,647
360610078003,36, New York,061, New York County,95,16,16,0,0,0,0,0,0,0,95,16,16,0,0,713,26,687
360610078004,36, New York,061, New York County,237,90,75,0,15,0,0,0,0,0,237,90,75,0,15,1349,56,1293
360610078005,36, New York,061, New York County,58,20,0,0,20,0,0,0,0,0,58,20,0,0,20,969,45,924
360610078006,36, New York,061, New York County,454,244,244,0,0,0,0,0,0,0,454,244,244,0,0,766,0,766
360610078007,36, New York,061, New York County,345,129,129,0,0,56,56,56,0,0,289,73,73,0,0,821,0,821
360610079000,36, New York,061, New York County,0,0,0,0,0,0,0,0,0,0,0,0,0,0,0,0,0,0
360610079001,36, New York,061, New York County,240,182,169,13,0,0,0,0,0,0,240,182,169,13,0,684,0,684
360610079002,36, New York,061, New York County,165,66,66,0,0,0,0,0,0,0,165,66,66,0,0,811,151,660
360610079003,36, New York,061, New York County,240,15,15,0,0,0,0,0,0,0,240,15,15,0,0,942,133,809
360610079004,36, New York,061, New York County,188,97,85,12,0,0,0,0,0,0,188,97,85,12,0,873,14,859
360610080001,36, New York,061, New York County,251,63,41,0,22,80,0,0,0,0,171,63,41,0,22,1032,229,803
360610080002,36, New York,061, New York County,108,39,39,0,0,0,0,0,0,0,108,39,39,0,0,689,0,689
360610080003,36, New York,061, New York County,281,107,107,0,0,0,0,0,0,0,281,107,107,0,0,973,0,973
360610080004,36, New York,061, New York County,192,57,57,0,0,16,0,0,0,0,176,57,57,0,0,685,18,667
360610080005,36, New York,061, New York County,0,0,0,0,0,0,0,0,0,0,0,0,0,0,0,0,0,0
360610080006,36, New York,061, New York County,127,41,41,0,0,0,0,0,0,0,127,41,41,0,0,648,20,628
360610081001,36, New York,061, New York County,52,30,30,0,0,0,0,0,0,0,52,30,30,0,0,787,42,745
360610081002,36, New York,061, New York County,140,91,91,0,0,0,0,0,0,0,140,91,91,0,0,1256,203,1053
360610081003,36, New York,061, New York County,163,90,90,0,0,0,0,0,0,0,163,90,90,0,0,469,0,469
360610081004,36, New York,061, New York County,583,306,255,0,51,0,0,0,0,0,583,306,255,0,51,1494,14,1480
360610081005,36, New York,061, New York County,156,97,97,0,0,0,0,0,0,0,156,97,97,0,0,1010,65,945
360610081006,36, New York,061, New York County,43,0,0,0,0,0,0,0,0,0,43,0,0,0,0,381,15,366
360610082001,36, New York,061, New York County,67,0,0,0,0,0,0,0,0,0,67,0,0,0,0,466,0,466
360610082002,36, New York,061, New York County,483,211,141,16,54,0,0,0,0,0,483,211,141,16,54,1212,65,1147
360610082003,36, New York,061, New York County,175,75,75,0,0,47,0,0,0,0,128,75,75,0,0,870,151,719
360610083001,36, New York,061, New York County,167,0,0,0,0,2,0,0,0,0,165,0,0,0,0,1010,48,962
360610083002,36, New York,061, New York County,54,19,0,0,19,19,19,0,0,19,35,0,0,0,0,856,106,750
360610083003,36, New York,061, New York County,511,115,31,0,84,140,77,9,0,68,371,38,22,0,16,1462,354,1108
360610084001,36, New York,061, New York County,0,0,0,0,0,0,0,0,0,0,0,0,0,0,0,0,0,0
360610084002,36, New York,061, New York County,361,99,99,0,0,8,0,0,0,0,353,99,99,0,0,1047,84,963
360610086010,36, New York,061, New York County,0,0,0,0,0,0,0,0,0,0,0,0,0,0,0,0,0,0
360610086011,36, New York,061, New York County,144,37,37,0,0,0,0,0,0,0,144,37,37,0,0,1336,363,973
360610086012,36, New York,061, New York County,0,0,0,0,0,0,0,0,0,0,0,0,0,0,0,0,0,0
360610086013,36, New York,061, New York County,274,108,82,26,0,0,0,0,0,0,274,108,82,26,0,774,16,758
360610086020,36, New York,061, New York County,0,0,0,0,0,0,0,0,0,0,0,0,0,0,0,0,0,0
360610086021,36, New York,061, New York County,0,0,0,0,0,0,0,0,0,0,0,0,0,0,0,0,0,0
360610086030,36, New York,061, New York County,0,0,0,0,0,0,0,0,0,0,0,0,0,0,0,0,0,0
360610086031,36, New York,061, New York County,228,104,82,0,22,0,0,0,0,0,228,104,82,0,22,736,0,736
360610086032,36, New York,061, New York County,219,116,116,0,0,0,0,0,0,0,219,116,116,0,0,812,32,780
360610086033,36, New York,061, New York County,211,51,51,0,0,0,0,0,0,0,211,51,51,0,0,726,88,638
360610086034,36, New York,061, New York County,590,60,60,0,0,0,0,0,0,0,590,60,60,0,0,1579,12,1567
360610087001,36, New York,061, New York County,146,19,19,0,0,0,0,0,0,0,146,19,19,0,0,798,65,733
360610087002,36, New York,061, New York County,191,0,0,0,0,0,0,0,0,0,191,0,0,0,0,941,24,917
360610087003,36, New York,061, New York County,190,93,93,0,0,0,0,0,0,0,190,93,93,0,0,913,240,673
360610087004,36, New York,061, New York County,97,0,0,0,0,0,0,0,0,0,97,0,0,0,0,696,52,644
360610087005,36, New York,061, New York County,97,63,37,26,0,0,0,0,0,0,97,63,37,26,0,567,0,567
360610087006,36, New York,061, New York County,277,162,116,0,46,46,46,0,0,46,231,116,116,0,0,975,90,885
360610088001,36, New York,061, New York County,132,0,0,0,0,37,0,0,0,0,95,0,0,0,0,1049,124,925
360610088002,36, New York,061, New York County,217,47,47,0,0,29,0,0,0,0,188,47,47,0,0,1144,117,1027
360610088003,36, New York,061, New York County,175,78,50,28,0,0,0,0,0,0,175,78,50,28,0,978,143,835
360610088004,36, New York,061, New York County,195,88,88,0,0,0,0,0,0,0,195,88,88,0,0,427,0,427
360610088005,36, New York,061, New York County,248,50,50,0,0,0,0,0,0,0,248,50,50,0,0,640,15,625
360610088006,36, New York,061, New York County,303,35,35,0,0,13,0,0,0,0,290,35,35,0,0,1104,33,1071
360610088007,36, New York,061, New York County,0,0,0,0,0,0,0,0,0,0,0,0,0,0,0,323,0,323
360610089001,36, New York,061, New York County,60,44,44,0,0,0,0,0,0,0,60,44,44,0,0,572,21,551
360610089002,36, New York,061, New York County,178,73,73,0,0,0,0,0,0,0,178,73,73,0,0,1281,98,1183
360610089003,36, New York,061, New York County,532,184,17,40,127,193,63,0,0,63,339,121,17,40,64,1727,488,1239
360610089004,36, New York,061, New York County,78,0,0,0,0,0,0,0,0,0,78,0,0,0,0,491,71,420
360610089005,36, New York,061, New York County,259,152,65,0,87,0,0,0,0,0,259,152,65,0,87,728,15,713
360610090001,36, New York,061, New York County,0,0,0,0,0,0,0,0,0,0,0,0,0,0,0,129,0,129
360610090002,36, New York,061, New York County,617,20,20,0,0,0,0,0,0,0,617,20,20,0,0,1574,116,1458
360610090003,36, New York,061, New York County,270,67,67,0,0,0,0,0,0,0,270,67,67,0,0,998,0,998
360610090004,36, New York,061, New York County,56,0,0,0,0,0,0,0,0,0,56,0,0,0,0,611,0,611
360610090005,36, New York,061, New York County,89,31,31,0,0,0,0,0,0,0,89,31,31,0,0,554,103,451
360610090006,36, New York,061, New York County,189,0,0,0,0,0,0,0,0,0,189,0,0,0,0,819,189,630
360610090007,36, New York,061, New York County,202,0,0,0,0,0,0,0,0,0,202,0,0,0,0,933,110,823
360610091001,36, New York,061, New York County,178,72,72,0,0,0,0,0,0,0,178,72,72,0,0,820,175,645
360610091002,36, New York,061, New York County,34,0,0,0,0,0,0,0,0,0,34,0,0,0,0,616,103,513
360610091003,36, New York,061, New York County,114,114,30,56,28,28,28,0,0,28,86,86,30,56,0,459,91,368
360610091004,36, New York,061, New York County,259,25,25,0,0,0,0,0,0,0,259,25,25,0,0,1301,325,976
360610091005,36, New York,061, New York County,162,63,63,0,0,0,0,0,0,0,162,63,63,0,0,806,222,584
360610091006,36, New York,061, New York County,211,13,13,0,0,26,0,0,0,0,185,13,13,0,0,1195,53,1142
360610092001,36, New York,061, New York County,72,0,0,0,0,0,0,0,0,0,72,0,0,0,0,491,24,467
360610092002,36, New York,061, New York County,0,0,0,0,0,0,0,0,0,0,0,0,0,0,0,0,0,0
360610092003,36, New York,061, New York County,155,63,63,0,0,0,0,0,0,0,155,63,63,0,0,637,5,632
360610093001,36, New York,061, New York County,412,251,166,0,85,0,0,0,0,0,412,251,166,0,85,1890,229,1661
360610093002,36, New York,061, New York County,316,74,43,0,31,0,0,0,0,0,316,74,43,0,31,1569,74,1495
360610093003,36, New York,061, New York County,195,65,65,0,0,0,0,0,0,0,195,65,65,0,0,1335,59,1276
360610093004,36, New York,061, New York County,136,0,0,0,0,0,0,0,0,0,136,0,0,0,0,640,128,512
360610093005,36, New York,061, New York County,142,86,86,0,0,0,0,0,0,0,142,86,86,0,0,683,0,683
360610093006,36, New York,061, New York County,400,165,34,0,131,131,131,0,0,131,269,34,34,0,0,1279,473,806
360610093007,36, New York,061, New York County,0,0,0,0,0,0,0,0,0,0,0,0,0,0,0,402,102,300
360610094001,36, New York,061, New York County,8,0,0,0,0,0,0,0,0,0,8,0,0,0,0,85,16,69
360610094002,36, New York,061, New York County,0,0,0,0,0,0,0,0,0,0,0,0,0,0,0,0,0,0
360610095001,36, New York,061, New York County,243,152,152,0,0,0,0,0,0,0,243,152,152,0,0,1120,120,1000
360610095002,36, New York,061, New York County,107,45,45,0,0,0,0,0,0,0,107,45,45,0,0,494,40,454
360610096001,36, New York,061, New York County,0,0,0,0,0,0,0,0,0,0,0,0,0,0,0,51,0,51
360610096002,36, New York,061, New York County,31,0,0,0,0,0,0,0,0,0,31,0,0,0,0,151,41,110
360610097001,36, New York,061, New York County,256,29,10,0,19,19,19,0,0,19,237,10,10,0,0,1462,126,1336
360610097002,36, New York,061, New York County,202,0,0,0,0,0,0,0,0,0,202,0,0,0,0,773,109,664
360610097003,36, New York,061, New York County,291,189,75,0,114,0,0,0,0,0,291,189,75,0,114,791,15,776
360610097004,36, New York,061, New York County,190,102,0,0,102,67,0,0,0,0,123,102,0,0,102,982,284,698
360610098001,36, New York,061, New York County,54,0,0,0,0,0,0,0,0,0,54,0,0,0,0,302,71,231
360610098002,36, New York,061, New York County,135,48,48,0,0,0,0,0,0,0,135,48,48,0,0,1025,0,1025
360610098003,36, New York,061, New York County,286,97,0,0,97,0,0,0,0,0,286,97,0,0,97,789,0,789
360610098004,36, New York,061, New York County,107,22,22,0,0,0,0,0,0,0,107,22,22,0,0,733,72,661
360610098005,36, New York,061, New York County,51,24,24,0,0,0,0,0,0,0,51,24,24,0,0,480,38,442
360610098006,36, New York,061, New York County,436,335,302,0,33,0,0,0,0,0,436,335,302,0,33,1292,41,1251
360610098007,36, New York,061, New York County,676,46,27,19,0,297,0,0,0,0,379,46,27,19,0,1572,596,976
360610099010,36, New York,061, New York County,0,0,0,0,0,0,0,0,0,0,0,0,0,0,0,0,0,0
360610099011,36, New York,061, New York County,539,174,153,0,21,9,0,0,0,0,530,174,153,0,21,1295,42,1253
360610099012,36, New York,061, New York County,0,0,0,0,0,0,0,0,0,0,0,0,0,0,0,0,0,0
360610099020,36, New York,061, New York County,0,0,0,0,0,0,0,0,0,0,0,0,0,0,0,0,0,0
360610099021,36, New York,061, New York County,391,99,61,0,38,21,21,0,0,21,370,78,61,0,17,2005,99,1906
360610099022,36, New York,061, New York County,0,0,0,0,0,0,0,0,0,0,0,0,0,0,0,0,0,0
360610099030,36, New York,061, New York County,0,0,0,0,0,0,0,0,0,0,0,0,0,0,0,0,0,0
360610099031,36, New York,061, New York County,0,0,0,0,0,0,0,0,0,0,0,0,0,0,0,0,0,0
360610099032,36, New York,061, New York County,184,48,32,0,16,0,0,0,0,0,184,48,32,0,16,678,62,616
360610100001,36, New York,061, New York County,76,35,35,0,0,0,0,0,0,0,76,35,35,0,0,251,15,236
360610100002,36, New York,061, New York County,171,4,4,0,0,0,0,0,0,0,171,4,4,0,0,1127,37,1090
360610101001,36, New York,061, New York County,125,30,3,4,23,17,17,3,0,14,108,13,0,4,9,1321,202,1119
360610102001,36, New York,061, New York County,5,0,0,0,0,5,0,0,0,0,0,0,0,0,0,5,5,0
360610102002,36, New York,061, New York County,28,11,11,0,0,5,0,0,0,0,23,11,11,0,0,190,21,169
360610103001,36, New York,061, New York County,250,57,19,25,13,21,13,0,0,13,229,44,19,25,0,1494,77,1417
360610103002,36, New York,061, New York County,49,0,0,0,0,0,0,0,0,0,49,0,0,0,0,306,0,306
360610104001,36, New York,061, New York County,148,10,4,0,6,1,0,0,0,0,147,10,4,0,6,669,33,636
360610106010,36, New York,061, New York County,0,0,0,0,0,0,0,0,0,0,0,0,0,0,0,0,0,0
360610106011,36, New York,061, New York County,274,37,37,0,0,0,0,0,0,0,274,37,37,0,0,869,0,869
360610106012,36, New York,061, New York County,260,96,82,2,12,0,0,0,0,0,260,96,82,2,12,897,57,840
360610106013,36, New York,061, New York County,444,41,41,0,0,0,0,0,0,0,444,41,41,0,0,1242,33,1209
360610106014,36, New York,061, New York County,649,413,413,0,0,0,0,0,0,0,649,413,413,0,0,1600,20,1580
360610106015,36, New York,061, New York County,172,104,104,0,0,0,0,0,0,0,172,104,104,0,0,932,40,892
360610106016,36, New York,061, New York County,187,0,0,0,0,0,0,0,0,0,187,0,0,0,0,705,0,705
360610106020,36, New York,061, New York County,0,0,0,0,0,0,0,0,0,0,0,0,0,0,0,0,0,0
360610106021,36, New York,061, New York County,315,117,82,0,35,0,0,0,0,0,315,117,82,0,35,987,45,942
360610106022,36, New York,061, New York County,259,228,228,0,0,0,0,0,0,0,259,228,228,0,0,381,0,381
360610106023,36, New York,061, New York County,281,134,47,61,26,0,0,0,0,0,281,134,47,61,26,817,57,760
360610106024,36, New York,061, New York County,338,148,148,0,0,25,25,25,0,0,313,123,123,0,0,693,26,667
360610108011,36, New York,061, New York County,194,81,81,0,0,0,0,0,0,0,194,81,81,0,0,937,0,937
360610108012,36, New York,061, New York County,128,53,53,0,0,0,0,0,0,0,128,53,53,0,0,484,49,435
360610108013,36, New York,061, New York County,42,0,0,0,0,0,0,0,0,0,42,0,0,0,0,755,86,669
360610108021,36, New York,061, New York County,450,99,99,0,0,49,0,0,0,0,401,99,99,0,0,1594,208,1386
360610108022,36, New York,061, New York County,195,29,29,0,0,0,0,0,0,0,195,29,29,0,0,414,0,414
360610108023,36, New York,061, New York County,505,185,170,0,15,0,0,0,0,0,505,185,170,0,15,1614,110,1504
360610108031,36, New York,061, New York County,233,94,94,0,0,0,0,0,0,0,233,94,94,0,0,800,35,765
360610108032,36, New York,061, New York County,151,97,62,0,35,0,0,0,0,0,151,97,62,0,35,619,11,608
360610109001,36, New York,061, New York County,19,4,4,0,0,0,0,0,0,0,19,4,4,0,0,163,81,82
360610110001,36, New York,061, New York County,215,190,49,50,91,0,0,0,0,0,215,190,49,50,91,661,51,610
360610110002,36, New York,061, New York County,220,96,96,0,0,0,0,0,0,0,220,96,96,0,0,869,81,788
360610110003,36, New York,061, New York County,437,266,266,0,0,0,0,0,0,0,437,266,266,0,0,1687,26,1661
360610110004,36, New York,061, New York County,224,69,69,0,0,0,0,0,0,0,224,69,69,0,0,439,0,439
360610110005,36, New York,061, New York County,146,92,92,0,0,0,0,0,0,0,146,92,92,0,0,433,0,433
360610110006,36, New York,061, New York County,225,8,8,0,0,0,0,0,0,0,225,8,8,0,0,969,36,933
360610111001,36, New York,061, New York County,492,136,75,0,61,0,0,0,0,0,492,136,75,0,61,1731,224,1507
360610111002,36, New York,061, New York County,85,0,0,0,0,0,0,0,0,0,85,0,0,0,0,848,222,626
360610111003,36, New York,061, New York County,179,86,43,0,43,43,43,0,0,43,136,43,43,0,0,960,117,843
360610112011,36, New York,061, New York County,231,60,43,0,17,11,6,0,0,6,220,54,43,0,11,657,45,612
360610112021,36, New York,061, New York County,127,25,15,0,10,4,4,0,0,4,123,21,15,0,6,423,11,412
360610112031,36, New York,061, New York County,113,56,39,0,17,0,0,0,0,0,113,56,39,0,17,502,5,497
360610112032,36, New York,061, New York County,116,39,39,0,0,0,0,0,0,0,116,39,39,0,0,324,0,324
360610113001,36, New York,061, New York County,6,0,0,0,0,0,0,0,0,0,6,0,0,0,0,112,66,46
360610114011,36, New York,061, New York County,158,72,72,0,0,0,0,0,0,0,158,72,72,0,0,346,13,333
360610114012,36, New York,061, New York County,124,15,15,0,0,14,0,0,0,0,110,15,15,0,0,434,29,405
360610114021,36, New York,061, New York County,278,114,84,0,30,10,0,0,0,0,268,114,84,0,30,1222,52,1170
360610114022,36, New York,061, New York County,189,112,110,0,2,0,0,0,0,0,189,112,110,0,2,735,26,709
360610115001,36, New York,061, New York County,137,34,12,20,2,0,0,0,0,0,137,34,12,20,2,948,190,758
360610115002,36, New York,061, New York County,282,134,134,0,0,14,0,0,0,0,268,134,134,0,0,1455,154,1301
360610116000,36, New York,061, New York County,0,0,0,0,0,0,0,0,0,0,0,0,0,0,0,0,0,0
360610116001,36, New York,061, New York County,103,56,56,0,0,0,0,0,0,0,103,56,56,0,0,479,169,310
360610116002,36, New York,061, New York County,302,90,90,0,0,0,0,0,0,0,302,90,90,0,0,1287,87,1200
360610116003,36, New York,061, New York County,245,125,0,15,110,0,0,0,0,0,245,125,0,15,110,798,45,753
360610117000,36, New York,061, New York County,0,0,0,0,0,0,0,0,0,0,0,0,0,0,0,0,0,0
360610117001,36, New York,061, New York County,329,113,30,0,83,0,0,0,0,0,329,113,30,0,83,1271,104,1167
360610117002,36, New York,061, New York County,470,141,67,0,74,0,0,0,0,0,470,141,67,0,74,2529,182,2347
360610117003,36, New York,061, New York County,0,0,0,0,0,0,0,0,0,0,0,0,0,0,0,0,0,0
360610118001,36, New York,061, New York County,349,90,90,0,0,0,0,0,0,0,349,90,90,0,0,1256,87,1169
360610118002,36, New York,061, New York County,499,222,187,35,0,0,0,0,0,0,499,222,187,35,0,1073,32,1041
360610118003,36, New York,061, New York County,107,107,107,0,0,0,0,0,0,0,107,107,107,0,0,431,41,390
360610118004,36, New York,061, New York County,359,209,167,0,42,0,0,0,0,0,359,209,167,0,42,1585,54,1531
360610118005,36, New York,061, New York County,193,171,171,0,0,37,37,37,0,0,156,134,134,0,0,1103,250,853
360610118006,36, New York,061, New York County,163,48,48,0,0,0,0,0,0,0,163,48,48,0,0,880,66,814
360610118007,36, New York,061, New York County,86,22,22,0,0,32,0,0,0,0,54,22,22,0,0,528,70,458
360610118008,36, New York,061, New York County,119,37,37,0,0,0,0,0,0,0,119,37,37,0,0,300,0,300
360610119001,36, New York,061, New York County,0,0,0,0,0,0,0,0,0,0,0,0,0,0,0,282,121,161
360610119002,36, New York,061, New York County,10,10,0,0,10,0,0,0,0,0,10,10,0,0,10,662,336,326
360610120001,36, New York,061, New York County,150,44,44,0,0,0,0,0,0,0,150,44,44,0,0,569,0,569
360610120002,36, New York,061, New York County,220,34,34,0,0,78,0,0,0,0,142,34,34,0,0,698,208,490
360610120003,36, New York,061, New York County,138,66,66,0,0,0,0,0,0,0,138,66,66,0,0,426,33,393
360610120004,36, New York,061, New York County,250,58,58,0,0,0,0,0,0,0,250,58,58,0,0,747,90,657
360610121011,36, New York,061, New York County,165,0,0,0,0,53,0,0,0,0,112,0,0,0,0,936,167,769
360610121012,36, New York,061, New York County,78,24,24,0,0,0,0,0,0,0,78,24,24,0,0,1163,242,921
360610121021,36, New York,061, New York County,363,76,40,0,36,12,0,0,0,0,351,76,40,0,36,1716,240,1476
360610121022,36, New York,061, New York County,613,0,0,0,0,26,0,0,0,0,587,0,0,0,0,1655,255,1400
360610121023,36, New York,061, New York County,136,91,39,52,0,0,0,0,0,0,136,91,39,52,0,464,26,438
360610121024,36, New York,061, New York County,21,0,0,0,0,0,0,0,0,0,21,0,0,0,0,481,0,481
360610122001,36, New York,061, New York County,212,32,15,17,0,0,0,0,0,0,212,32,15,17,0,660,48,612
360610122002,36, New York,061, New York County,171,74,56,11,7,0,0,0,0,0,171,74,56,11,7,476,11,465
360610122003,36, New York,061, New York County,38,0,0,0,0,0,0,0,0,0,38,0,0,0,0,184,0,184
360610122004,36, New York,061, New York County,305,84,34,43,7,0,0,0,0,0,305,84,34,43,7,811,13,798
360610124000,36, New York,061, New York County,0,0,0,0,0,0,0,0,0,0,0,0,0,0,0,0,0,0
360610124001,36, New York,061, New York County,228,84,84,0,0,0,0,0,0,0,228,84,84,0,0,878,106,772
360610124002,36, New York,061, New York County,443,152,152,0,0,0,0,0,0,0,443,152,152,0,0,1284,0,1284
360610124003,36, New York,061, New York County,450,327,327,0,0,0,0,0,0,0,450,327,327,0,0,1110,0,1110
360610124004,36, New York,061, New York County,329,109,109,0,0,0,0,0,0,0,329,109,109,0,0,762,16,746
360610124005,36, New York,061, New York County,234,52,52,0,0,0,0,0,0,0,234,52,52,0,0,523,0,523
360610124006,36, New York,061, New York County,252,157,107,0,50,40,40,16,0,24,212,117,91,0,26,893,128,765
360610124007,36, New York,061, New York County,284,208,208,0,0,0,0,0,0,0,284,208,208,0,0,663,0,663
360610124008,36, New York,061, New York County,65,25,25,0,0,0,0,0,0,0,65,25,25,0,0,305,0,305
360610125001,36, New York,061, New York County,53,53,53,0,0,0,0,0,0,0,53,53,53,0,0,205,25,180
360610125002,36, New York,061, New York County,161,62,54,0,8,0,0,0,0,0,161,62,54,0,8,556,59,497
360610125003,36, New York,061, New York County,51,0,0,0,0,18,0,0,0,0,33,0,0,0,0,320,48,272
360610125004,36, New York,061, New York County,232,52,52,0,0,15,0,0,0,0,217,52,52,0,0,572,71,501
360610126011,36, New York,061, New York County,196,59,59,0,0,0,0,0,0,0,196,59,59,0,0,713,39,674
360610126012,36, New York,061, New York County,34,0,0,0,0,0,0,0,0,0,34,0,0,0,0,522,66,456
360610126013,36, New York,061, New York County,329,173,173,0,0,0,0,0,0,0,329,173,173,0,0,1048,138,910
360610126014,36, New York,061, New York County,681,480,480,0,0,0,0,0,0,0,681,480,480,0,0,1860,0,1860
360610126015,36, New York,061, New York County,637,454,454,0,0,0,0,0,0,0,637,454,454,0,0,1633,0,1633
360610126021,36, New York,061, New York County,541,217,127,36,54,48,0,0,0,0,493,217,127,36,54,1586,74,1512
360610126022,36, New York,061, New York County,129,0,0,0,0,0,0,0,0,0,129,0,0,0,0,520,0,520
360610126023,36, New York,061, New York County,484,133,133,0,0,0,0,0,0,0,484,133,133,0,0,1133,0,1133
360610126024,36, New York,061, New York County,127,71,63,8,0,0,0,0,0,0,127,71,63,8,0,534,41,493
360610127001,36, New York,061, New York County,0,0,0,0,0,0,0,0,0,0,0,0,0,0,0,774,134,640
360610127002,36, New York,061, New York County,223,51,51,0,0,0,0,0,0,0,223,51,51,0,0,1152,55,1097
360610127003,36, New York,061, New York County,298,83,0,0,83,38,38,0,0,38,260,45,0,0,45,2128,405,1723
360610127004,36, New York,061, New York County,199,41,8,0,33,38,0,0,0,0,161,41,8,0,33,1429,133,1296
360610127005,36, New York,061, New York County,184,0,0,0,0,0,0,0,0,0,184,0,0,0,0,760,8,752
360610128001,36, New York,061, New York County,423,132,94,38,0,27,14,14,0,0,396,118,80,38,0,1249,129,1120
360610128002,36, New York,061, New York County,236,92,92,0,0,0,0,0,0,0,236,92,92,0,0,612,0,612
360610128003,36, New York,061, New York County,320,60,39,0,21,0,0,0,0,0,320,60,39,0,21,828,48,780
360610128004,36, New York,061, New York County,338,161,143,0,18,0,0,0,0,0,338,161,143,0,18,757,24,733
360610128005,36, New York,061, New York County,175,44,44,0,0,14,0,0,0,0,161,44,44,0,0,524,50,474
360610129010,36, New York,061, New York County,0,0,0,0,0,0,0,0,0,0,0,0,0,0,0,0,0,0
360610129011,36, New York,061, New York County,650,338,338,0,0,28,0,0,0,0,622,338,338,0,0,1929,106,1823
360610129012,36, New York,061, New York County,965,335,105,41,189,0,0,0,0,0,965,335,105,41,189,3467,146,3321
360610129013,36, New York,061, New York County,0,0,0,0,0,0,0,0,0,0,0,0,0,0,0,0,0,0
360610129014,36, New York,061, New York County,0,0,0,0,0,0,0,0,0,0,0,0,0,0,0,0,0,0
360610129020,36, New York,061, New York County,0,0,0,0,0,0,0,0,0,0,0,0,0,0,0,0,0,0
360610129021,36, New York,061, New York County,36,0,0,0,0,0,0,0,0,0,36,0,0,0,0,926,137,789
360610129022,36, New York,061, New York County,197,75,56,19,0,0,0,0,0,0,197,75,56,19,0,989,19,970
360610129023,36, New York,061, New York County,0,0,0,0,0,0,0,0,0,0,0,0,0,0,0,0,0,0
360610130001,36, New York,061, New York County,111,60,60,0,0,0,0,0,0,0,111,60,60,0,0,395,11,384
360610130002,36, New York,061, New York County,299,108,108,0,0,0,0,0,0,0,299,108,108,0,0,1109,113,996
360610130003,36, New York,061, New York County,268,52,33,0,19,0,0,0,0,0,268,52,33,0,19,716,0,716
360610130004,36, New York,061, New York County,217,77,60,0,17,0,0,0,0,0,217,77,60,0,17,697,83,614
360610131001,36, New York,061, New York County,144,0,0,0,0,18,0,0,0,0,126,0,0,0,0,973,169,804
360610131002,36, New York,061, New York County,189,18,18,0,0,0,0,0,0,0,189,18,18,0,0,525,36,489
360610131003,36, New York,061, New York County,217,112,112,0,0,0,0,0,0,0,217,112,112,0,0,779,11,768
360610132010,36, New York,061, New York County,0,0,0,0,0,0,0,0,0,0,0,0,0,0,0,0,0,0
360610132011,36, New York,061, New York County,95,4,4,0,0,0,0,0,0,0,95,4,4,0,0,540,0,540
360610132012,36, New York,061, New York County,126,41,41,0,0,0,0,0,0,0,126,41,41,0,0,731,14,717
360610132013,36, New York,061, New York County,199,40,40,0,0,0,0,0,0,0,199,40,40,0,0,533,41,492
360610132021,36, New York,061, New York County,437,151,136,0,15,0,0,0,0,0,437,151,136,0,15,1383,179,1204
360610132022,36, New York,061, New York County,71,61,61,0,0,0,0,0,0,0,71,61,61,0,0,561,24,537
360610132023,36, New York,061, New York County,96,74,74,0,0,0,0,0,0,0,96,74,74,0,0,765,193,572
360610132031,36, New York,061, New York County,273,118,0,0,118,0,0,0,0,0,273,118,0,0,118,740,19,721
360610132032,36, New York,061, New York County,460,441,272,169,0,181,181,181,0,0,279,260,91,169,0,1424,512,912
360610132033,36, New York,061, New York County,404,127,127,0,0,232,0,0,0,0,172,127,127,0,0,636,0,636
360610133001,36, New York,061, New York County,37,20,20,0,0,0,0,0,0,0,37,20,20,0,0,680,46,634
360610133002,36, New York,061, New York County,162,2,0,0,2,16,0,0,0,0,146,2,0,0,2,956,189,767
360610133003,36, New York,061, New York County,146,29,29,0,0,0,0,0,0,0,146,29,29,0,0,988,59,929
360610133004,36, New York,061, New York County,118,42,42,0,0,0,0,0,0,0,118,42,42,0,0,1086,119,967
360610133005,36, New York,061, New York County,353,82,69,0,13,86,0,0,0,0,267,82,69,0,13,1122,233,889
360610134001,36, New York,061, New York County,155,95,95,0,0,0,0,0,0,0,155,95,95,0,0,481,72,409
360610134002,36, New York,061, New York County,220,59,0,0,59,0,0,0,0,0,220,59,0,0,59,701,110,591
360610134003,36, New York,061, New York County,490,242,151,0,91,0,0,0,0,0,490,242,151,0,91,1933,776,1157
360610134004,36, New York,061, New York County,73,73,0,73,0,0,0,0,0,0,73,73,0,73,0,469,0,469
360610134005,36, New York,061, New York County,175,107,107,0,0,0,0,0,0,0,175,107,107,0,0,508,0,508
360610134006,36, New York,061, New York County,93,0,0,0,0,0,0,0,0,0,93,0,0,0,0,874,131,743
360610134007,36, New York,061, New York County,344,180,180,0,0,0,0,0,0,0,344,180,180,0,0,1505,44,1461
360610134008,36, New York,061, New York County,764,495,327,0,168,0,0,0,0,0,764,495,327,0,168,1566,8,1558
360610134009,36, New York,061, New York County,0,0,0,0,0,0,0,0,0,0,0,0,0,0,0,196,0,196
360610135010,36, New York,061, New York County,0,0,0,0,0,0,0,0,0,0,0,0,0,0,0,0,0,0
360610135011,36, New York,061, New York County,411,92,92,0,0,56,56,56,0,0,355,36,36,0,0,1352,321,1031
360610135012,36, New York,061, New York County,366,213,69,0,144,0,0,0,0,0,366,213,69,0,144,1229,7,1222
360610135013,36, New York,061, New York County,271,0,0,0,0,0,0,0,0,0,271,0,0,0,0,617,15,602
360610135014,36, New York,061, New York County,0,0,0,0,0,0,0,0,0,0,0,0,0,0,0,0,0,0
360610135020,36, New York,061, New York County,0,0,0,0,0,0,0,0,0,0,0,0,0,0,0,0,0,0
360610135021,36, New York,061, New York County,468,121,34,0,87,65,55,0,0,55,403,66,34,0,32,1609,651,958
360610135022,36, New York,061, New York County,173,31,31,0,0,0,0,0,0,0,173,31,31,0,0,732,242,490
360610135023,36, New York,061, New York County,487,85,38,0,47,95,51,19,0,32,392,34,19,0,15,2045,355,1690
360610135024,36, New York,061, New York County,0,0,0,0,0,0,0,0,0,0,0,0,0,0,0,0,0,0
360610135025,36, New York,061, New York County,0,0,0,0,0,0,0,0,0,0,0,0,0,0,0,0,0,0
360610136010,36, New York,061, New York County,0,0,0,0,0,0,0,0,0,0,0,0,0,0,0,0,0,0
360610136011,36, New York,061, New York County,527,118,97,0,21,0,0,0,0,0,527,118,97,0,21,1479,15,1464
360610136021,36, New York,061, New York County,647,293,293,0,0,0,0,0,0,0,647,293,293,0,0,1623,0,1623
360610136022,36, New York,061, New York County,68,0,0,0,0,0,0,0,0,0,68,0,0,0,0,603,22,581
360610136023,36, New York,061, New York County,927,650,482,97,71,37,37,0,37,0,890,613,482,60,71,1880,37,1843
360610136031,36, New York,061, New York County,137,0,0,0,0,0,0,0,0,0,137,0,0,0,0,379,5,374
360610136032,36, New York,061, New York County,342,129,67,0,62,0,0,0,0,0,342,129,67,0,62,1442,27,1415
360610136033,36, New York,061, New York County,213,149,135,14,0,14,14,0,14,0,199,135,135,0,0,1323,54,1269
360610136041,36, New York,061, New York County,160,0,0,0,0,0,0,0,0,0,160,0,0,0,0,713,42,671
360610136042,36, New York,061, New York County,226,0,0,0,0,0,0,0,0,0,226,0,0,0,0,1342,123,1219
360610136043,36, New York,061, New York County,88,0,0,0,0,0,0,0,0,0,88,0,0,0,0,557,44,513
360610136044,36, New York,061, New York County,201,76,30,0,46,0,0,0,0,0,201,76,30,0,46,452,32,420
360610137001,36, New York,061, New York County,254,7,7,0,0,0,0,0,0,0,254,7,7,0,0,684,0,684
360610137002,36, New York,061, New York County,217,84,0,0,84,0,0,0,0,0,217,84,0,0,84,1147,173,974
360610137003,36, New York,061, New York County,221,31,13,0,18,29,0,0,0,0,192,31,13,0,18,919,120,799
360610137004,36, New York,061, New York County,178,58,19,21,18,0,0,0,0,0,178,58,19,21,18,1085,92,993
360610137005,36, New York,061, New York County,344,160,65,95,0,0,0,0,0,0,344,160,65,95,0,992,92,900
360610137006,36, New York,061, New York County,142,46,46,0,0,0,0,0,0,0,142,46,46,0,0,500,0,500
360610138001,36, New York,061, New York County,152,51,51,0,0,0,0,0,0,0,152,51,51,0,0,642,24,618
360610138002,36, New York,061, New York County,512,340,340,0,0,0,0,0,0,0,512,340,340,0,0,1843,323,1520
360610138003,36, New York,061, New York County,214,75,75,0,0,0,0,0,0,0,214,75,75,0,0,1080,69,1011
360610138004,36, New York,061, New York County,117,74,74,0,0,0,0,0,0,0,117,74,74,0,0,1071,0,1071
360610138005,36, New York,061, New York County,452,0,0,0,0,0,0,0,0,0,452,0,0,0,0,1234,99,1135
360610138006,36, New York,061, New York County,100,60,60,0,0,0,0,0,0,0,100,60,60,0,0,920,45,875
360610138007,36, New York,061, New York County,483,51,51,0,0,0,0,0,0,0,483,51,51,0,0,1126,0,1126
360610138008,36, New York,061, New York County,314,215,215,0,0,0,0,0,0,0,314,215,215,0,0,1027,0,1027
360610138009,36, New York,061, New York County,407,96,96,0,0,0,0,0,0,0,407,96,96,0,0,1177,0,1177
360610139001,36, New York,061, New York County,255,150,106,44,0,0,0,0,0,0,255,150,106,44,0,1386,327,1059
360610139002,36, New York,061, New York County,54,0,0,0,0,0,0,0,0,0,54,0,0,0,0,643,74,569
360610139003,36, New York,061, New York County,76,0,0,0,0,0,0,0,0,0,76,0,0,0,0,1088,74,1014
360610139004,36, New York,061, New York County,379,104,104,0,0,0,0,0,0,0,379,104,104,0,0,1734,0,1734
360610139005,36, New York,061, New York County,232,88,88,0,0,0,0,0,0,0,232,88,88,0,0,911,0,911
360610139006,36, New York,061, New York County,276,0,0,0,0,0,0,0,0,0,276,0,0,0,0,855,95,760
360610139007,36, New York,061, New York County,127,0,0,0,0,0,0,0,0,0,127,0,0,0,0,1475,145,1330
360610140001,36, New York,061, New York County,264,101,101,0,0,0,0,0,0,0,264,101,101,0,0,992,83,909
360610140002,36, New York,061, New York County,282,130,116,0,14,0,0,0,0,0,282,130,116,0,14,1407,30,1377
360610140003,36, New York,061, New York County,109,39,39,0,0,0,0,0,0,0,109,39,39,0,0,933,66,867
360610140004,36, New York,061, New York County,215,115,99,0,16,0,0,0,0,0,215,115,99,0,16,601,0,601
360610140005,36, New York,061, New York County,465,160,75,25,60,40,24,0,0,24,425,136,75,25,36,807,49,758
360610140006,36, New York,061, New York County,284,111,111,0,0,0,0,0,0,0,284,111,111,0,0,973,16,957
360610142001,36, New York,061, New York County,189,65,65,0,0,44,0,0,0,0,145,65,65,0,0,419,123,296
360610142002,36, New York,061, New York County,325,77,76,1,0,0,0,0,0,0,325,77,76,1,0,613,63,550
360610142003,36, New York,061, New York County,137,28,13,0,15,15,0,0,0,0,122,28,13,0,15,334,60,274
360610142004,36, New York,061, New York County,91,76,0,0,76,0,0,0,0,0,91,76,0,0,76,164,0,164
360610142005,36, New York,061, New York County,164,68,68,0,0,0,0,0,0,0,164,68,68,0,0,447,0,447
360610142006,36, New York,061, New York County,267,60,60,0,0,0,0,0,0,0,267,60,60,0,0,746,26,720
360610143001,36, New York,061, New York County,0,0,0,0,0,0,0,0,0,0,0,0,0,0,0,0,0,0
360610144011,36, New York,061, New York County,188,65,65,0,0,0,0,0,0,0,188,65,65,0,0,697,14,683
360610144012,36, New York,061, New York County,660,89,89,0,0,0,0,0,0,0,660,89,89,0,0,1682,0,1682
360610144013,36, New York,061, New York County,114,53,53,0,0,0,0,0,0,0,114,53,53,0,0,535,38,497
360610144014,36, New York,061, New York County,339,216,158,58,0,0,0,0,0,0,339,216,158,58,0,764,13,751
360610144021,36, New York,061, New York County,556,249,249,0,0,0,0,0,0,0,556,249,249,0,0,1375,28,1347
360610144022,36, New York,061, New York County,28,0,0,0,0,0,0,0,0,0,28,0,0,0,0,478,135,343
360610144023,36, New York,061, New York County,345,100,100,0,0,22,0,0,0,0,323,100,100,0,0,967,15,952
360610144024,36, New York,061, New York County,241,103,103,0,0,5,5,5,0,0,236,98,98,0,0,667,6,661
360610144025,36, New York,061, New York County,115,24,24,0,0,0,0,0,0,0,115,24,24,0,0,1005,53,952
360610144026,36, New York,061, New York County,257,157,106,0,51,0,0,0,0,0,257,157,106,0,51,907,48,859
360610144027,36, New York,061, New York County,0,0,0,0,0,0,0,0,0,0,0,0,0,0,0,0,0,0
360610145001,36, New York,061, New York County,649,334,307,0,27,0,0,0,0,0,649,334,307,0,27,1270,73,1197
360610145002,36, New York,061, New York County,270,25,12,0,13,0,0,0,0,0,270,25,12,0,13,913,9,904
360610145003,36, New York,061, New York County,114,35,35,0,0,0,0,0,0,0,114,35,35,0,0,528,26,502
360610145004,36, New York,061, New York County,328,117,117,0,0,0,0,0,0,0,328,117,117,0,0,711,64,647
360610145005,36, New York,061, New York County,161,17,0,0,17,17,17,0,0,17,144,0,0,0,0,339,44,295
360610146011,36, New York,061, New York County,131,35,35,0,0,0,0,0,0,0,131,35,35,0,0,416,0,416
360610146012,36, New York,061, New York County,90,47,47,0,0,17,0,0,0,0,73,47,47,0,0,545,130,415
360610146013,36, New York,061, New York County,137,36,36,0,0,0,0,0,0,0,137,36,36,0,0,601,16,585
360610146014,36, New York,061, New York County,355,101,101,0,0,0,0,0,0,0,355,101,101,0,0,1372,213,1159
360610146021,36, New York,061, New York County,390,80,43,0,37,37,37,0,0,37,353,43,43,0,0,1377,92,1285
360610146022,36, New York,061, New York County,358,63,0,0,63,0,0,0,0,0,358,63,0,0,63,1374,75,1299
360610146023,36, New York,061, New York County,322,146,73,0,73,0,0,0,0,0,322,146,73,0,73,1246,64,1182
360610146024,36, New York,061, New York County,165,27,0,0,27,19,0,0,0,0,146,27,0,0,27,1078,91,987
360610146025,36, New York,061, New York County,158,86,86,0,0,0,0,0,0,0,158,86,86,0,0,704,170,534
360610146026,36, New York,061, New York County,317,87,87,0,0,0,0,0,0,0,317,87,87,0,0,1605,115,1490
360610147001,36, New York,061, New York County,373,275,245,25,5,25,25,0,25,0,348,250,245,0,5,633,44,589
360610147002,36, New York,061, New York County,0,0,0,0,0,0,0,0,0,0,0,0,0,0,0,0,0,0
360610147003,36, New York,061, New York County,351,134,118,16,0,15,0,0,0,0,336,134,118,16,0,982,56,926
360610148011,36, New York,061, New York County,365,164,136,0,28,0,0,0,0,0,365,164,136,0,28,1188,27,1161
360610148012,36, New York,061, New York County,347,222,222,0,0,0,0,0,0,0,347,222,222,0,0,997,29,968
360610148021,36, New York,061, New York County,204,63,48,0,15,0,0,0,0,0,204,63,48,0,15,1177,89,1088
360610148022,36, New York,061, New York County,288,251,234,0,17,0,0,0,0,0,288,251,234,0,17,842,18,824
360610148023,36, New York,061, New York County,537,325,74,134,117,0,0,0,0,0,537,325,74,134,117,1237,15,1222
360610148024,36, New York,061, New York County,376,130,81,49,0,63,49,0,49,0,313,81,81,0,0,1155,201,954
360610148025,36, New York,061, New York County,70,28,28,0,0,0,0,0,0,0,70,28,28,0,0,237,0,237
360610149001,36, New York,061, New York County,164,48,31,0,17,0,0,0,0,0,164,48,31,0,17,462,24,438
360610149002,36, New York,061, New York County,204,63,63,0,0,0,0,0,0,0,204,63,63,0,0,769,105,664
360610149003,36, New York,061, New York County,284,179,169,10,0,0,0,0,0,0,284,179,169,10,0,805,44,761
360610149004,36, New York,061, New York County,479,142,25,63,54,0,0,0,0,0,479,142,25,63,54,1109,182,927
360610149005,36, New York,061, New York County,296,174,126,0,48,4,4,4,0,0,292,170,122,0,48,871,85,786
360610150011,36, New York,061, New York County,259,135,126,0,9,0,0,0,0,0,259,135,126,0,9,628,18,610
360610150012,36, New York,061, New York County,258,70,60,0,10,0,0,0,0,0,258,70,60,0,10,866,28,838
360610150021,36, New York,061, New York County,611,226,226,0,0,10,10,10,0,0,601,216,216,0,0,1394,89,1305
360610150022,36, New York,061, New York County,380,220,202,5,13,5,5,0,5,0,375,215,202,0,13,761,0,761
360610150023,36, New York,061, New York County,266,80,80,0,0,0,0,0,0,0,266,80,80,0,0,671,15,656
360610150024,36, New York,061, New York County,147,40,40,0,0,0,0,0,0,0,147,40,40,0,0,534,48,486
360610151011,36, New York,061, New York County,247,183,0,0,183,0,0,0,0,0,247,183,0,0,183,865,249,616
360610151012,36, New York,061, New York County,248,89,81,0,8,138,89,81,0,8,110,0,0,0,0,945,614,331
360610151013,36, New York,061, New York County,201,132,18,4,110,0,0,0,0,0,201,132,18,4,110,489,48,441
360610151020,36, New York,061, New York County,0,0,0,0,0,0,0,0,0,0,0,0,0,0,0,0,0,0
360610151021,36, New York,061, New York County,205,205,205,0,0,1,1,1,0,0,204,204,204,0,0,1119,0,1119
360610151022,36, New York,061, New York County,1026,560,272,79,209,189,189,0,0,189,837,371,272,79,20,2449,283,2166
360610151023,36, New York,061, New York County,623,539,311,0,228,0,0,0,0,0,623,539,311,0,228,1267,20,1247
360610151024,36, New York,061, New York County,0,0,0,0,0,0,0,0,0,0,0,0,0,0,0,0,0,0
360610152000,36, New York,061, New York County,0,0,0,0,0,0,0,0,0,0,0,0,0,0,0,0,0,0
360610152001,36, New York,061, New York County,514,286,18,15,253,271,146,18,15,113,243,140,0,0,140,1199,571,628
360610152002,36, New York,061, New York County,317,74,40,0,34,122,54,20,0,34,195,20,20,0,0,1191,443,748
360610152003,36, New York,061, New York County,287,40,40,0,0,0,0,0,0,0,287,40,40,0,0,668,0,668
360610152004,36, New York,061, New York County,261,163,163,0,0,0,0,0,0,0,261,163,163,0,0,1014,43,971
360610152005,36, New York,061, New York County,273,168,149,0,19,0,0,0,0,0,273,168,149,0,19,817,0,817
360610152006,36, New York,061, New York County,349,157,133,0,24,22,0,0,0,0,327,157,133,0,24,782,51,731
360610152007,36, New York,061, New York County,0,0,0,0,0,0,0,0,0,0,0,0,0,0,0,0,0,0
360610153011,36, New York,061, New York County,265,182,182,0,0,0,0,0,0,0,265,182,182,0,0,981,118,863
360610153012,36, New York,061, New York County,220,83,52,0,31,0,0,0,0,0,220,83,52,0,31,1303,33,1270
360610153013,36, New York,061, New York County,434,169,169,0,0,0,0,0,0,0,434,169,169,0,0,1249,80,1169
360610153021,36, New York,061, New York County,432,175,175,0,0,0,0,0,0,0,432,175,175,0,0,1009,66,943
360610153022,36, New York,061, New York County,280,142,69,0,73,0,0,0,0,0,280,142,69,0,73,904,17,887
360610153023,36, New York,061, New York County,272,103,103,0,0,0,0,0,0,0,272,103,103,0,0,748,19,729
360610153024,36, New York,061, New York County,40,22,0,22,0,0,0,0,0,0,40,22,0,22,0,435,39,396
360610153025,36, New York,061, New York County,97,71,41,30,0,0,0,0,0,0,97,71,41,30,0,312,29,283
360610153026,36, New York,061, New York County,136,112,87,0,25,0,0,0,0,0,136,112,87,0,25,243,26,217
360610154011,36, New York,061, New York County,128,0,0,0,0,79,0,0,0,0,49,0,0,0,0,664,137,527
360610154012,36, New York,061, New York County,139,0,0,0,0,0,0,0,0,0,139,0,0,0,0,867,19,848
360610154013,36, New York,061, New York County,513,136,136,0,0,0,0,0,0,0,513,136,136,0,0,1229,0,1229
360610154014,36, New York,061, New York County,165,87,87,0,0,0,0,0,0,0,165,87,87,0,0,801,208,593
360610154021,36, New York,061, New York County,224,139,139,0,0,0,0,0,0,0,224,139,139,0,0,714,0,714
360610154022,36, New York,061, New York County,83,0,0,0,0,0,0,0,0,0,83,0,0,0,0,556,0,556
360610154023,36, New York,061, New York County,537,58,0,0,58,93,58,0,0,58,444,0,0,0,0,1660,140,1520
360610154031,36, New York,061, New York County,393,0,0,0,0,0,0,0,0,0,393,0,0,0,0,1325,0,1325
360610154032,36, New York,061, New York County,35,35,35,0,0,0,0,0,0,0,35,35,35,0,0,469,216,253
360610154033,36, New York,061, New York County,77,14,14,0,0,20,0,0,0,0,57,14,14,0,0,452,231,221
360610154034,36, New York,061, New York County,410,340,340,0,0,0,0,0,0,0,410,340,340,0,0,1004,47,957
360610155011,36, New York,061, New York County,1419,341,312,29,0,42,0,0,0,0,1377,341,312,29,0,4364,159,4205
360610155020,36, New York,061, New York County,0,0,0,0,0,0,0,0,0,0,0,0,0,0,0,0,0,0
360610155021,36, New York,061, New York County,254,131,105,0,26,0,0,0,0,0,254,131,105,0,26,808,118,690
360610155022,36, New York,061, New York County,271,121,121,0,0,66,0,0,0,0,205,121,121,0,0,1007,475,532
360610155023,36, New York,061, New York County,391,116,86,0,30,19,19,19,0,0,372,97,67,0,30,934,35,899
360610155024,36, New York,061, New York County,135,48,48,0,0,0,0,0,0,0,135,48,48,0,0,718,0,718
360610155025,36, New York,061, New York County,165,62,62,0,0,0,0,0,0,0,165,62,62,0,0,596,53,543
360610156011,36, New York,061, New York County,114,45,45,0,0,0,0,0,0,0,114,45,45,0,0,1067,317,750
360610156012,36, New York,061, New York County,135,44,25,19,0,0,0,0,0,0,135,44,25,19,0,448,0,448
360610156013,36, New York,061, New York County,152,41,41,0,0,0,0,0,0,0,152,41,41,0,0,653,25,628
360610156014,36, New York,061, New York County,440,282,246,0,36,58,58,36,0,22,382,224,210,0,14,1566,177,1389
360610156021,36, New York,061, New York County,534,246,49,137,60,38,38,0,32,6,496,208,49,105,54,1657,414,1243
360610157001,36, New York,061, New York County,50,0,0,0,0,0,0,0,0,0,50,0,0,0,0,421,0,421
360610157002,36, New York,061, New York County,230,47,0,0,47,0,0,0,0,0,230,47,0,0,47,896,33,863
360610157003,36, New York,061, New York County,233,50,50,0,0,0,0,0,0,0,233,50,50,0,0,1425,0,1425
360610157004,36, New York,061, New York County,166,138,39,51,48,0,0,0,0,0,166,138,39,51,48,769,0,769
360610157005,36, New York,061, New York County,257,122,122,0,0,46,46,46,0,0,211,76,76,0,0,930,134,796
360610157006,36, New York,061, New York County,34,0,0,0,0,0,0,0,0,0,34,0,0,0,0,670,47,623
360610157007,36, New York,061, New York County,441,253,216,37,0,0,0,0,0,0,441,253,216,37,0,1975,86,1889
360610157008,36, New York,061, New York County,166,42,42,0,0,0,0,0,0,0,166,42,42,0,0,682,122,560
360610158011,36, New York,061, New York County,345,151,136,0,15,0,0,0,0,0,345,151,136,0,15,1035,53,982
360610158012,36, New York,061, New York County,256,50,36,0,14,32,14,0,0,14,224,36,36,0,0,753,53,700
360610158013,36, New York,061, New York County,181,114,114,0,0,40,40,40,0,0,141,74,74,0,0,866,80,786
360610158014,36, New York,061, New York County,349,129,115,14,0,0,0,0,0,0,349,129,115,14,0,1027,50,977
360610158021,36, New York,061, New York County,179,68,36,0,32,0,0,0,0,0,179,68,36,0,32,585,55,530
360610158022,36, New York,061, New York County,131,56,44,12,0,23,23,11,12,0,108,33,33,0,0,589,109,480
360610158023,36, New York,061, New York County,105,25,25,0,0,0,0,0,0,0,105,25,25,0,0,1133,108,1025
360610159000,36, New York,061, New York County,0,0,0,0,0,0,0,0,0,0,0,0,0,0,0,0,0,0
360610159001,36, New York,061, New York County,332,124,124,0,0,0,0,0,0,0,332,124,124,0,0,1332,193,1139
360610159002,36, New York,061, New York County,462,332,301,0,31,48,0,0,0,0,414,332,301,0,31,1251,98,1153
360610159003,36, New York,061, New York County,368,151,51,0,100,0,0,0,0,0,368,151,51,0,100,1075,118,957
360610159004,36, New York,061, New York County,156,0,0,0,0,0,0,0,0,0,156,0,0,0,0,615,0,615
360610159005,36, New York,061, New York County,279,29,29,0,0,0,0,0,0,0,279,29,29,0,0,1066,92,974
360610159006,36, New York,061, New York County,375,84,84,0,0,0,0,0,0,0,375,84,84,0,0,408,0,408
360610159007,36, New York,061, New York County,314,113,113,0,0,0,0,0,0,0,314,113,113,0,0,1158,0,1158
360610160011,36, New York,061, New York County,265,61,51,10,0,0,0,0,0,0,265,61,51,10,0,633,0,633
360610160012,36, New York,061, New York County,241,122,122,0,0,0,0,0,0,0,241,122,122,0,0,739,3,736
360610160013,36, New York,061, New York County,123,24,24,0,0,0,0,0,0,0,123,24,24,0,0,406,23,383
360610160014,36, New York,061, New York County,199,70,70,0,0,0,0,0,0,0,199,70,70,0,0,583,1,582
360610160021,36, New York,061, New York County,285,188,167,12,9,9,9,0,0,9,276,179,167,12,0,824,78,746
360610160022,36, New York,061, New York County,246,39,39,0,0,0,0,0,0,0,246,39,39,0,0,943,49,894
360610161001,36, New York,061, New York County,213,146,146,0,0,0,0,0,0,0,213,146,146,0,0,1142,100,1042
360610161002,36, New York,061, New York County,163,97,97,0,0,0,0,0,0,0,163,97,97,0,0,698,0,698
360610161003,36, New York,061, New York County,221,46,46,0,0,0,0,0,0,0,221,46,46,0,0,1036,41,995
360610161004,36, New York,061, New York County,168,50,26,24,0,0,0,0,0,0,168,50,26,24,0,458,0,458
360610161005,36, New York,061, New York County,276,65,65,0,0,0,0,0,0,0,276,65,65,0,0,936,83,853
360610161006,36, New York,061, New York County,82,31,31,0,0,0,0,0,0,0,82,31,31,0,0,623,73,550
360610162000,36, New York,061, New York County,0,0,0,0,0,0,0,0,0,0,0,0,0,0,0,0,0,0
360610162001,36, New York,061, New York County,313,141,33,0,108,2,0,0,0,0,311,141,33,0,108,895,166,729
360610162002,36, New York,061, New York County,281,227,123,25,79,0,0,0,0,0,281,227,123,25,79,816,11,805
360610162003,36, New York,061, New York County,245,68,0,7,61,74,38,0,7,31,171,30,0,0,30,794,302,492
360610162004,36, New York,061, New York County,559,307,56,31,220,322,208,0,0,208,237,99,56,31,12,1855,1051,804
360610162005,36, New York,061, New York County,992,59,0,47,12,781,0,0,0,0,211,59,0,47,12,2172,1142,1030
360610163000,36, New York,061, New York County,0,0,0,0,0,0,0,0,0,0,0,0,0,0,0,0,0,0
360610163001,36, New York,061, New York County,587,283,283,0,0,0,0,0,0,0,587,283,283,0,0,1281,18,1263
360610163002,36, New York,061, New York County,376,92,80,12,0,0,0,0,0,0,376,92,80,12,0,1407,9,1398
360610163003,36, New York,061, New York County,92,15,15,0,0,0,0,0,0,0,92,15,15,0,0,300,81,219
360610163004,36, New York,061, New York County,136,78,23,0,55,0,0,0,0,0,136,78,23,0,55,320,0,320
360610163005,36, New York,061, New York County,511,243,225,0,18,0,0,0,0,0,511,243,225,0,18,1634,215,1419
360610164001,36, New York,061, New York County,467,227,107,0,120,162,108,0,0,108,305,119,107,0,12,1297,405,892
360610164002,36, New York,061, New York County,675,169,96,17,56,384,83,45,17,21,291,86,51,0,35,2323,1104,1219
360610164003,36, New York,061, New York County,538,293,43,0,250,204,168,13,0,155,334,125,30,0,95,1208,512,696
360610164004,36, New York,061, New York County,282,102,0,16,86,108,66,0,16,50,174,36,0,0,36,776,104,672
360610165001,36, New York,061, New York County,484,179,159,0,20,0,0,0,0,0,484,179,159,0,20,1019,67,952
360610165002,36, New York,061, New York County,451,164,148,0,16,17,0,0,0,0,434,164,148,0,16,1326,34,1292
360610165003,36, New York,061, New York County,384,222,208,0,14,0,0,0,0,0,384,222,208,0,14,1057,16,1041
360610165004,36, New York,061, New York County,149,52,52,0,0,0,0,0,0,0,149,52,52,0,0,772,15,757
360610165005,36, New York,061, New York County,261,38,23,15,0,64,0,0,0,0,197,38,23,15,0,1119,397,722
360610166001,36, New York,061, New York County,32,0,0,0,0,0,0,0,0,0,32,0,0,0,0,219,105,114
360610166002,36, New York,061, New York County,186,108,56,0,52,52,52,0,0,52,134,56,56,0,0,470,121,349
360610166003,36, New York,061, New York County,168,15,0,0,15,0,0,0,0,0,168,15,0,0,15,1249,357,892
360610166004,36, New York,061, New York County,212,109,46,15,48,99,48,0,0,48,113,61,46,15,0,754,402,352
360610166005,36, New York,061, New York County,171,118,35,0,83,50,35,35,0,0,121,83,0,0,83,529,54,475
360610166006,36, New York,061, New York County,279,126,43,0,83,40,19,0,0,19,239,107,43,0,64,1082,284,798
360610167000,36, New York,061, New York County,0,0,0,0,0,0,0,0,0,0,0,0,0,0,0,0,0,0
360610167001,36, New York,061, New York County,304,132,106,9,17,0,0,0,0,0,304,132,106,9,17,662,0,662
360610167002,36, New York,061, New York County,330,146,98,48,0,0,0,0,0,0,330,146,98,48,0,864,17,847
360610167003,36, New York,061, New York County,410,176,115,32,29,18,0,0,0,0,392,176,115,32,29,902,74,828
360610167004,36, New York,061, New York County,306,214,195,0,19,0,0,0,0,0,306,214,195,0,19,1202,182,1020
360610167005,36, New York,061, New York County,392,291,262,0,29,29,29,0,0,29,363,262,262,0,0,1237,102,1135
360610168001,36, New York,061, New York County,641,316,37,62,217,201,135,16,0,119,440,181,21,62,98,1190,481,709
360610168002,36, New York,061, New York County,416,191,82,0,109,113,41,0,0,41,303,150,82,0,68,1088,314,774
360610168003,36, New York,061, New York County,32,0,0,0,0,0,0,0,0,0,32,0,0,0,0,237,41,196
360610169001,36, New York,061, New York County,246,80,80,0,0,0,0,0,0,0,246,80,80,0,0,654,0,654
360610169002,36, New York,061, New York County,275,33,33,0,0,0,0,0,0,0,275,33,33,0,0,1164,0,1164
360610169003,36, New York,061, New York County,296,198,198,0,0,0,0,0,0,0,296,198,198,0,0,1108,64,1044
360610169004,36, New York,061, New York County,317,192,192,0,0,0,0,0,0,0,317,192,192,0,0,1693,145,1548
360610169005,36, New York,061, New York County,74,67,67,0,0,0,0,0,0,0,74,67,67,0,0,344,34,310
360610169006,36, New York,061, New York County,241,140,0,0,140,140,140,0,0,140,101,0,0,0,0,730,140,590
360610170001,36, New York,061, New York County,465,282,26,48,208,161,88,0,0,88,304,194,26,48,120,1869,279,1590
360610170002,36, New York,061, New York County,239,120,20,57,43,110,88,0,45,43,129,32,20,12,0,657,322,335
360610170003,36, New York,061, New York County,263,147,45,10,92,63,23,6,0,17,200,124,39,10,75,1138,386,752
360610170004,36, New York,061, New York County,588,262,61,0,201,100,100,19,0,81,488,162,42,0,120,1749,330,1419
360610170005,36, New York,061, New York County,183,80,80,0,0,12,0,0,0,0,171,80,80,0,0,735,100,635
360610171000,36, New York,061, New York County,0,0,0,0,0,0,0,0,0,0,0,0,0,0,0,0,0,0
360610171001,36, New York,061, New York County,265,199,142,57,0,0,0,0,0,0,265,199,142,57,0,1117,115,1002
360610171002,36, New York,061, New York County,770,75,56,0,19,73,0,0,0,0,697,75,56,0,19,1811,361,1450
360610171003,36, New York,061, New York County,206,24,24,0,0,0,0,0,0,0,206,24,24,0,0,819,99,720
360610171004,36, New York,061, New York County,181,53,53,0,0,0,0,0,0,0,181,53,53,0,0,682,180,502
360610171005,36, New York,061, New York County,824,438,438,0,0,74,0,0,0,0,750,438,438,0,0,2091,259,1832
360610171006,36, New York,061, New York County,120,18,18,0,0,0,0,0,0,0,120,18,18,0,0,381,0,381
360610172001,36, New York,061, New York County,319,38,38,0,0,108,0,0,0,0,211,38,38,0,0,1433,580,853
360610172002,36, New York,061, New York County,266,97,0,0,97,148,40,0,0,40,118,57,0,0,57,1151,459,692
360610172003,36, New York,061, New York County,205,87,0,0,87,17,17,0,0,17,188,70,0,0,70,559,93,466
360610172004,36, New York,061, New York County,146,41,0,22,19,41,41,0,22,19,105,0,0,0,0,633,158,475
360610172005,36, New York,061, New York County,123,101,19,0,82,0,0,0,0,0,123,101,19,0,82,499,24,475
360610173001,36, New York,061, New York County,225,112,50,0,62,0,0,0,0,0,225,112,50,0,62,1044,132,912
360610173002,36, New York,061, New York County,262,137,137,0,0,15,15,15,0,0,247,122,122,0,0,867,46,821
360610173003,36, New York,061, New York County,272,234,173,0,61,0,0,0,0,0,272,234,173,0,61,1065,211,854
360610173004,36, New York,061, New York County,492,339,339,0,0,27,0,0,0,0,465,339,339,0,0,726,45,681
360610173005,36, New York,061, New York County,211,54,54,0,0,0,0,0,0,0,211,54,54,0,0,641,52,589
360610173006,36, New York,061, New York County,173,59,59,0,0,0,0,0,0,0,173,59,59,0,0,572,0,572
360610173007,36, New York,061, New York County,265,125,66,0,59,0,0,0,0,0,265,125,66,0,59,753,3,750
360610174011,36, New York,061, New York County,492,323,76,46,201,158,108,35,0,73,334,215,41,46,128,1087,333,754
360610174012,36, New York,061, New York County,297,150,136,0,14,99,79,79,0,0,198,71,57,0,14,1150,351,799
360610174013,36, New York,061, New York County,350,171,124,10,37,10,10,0,10,0,340,161,124,0,37,1107,108,999
360610174021,36, New York,061, New York County,503,184,107,6,71,110,54,0,0,54,393,130,107,6,17,1990,387,1603
360610175000,36, New York,061, New York County,0,0,0,0,0,0,0,0,0,0,0,0,0,0,0,0,0,0
360610175001,36, New York,061, New York County,431,247,189,31,27,0,0,0,0,0,431,247,189,31,27,1131,0,1131
360610175002,36, New York,061, New York County,243,66,31,0,35,0,0,0,0,0,243,66,31,0,35,688,0,688
360610175003,36, New York,061, New York County,245,87,87,0,0,0,0,0,0,0,245,87,87,0,0,953,126,827
360610175004,36, New York,061, New York County,189,0,0,0,0,0,0,0,0,0,189,0,0,0,0,999,2,997
360610175005,36, New York,061, New York County,138,28,28,0,0,0,0,0,0,0,138,28,28,0,0,610,1,609
360610175006,36, New York,061, New York County,807,264,264,0,0,0,0,0,0,0,807,264,264,0,0,2145,12,2133
360610175007,36, New York,061, New York County,166,140,51,0,89,89,89,0,0,89,77,51,51,0,0,535,115,420
360610177001,36, New York,061, New York County,180,122,67,18,37,36,19,0,0,19,144,103,67,18,18,797,102,695
360610177002,36, New York,061, New York County,344,117,117,0,0,111,87,87,0,0,233,30,30,0,0,932,320,612
360610177003,36, New York,061, New York County,164,41,41,0,0,0,0,0,0,0,164,41,41,0,0,542,113,429
360610177004,36, New York,061, New York County,616,560,48,417,95,0,0,0,0,0,616,560,48,417,95,1811,20,1791
360610177005,36, New York,061, New York County,397,247,66,0,181,0,0,0,0,0,397,247,66,0,181,682,25,657
360610177006,36, New York,061, New York County,456,382,69,249,64,249,249,0,249,0,207,133,69,0,64,891,354,537
360610177007,36, New York,061, New York County,195,25,25,0,0,0,0,0,0,0,195,25,25,0,0,712,111,601
360610177008,36, New York,061, New York County,290,135,135,0,0,0,0,0,0,0,290,135,135,0,0,950,24,926
360610178000,36, New York,061, New York County,0,0,0,0,0,0,0,0,0,0,0,0,0,0,0,0,0,0
360610178001,36, New York,061, New York County,278,176,76,0,100,99,54,0,0,54,179,122,76,0,46,825,180,645
360610178002,36, New York,061, New York County,240,166,74,44,48,106,106,65,31,10,134,60,9,13,38,1138,213,925
360610178003,36, New York,061, New York County,250,105,59,0,46,134,104,58,0,46,116,1,1,0,0,952,357,595
360610179000,36, New York,061, New York County,0,0,0,0,0,0,0,0,0,0,0,0,0,0,0,0,0,0
360610179001,36, New York,061, New York County,106,0,0,0,0,0,0,0,0,0,106,0,0,0,0,602,36,566
360610179002,36, New York,061, New York County,323,253,67,46,140,113,113,0,0,113,210,140,67,46,27,968,0,968
360610179003,36, New York,061, New York County,429,68,68,0,0,0,0,0,0,0,429,68,68,0,0,1113,34,1079
360610179004,36, New York,061, New York County,451,233,147,86,0,0,0,0,0,0,451,233,147,86,0,1583,28,1555
360610179005,36, New York,061, New York County,21,21,21,0,0,0,0,0,0,0,21,21,21,0,0,376,165,211
360610179006,36, New York,061, New York County,458,372,372,0,0,30,0,0,0,0,428,372,372,0,0,1272,82,1190
360610179007,36, New York,061, New York County,356,60,26,0,34,0,0,0,0,0,356,60,26,0,34,1001,29,972
360610180001,36, New York,061, New York County,374,271,128,0,143,27,27,0,0,27,347,244,128,0,116,1243,184,1059
360610180002,36, New York,061, New York County,330,179,82,18,79,79,79,0,0,79,251,100,82,18,0,802,193,609
360610180003,36, New York,061, New York County,170,122,0,0,122,127,122,0,0,122,43,0,0,0,0,512,406,106
360610180004,36, New York,061, New York County,48,48,0,0,48,34,34,0,0,34,14,14,0,0,14,230,94,136
360610180005,36, New York,061, New York County,674,310,113,0,197,342,195,0,0,195,332,115,113,0,2,1814,733,1081
360610181001,36, New York,061, New York County,216,93,18,0,75,0,0,0,0,0,216,93,18,0,75,1089,38,1051
360610181002,36, New York,061, New York County,339,130,73,0,57,0,0,0,0,0,339,130,73,0,57,1160,0,1160
360610181003,36, New York,061, New York County,542,285,285,0,0,0,0,0,0,0,542,285,285,0,0,1361,13,1348
360610181004,36, New York,061, New York County,125,83,83,0,0,0,0,0,0,0,125,83,83,0,0,1092,72,1020
360610181005,36, New York,061, New York County,338,164,71,0,93,0,0,0,0,0,338,164,71,0,93,1027,69,958
360610181006,36, New York,061, New York County,338,56,37,19,0,0,0,0,0,0,338,56,37,19,0,1402,0,1402
360610182001,36, New York,061, New York County,92,39,39,0,0,0,0,0,0,0,92,39,39,0,0,581,74,507
360610182002,36, New York,061, New York County,99,54,39,0,15,28,15,0,0,15,71,39,39,0,0,821,430,391
360610182003,36, New York,061, New York County,347,167,87,0,80,64,64,26,0,38,283,103,61,0,42,1068,232,836
360610182004,36, New York,061, New York County,339,205,28,0,177,97,59,0,0,59,242,146,28,0,118,1008,313,695
360610182005,36, New York,061, New York County,377,317,0,0,317,73,73,0,0,73,304,244,0,0,244,1149,358,791
360610183000,36, New York,061, New York County,0,0,0,0,0,0,0,0,0,0,0,0,0,0,0,0,0,0
360610183001,36, New York,061, New York County,639,394,354,40,0,51,51,51,0,0,588,343,303,40,0,2110,300,1810
360610183002,36, New York,061, New York County,189,0,0,0,0,0,0,0,0,0,189,0,0,0,0,781,82,699
360610183003,36, New York,061, New York County,266,109,109,0,0,0,0,0,0,0,266,109,109,0,0,930,288,642
360610183004,36, New York,061, New York County,288,109,84,25,0,13,0,0,0,0,275,109,84,25,0,790,32,758
360610183005,36, New York,061, New York County,130,44,44,0,0,0,0,0,0,0,130,44,44,0,0,866,84,782
360610183006,36, New York,061, New York County,108,26,26,0,0,0,0,0,0,0,108,26,26,0,0,488,38,450
360610183007,36, New York,061, New York County,103,0,0,0,0,0,0,0,0,0,103,0,0,0,0,714,82,632
360610184001,36, New York,061, New York County,150,28,28,0,0,0,0,0,0,0,150,28,28,0,0,577,99,478
360610184002,36, New York,061, New York County,223,135,97,26,12,144,70,44,26,0,79,65,53,0,12,1171,776,395
360610184003,36, New York,061, New York County,353,211,94,0,117,60,0,0,0,0,293,211,94,0,117,1478,595,883
360610184004,36, New York,061, New York County,514,282,38,175,69,47,47,16,0,31,467,235,22,175,38,1056,175,881
360610184005,36, New York,061, New York County,608,450,129,24,297,88,45,45,0,0,520,405,84,24,297,1185,230,955
360610185001,36, New York,061, New York County,239,140,112,0,28,28,28,0,0,28,211,112,112,0,0,886,54,832
360610185002,36, New York,061, New York County,392,216,169,22,25,18,18,0,0,18,374,198,169,22,7,1540,222,1318
360610185003,36, New York,061, New York County,467,49,49,0,0,0,0,0,0,0,467,49,49,0,0,1145,39,1106
360610186001,36, New York,061, New York County,366,201,49,0,152,74,30,0,0,30,292,171,49,0,122,852,224,628
360610186002,36, New York,061, New York County,448,289,19,0,270,82,0,0,0,0,366,289,19,0,270,1943,951,992
360610186003,36, New York,061, New York County,468,288,38,40,210,43,42,0,0,42,425,246,38,40,168,1543,304,1239
360610187000,36, New York,061, New York County,0,0,0,0,0,0,0,0,0,0,0,0,0,0,0,0,0,0
360610187001,36, New York,061, New York County,510,160,160,0,0,25,0,0,0,0,485,160,160,0,0,2462,74,2388
360610187002,36, New York,061, New York County,571,360,302,0,58,0,0,0,0,0,571,360,302,0,58,1559,29,1530
360610187003,36, New York,061, New York County,91,36,36,0,0,0,0,0,0,0,91,36,36,0,0,564,53,511
360610187004,36, New York,061, New York County,485,144,144,0,0,0,0,0,0,0,485,144,144,0,0,1480,23,1457
360610187005,36, New York,061, New York County,258,137,109,28,0,0,0,0,0,0,258,137,109,28,0,1541,533,1008
360610187006,36, New York,061, New York County,146,79,79,0,0,0,0,0,0,0,146,79,79,0,0,485,0,485
360610188001,36, New York,061, New York County,95,29,29,0,0,23,23,23,0,0,72,6,6,0,0,499,81,418
360610188002,36, New York,061, New York County,94,61,42,0,19,19,19,0,0,19,75,42,42,0,0,607,123,484
360610188003,36, New York,061, New York County,119,33,0,0,33,33,33,0,0,33,86,0,0,0,0,973,131,842
360610188004,36, New York,061, New York County,337,265,0,110,155,265,265,0,110,155,72,0,0,0,0,956,517,439
360610189001,36, New York,061, New York County,267,82,57,0,25,0,0,0,0,0,267,82,57,0,25,718,31,687
360610189002,36, New York,061, New York County,437,224,110,0,114,0,0,0,0,0,437,224,110,0,114,1540,193,1347
360610189003,36, New York,061, New York County,515,362,0,150,212,241,241,0,29,212,274,121,0,121,0,1161,650,511
360610189004,36, New York,061, New York County,249,91,41,0,50,65,0,0,0,0,184,91,41,0,50,934,257,677
360610189005,36, New York,061, New York County,152,0,0,0,0,21,0,0,0,0,131,0,0,0,0,565,96,469
360610189006,36, New York,061, New York County,894,439,132,0,307,420,307,0,0,307,474,132,132,0,0,2161,832,1329
360610190001,36, New York,061, New York County,212,74,35,17,22,30,0,0,0,0,182,74,35,17,22,847,225,622
360610190002,36, New York,061, New York County,612,308,284,0,24,57,57,57,0,0,555,251,227,0,24,1851,187,1664
360610191000,36, New York,061, New York County,0,0,0,0,0,0,0,0,0,0,0,0,0,0,0,0,0,0
360610191001,36, New York,061, New York County,235,142,109,0,33,0,0,0,0,0,235,142,109,0,33,821,71,750
360610191002,36, New York,061, New York County,505,294,294,0,0,0,0,0,0,0,505,294,294,0,0,1629,0,1629
360610191003,36, New York,061, New York County,403,185,157,28,0,0,0,0,0,0,403,185,157,28,0,1101,104,997
360610191004,36, New York,061, New York County,258,97,97,0,0,0,0,0,0,0,258,97,97,0,0,980,16,964
360610191005,36, New York,061, New York County,354,62,0,62,0,110,0,0,0,0,244,62,0,62,0,1231,445,786
360610191006,36, New York,061, New York County,152,25,25,0,0,0,0,0,0,0,152,25,25,0,0,791,23,768
360610192000,36, New York,061, New York County,0,0,0,0,0,0,0,0,0,0,0,0,0,0,0,0,0,0
360610192001,36, New York,061, New York County,121,49,0,0,49,49,49,0,0,49,72,0,0,0,0,418,108,310
360610192002,36, New York,061, New York County,496,347,136,0,211,306,219,37,0,182,190,128,99,0,29,1116,667,449
360610192003,36, New York,061, New York County,403,178,5,38,135,137,57,0,38,19,266,121,5,0,116,1046,271,775
360610193001,36, New York,061, New York County,523,205,143,0,62,0,0,0,0,0,523,205,143,0,62,1387,0,1387
360610193002,36, New York,061, New York County,237,0,0,0,0,20,0,0,0,0,217,0,0,0,0,974,228,746
360610193003,36, New York,061, New York County,324,24,24,0,0,32,0,0,0,0,292,24,24,0,0,1522,219,1303
360610193004,36, New York,061, New York County,178,144,84,0,60,0,0,0,0,0,178,144,84,0,60,572,0,572
360610193005,36, New York,061, New York County,510,155,130,0,25,16,0,0,0,0,494,155,130,0,25,1702,427,1275
360610193006,36, New York,061, New York County,273,0,0,0,0,37,0,0,0,0,236,0,0,0,0,1481,352,1129
360610194001,36, New York,061, New York County,423,262,19,18,225,97,73,19,18,36,326,189,0,0,189,1367,449,918
360610194002,36, New York,061, New York County,162,65,37,0,28,19,0,0,0,0,143,65,37,0,28,969,91,878
360610194003,36, New York,061, New York County,139,117,54,0,63,11,11,0,0,11,128,106,54,0,52,995,546,449
360610194004,36, New York,061, New York County,286,151,42,22,87,109,109,0,22,87,177,42,42,0,0,1210,430,780
360610195000,36, New York,061, New York County,0,0,0,0,0,0,0,0,0,0,0,0,0,0,0,0,0,0
360610195001,36, New York,061, New York County,332,95,48,13,34,0,0,0,0,0,332,95,48,13,34,917,50,867
360610195002,36, New York,061, New York County,98,36,36,0,0,0,0,0,0,0,98,36,36,0,0,555,63,492
360610195003,36, New York,061, New York County,633,277,277,0,0,0,0,0,0,0,633,277,277,0,0,2217,287,1930
360610195004,36, New York,061, New York County,178,59,46,0,13,0,0,0,0,0,178,59,46,0,13,861,201,660
360610195005,36, New York,061, New York County,235,80,57,0,23,0,0,0,0,0,235,80,57,0,23,952,42,910
360610196001,36, New York,061, New York County,351,214,126,0,88,80,55,0,0,55,271,159,126,0,33,1278,315,963
360610196002,36, New York,061, New York County,297,50,6,0,44,63,44,0,0,44,234,6,6,0,0,1218,456,762
360610196003,36, New York,061, New York County,9,9,0,0,9,9,9,0,0,9,0,0,0,0,0,196,132,64
360610197011,36, New York,061, New York County,198,92,77,0,15,26,8,8,0,0,172,84,69,0,15,626,131,495
360610197021,36, New York,061, New York County,468,166,106,0,60,62,6,6,0,0,406,160,100,0,60,2070,609,1461
360610198001,36, New York,061, New York County,511,267,225,5,37,22,4,0,0,4,489,263,225,5,33,1752,154,1598
360610198002,36, New York,061, New York County,0,0,0,0,0,0,0,0,0,0,0,0,0,0,0,0,0,0
360610199000,36, New York,061, New York County,0,0,0,0,0,0,0,0,0,0,0,0,0,0,0,0,0,0
360610199001,36, New York,061, New York County,238,58,58,0,0,30,14,14,0,0,208,44,44,0,0,655,56,599
360610199002,36, New York,061, New York County,298,48,35,0,13,0,0,0,0,0,298,48,35,0,13,1353,179,1174
360610199003,36, New York,061, New York County,8,0,0,0,0,0,0,0,0,0,8,0,0,0,0,245,52,193
360610199004,36, New York,061, New York County,163,105,88,0,17,16,0,0,0,0,147,105,88,0,17,515,112,403
360610199005,36, New York,061, New York County,484,114,113,0,1,0,0,0,0,0,484,114,113,0,1,1056,145,911
360610199006,36, New York,061, New York County,246,71,71,0,0,0,0,0,0,0,246,71,71,0,0,682,29,653
360610200001,36, New York,061, New York County,125,66,37,0,29,14,0,0,0,0,111,66,37,0,29,913,105,808
360610200002,36, New York,061, New York County,371,188,107,0,81,0,0,0,0,0,371,188,107,0,81,1464,214,1250
360610201011,36, New York,061, New York County,155,54,32,0,22,0,0,0,0,0,155,54,32,0,22,462,44,418
360610201021,36, New York,061, New York County,194,106,32,8,66,50,50,2,8,40,144,56,30,0,26,750,102,648
360610201022,36, New York,061, New York County,244,99,56,0,43,0,0,0,0,0,244,99,56,0,43,882,83,799
360610201023,36, New York,061, New York County,54,26,26,0,0,17,0,0,0,0,37,26,26,0,0,415,131,284
360610201024,36, New York,061, New York County,155,95,40,0,55,21,13,0,0,13,134,82,40,0,42,666,151,515
360610203001,36, New York,061, New York County,196,100,59,0,41,30,30,0,0,30,166,70,59,0,11,509,81,428
360610203002,36, New York,061, New York County,0,0,0,0,0,0,0,0,0,0,0,0,0,0,0,0,0,0
360610205000,36, New York,061, New York County,0,0,0,0,0,0,0,0,0,0,0,0,0,0,0,0,0,0
360610205001,36, New York,061, New York County,491,100,79,15,6,0,0,0,0,0,491,100,79,15,6,1037,12,1025
360610205002,36, New York,061, New York County,143,81,81,0,0,0,0,0,0,0,143,81,81,0,0,206,0,206
360610205003,36, New York,061, New York County,241,96,55,0,41,45,36,14,0,22,196,60,41,0,19,625,93,532
360610206001,36, New York,061, New York County,343,177,66,72,39,45,45,6,39,0,298,132,60,33,39,1254,280,974
360610206002,36, New York,061, New York County,347,193,128,0,65,33,33,20,0,13,314,160,108,0,52,1759,547,1212
360610207011,36, New York,061, New York County,149,27,27,0,0,28,0,0,0,0,121,27,27,0,0,626,182,444
360610207012,36, New York,061, New York County,259,143,143,0,0,59,0,0,0,0,200,143,143,0,0,411,81,330
360610208001,36, New York,061, New York County,343,162,90,0,72,91,44,44,0,0,252,118,46,0,72,1346,519,827
360610208002,36, New York,061, New York County,291,113,17,17,79,0,0,0,0,0,291,113,17,17,79,1354,77,1277
360610208003,36, New York,061, New York County,332,148,81,0,67,45,45,0,0,45,287,103,81,0,22,1273,160,1113
360610209011,36, New York,061, New York County,228,136,18,0,118,28,28,9,0,19,200,108,9,0,99,793,187,606
360610209012,36, New York,061, New York County,532,361,93,74,194,235,231,35,74,122,297,130,58,0,72,1450,502,948
360610210000,36, New York,061, New York County,0,0,0,0,0,0,0,0,0,0,0,0,0,0,0,0,0,0
360610210001,36, New York,061, New York County,345,114,64,0,50,12,0,0,0,0,333,114,64,0,50,1266,273,993
360610210002,36, New York,061, New York County,192,118,0,0,118,0,0,0,0,0,192,118,0,0,118,538,54,484
360610210003,36, New York,061, New York County,295,110,90,0,20,46,0,0,0,0,249,110,90,0,20,767,234,533
360610210004,36, New York,061, New York County,474,424,51,0,373,302,272,25,0,247,172,152,26,0,126,814,411,403
360610210005,36, New York,061, New York County,0,0,0,0,0,0,0,0,0,0,0,0,0,0,0,0,0,0
360610210006,36, New York,061, New York County,429,255,117,0,138,187,172,94,0,78,242,83,23,0,60,1462,512,950
360610211000,36, New York,061, New York County,0,0,0,0,0,0,0,0,0,0,0,0,0,0,0,0,0,0
360610211001,36, New York,061, New York County,0,0,0,0,0,0,0,0,0,0,0,0,0,0,0,313,59,254
360610211002,36, New York,061, New York County,213,113,81,0,32,0,0,0,0,0,213,113,81,0,32,583,0,583
360610211003,36, New York,061, New York County,276,142,121,21,0,21,21,0,21,0,255,121,121,0,0,2578,388,2190
360610211004,36, New York,061, New York County,111,0,0,0,0,61,0,0,0,0,50,0,0,0,0,606,401,205
360610211005,36, New York,061, New York County,384,273,111,64,98,122,98,0,0,98,262,175,111,64,0,939,383,556
360610211006,36, New York,061, New York County,341,96,34,62,0,0,0,0,0,0,341,96,34,62,0,1564,17,1547
360610211007,36, New York,061, New York County,143,30,30,0,0,0,0,0,0,0,143,30,30,0,0,459,35,424
360610212001,36, New York,061, New York County,436,270,78,0,192,74,74,18,0,56,362,196,60,0,136,1189,247,942
360610212002,36, New York,061, New York County,0,0,0,0,0,0,0,0,0,0,0,0,0,0,0,0,0,0
360610212003,36, New York,061, New York County,143,42,8,0,34,0,0,0,0,0,143,42,8,0,34,700,92,608
360610212004,36, New York,061, New York County,229,26,26,0,0,0,0,0,0,0,229,26,26,0,0,1238,99,1139
360610213031,36, New York,061, New York County,121,72,0,31,41,6,0,0,0,0,115,72,0,31,41,706,91,615
360610213032,36, New York,061, New York County,148,115,36,0,79,25,25,0,0,25,123,90,36,0,54,523,225,298
360610213033,36, New York,061, New York County,441,250,54,14,182,0,0,0,0,0,441,250,54,14,182,2105,197,1908
360610213034,36, New York,061, New York County,271,177,177,0,0,119,108,108,0,0,152,69,69,0,0,1069,360,709
360610214001,36, New York,061, New York County,207,57,35,0,22,34,0,0,0,0,173,57,35,0,22,1283,207,1076
360610214002,36, New York,061, New York County,245,63,29,10,24,34,24,0,0,24,211,39,29,10,0,1382,234,1148
360610215001,36, New York,061, New York County,300,186,94,0,92,39,28,0,0,28,261,158,94,0,64,793,158,635
360610215002,36, New York,061, New York County,644,312,75,27,210,98,52,0,0,52,546,260,75,27,158,2255,374,1881
360610216001,36, New York,061, New York County,260,125,67,0,58,55,41,0,0,41,205,84,67,0,17,1215,379,836
360610216002,36, New York,061, New York County,128,67,67,0,0,0,0,0,0,0,128,67,67,0,0,794,216,578
360610216003,36, New York,061, New York County,377,138,78,0,60,0,0,0,0,0,377,138,78,0,60,858,12,846
360610216004,36, New York,061, New York County,459,228,131,0,97,58,38,0,0,38,401,190,131,0,59,1501,225,1276
360610216005,36, New York,061, New York County,695,383,198,0,185,164,69,0,0,69,531,314,198,0,116,1767,434,1333
360610217031,36, New York,061, New York County,0,0,0,0,0,0,0,0,0,0,0,0,0,0,0,0,0,0
360610218001,36, New York,061, New York County,230,141,53,46,42,0,0,0,0,0,230,141,53,46,42,769,31,738
360610218002,36, New York,061, New York County,329,166,11,0,155,59,59,0,0,59,270,107,11,0,96,1522,366,1156
360610218003,36, New York,061, New York County,123,83,83,0,0,0,0,0,0,0,123,83,83,0,0,758,93,665
360610218004,36, New York,061, New York County,243,104,31,20,53,1,0,0,0,0,242,104,31,20,53,1280,242,1038
360610219000,36, New York,061, New York County,0,0,0,0,0,0,0,0,0,0,0,0,0,0,0,0,0,0
360610219001,36, New York,061, New York County,134,134,39,32,63,95,95,0,32,63,39,39,39,0,0,447,229,218
360610219002,36, New York,061, New York County,211,104,61,0,43,37,7,7,0,0,174,97,54,0,43,904,100,804
360610219003,36, New York,061, New York County,632,458,8,0,450,362,318,0,0,318,270,140,8,0,132,1478,749,729
360610219004,36, New York,061, New York County,245,156,0,0,156,156,156,0,0,156,89,0,0,0,0,485,308,177
360610220001,36, New York,061, New York County,77,25,25,0,0,0,0,0,0,0,77,25,25,0,0,451,50,401
360610220002,36, New York,061, New York County,221,149,74,16,59,41,0,0,0,0,180,149,74,16,59,817,212,605
360610220003,36, New York,061, New York County,288,81,40,0,41,41,41,0,0,41,247,40,40,0,0,756,41,715
360610220004,36, New York,061, New York County,325,86,60,0,26,37,0,0,0,0,288,86,60,0,26,1270,85,1185
360610220005,36, New York,061, New York County,564,160,80,0,80,80,80,0,0,80,484,80,80,0,0,1538,358,1180
360610221021,36, New York,061, New York County,161,53,36,0,17,0,0,0,0,0,161,53,36,0,17,855,66,789
360610221022,36, New York,061, New York County,316,93,69,16,8,35,0,0,0,0,281,93,69,16,8,1257,122,1135
360610222001,36, New York,061, New York County,446,261,120,0,141,141,136,22,0,114,305,125,98,0,27,1488,455,1033
360610222002,36, New York,061, New York County,160,97,62,0,35,21,21,0,0,21,139,76,62,0,14,784,213,571
360610223010,36, New York,061, New York County,0,0,0,0,0,0,0,0,0,0,0,0,0,0,0,0,0,0
360610223011,36, New York,061, New York County,210,189,134,0,55,0,0,0,0,0,210,189,134,0,55,763,82,681
360610223012,36, New York,061, New York County,528,198,68,0,130,27,27,0,0,27,501,171,68,0,103,1684,244,1440
360610223013,36, New York,061, New York County,265,24,24,0,0,118,0,0,0,0,147,24,24,0,0,1455,302,1153
360610223014,36, New York,061, New York County,350,126,0,35,91,70,40,0,17,23,280,86,0,18,68,1817,397,1420
360610223020,36, New York,061, New York County,0,0,0,0,0,0,0,0,0,0,0,0,0,0,0,0,0,0
360610223021,36, New York,061, New York County,0,0,0,0,0,0,0,0,0,0,0,0,0,0,0,0,0,0
360610223022,36, New York,061, New York County,541,217,68,40,109,153,76,0,23,53,388,141,68,17,56,2330,702,1628
360610224001,36, New York,061, New York County,291,153,153,0,0,0,0,0,0,0,291,153,153,0,0,1017,91,926
360610224002,36, New York,061, New York County,328,237,74,0,163,51,44,0,0,44,277,193,74,0,119,1242,358,884
360610224003,36, New York,061, New York County,429,194,12,67,115,177,99,0,40,59,252,95,12,27,56,1026,471,555
360610224004,36, New York,061, New York County,466,245,0,0,245,195,104,0,0,104,271,141,0,0,141,1347,616,731
360610225000,36, New York,061, New York County,0,0,0,0,0,0,0,0,0,0,0,0,0,0,0,0,0,0
360610225001,36, New York,061, New York County,640,179,114,0,65,327,65,0,0,65,313,114,114,0,0,1984,977,1007
360610225002,36, New York,061, New York County,562,224,109,102,13,80,47,25,22,0,482,177,84,80,13,1883,257,1626
360610225003,36, New York,061, New York County,201,85,61,24,0,0,0,0,0,0,201,85,61,24,0,1258,196,1062
360610225004,36, New York,061, New York County,110,110,66,0,44,25,25,0,0,25,85,85,66,0,19,437,43,394
360610225005,36, New York,061, New York County,439,219,167,28,24,19,0,0,0,0,420,219,167,28,24,1538,330,1208
360610226001,36, New York,061, New York County,326,119,70,0,49,68,68,38,0,30,258,51,32,0,19,1111,408,703
360610226002,36, New York,061, New York County,269,202,113,0,89,0,0,0,0,0,269,202,113,0,89,945,187,758
360610226003,36, New York,061, New York County,360,227,67,0,160,70,58,0,0,58,290,169,67,0,102,1583,328,1255
360610227001,36, New York,061, New York County,143,44,14,0,30,0,0,0,0,0,143,44,14,0,30,1262,233,1029
360610227002,36, New York,061, New York County,206,90,59,31,0,0,0,0,0,0,206,90,59,31,0,989,31,958
360610227003,36, New York,061, New York County,460,203,124,0,79,129,101,101,0,0,331,102,23,0,79,1584,389,1195
360610228001,36, New York,061, New York County,576,414,148,0,266,48,48,0,0,48,528,366,148,0,218,2100,257,1843
360610228002,36, New York,061, New York County,61,6,3,0,3,37,6,3,0,3,24,0,0,0,0,370,229,141
360610228003,36, New York,061, New York County,284,133,18,0,115,50,0,0,0,0,234,133,18,0,115,1446,317,1129
360610228004,36, New York,061, New York County,431,162,24,68,70,22,0,0,0,0,409,162,24,68,70,1001,134,867
360610229000,36, New York,061, New York County,0,0,0,0,0,0,0,0,0,0,0,0,0,0,0,0,0,0
360610229001,36, New York,061, New York County,430,68,0,0,68,70,22,0,0,22,360,46,0,0,46,1543,208,1335
360610229002,36, New York,061, New York County,170,82,82,0,0,0,0,0,0,0,170,82,82,0,0,935,53,882
360610229003,36, New York,061, New York County,468,194,75,0,119,154,111,24,0,87,314,83,51,0,32,1450,494,956
360610229004,36, New York,061, New York County,292,171,44,29,98,68,68,0,29,39,224,103,44,0,59,919,269,650
360610229005,36, New York,061, New York County,460,198,56,0,142,212,119,0,0,119,248,79,56,0,23,1486,678,808
360610230001,36, New York,061, New York County,422,318,54,53,211,58,41,0,0,41,364,277,54,53,170,985,97,888
360610230002,36, New York,061, New York County,148,64,64,0,0,55,0,0,0,0,93,64,64,0,0,1204,554,650
360610230003,36, New York,061, New York County,377,175,151,0,24,156,101,77,0,24,221,74,74,0,0,1131,261,870
360610230004,36, New York,061, New York County,482,209,0,38,171,155,61,0,38,23,327,148,0,0,148,1493,672,821
360610230005,36, New York,061, New York County,181,98,38,0,60,1,0,0,0,0,180,98,38,0,60,1043,287,756
360610231001,36, New York,061, New York County,351,199,83,39,77,137,137,60,0,77,214,62,23,39,0,1469,388,1081
360610231002,36, New York,061, New York County,440,95,61,14,20,48,48,28,0,20,392,47,33,14,0,1676,215,1461
360610231003,36, New York,061, New York County,0,0,0,0,0,0,0,0,0,0,0,0,0,0,0,0,0,0
360610231004,36, New York,061, New York County,407,234,49,0,185,30,30,0,0,30,377,204,49,0,155,1896,130,1766
360610232001,36, New York,061, New York County,400,270,239,31,0,214,214,183,31,0,186,56,56,0,0,903,414,489
360610232002,36, New York,061, New York County,470,227,25,15,187,164,164,0,15,149,306,63,25,0,38,1689,596,1093
360610232003,36, New York,061, New York County,571,327,65,0,262,225,146,0,0,146,346,181,65,0,116,1889,764,1125
360610232004,36, New York,061, New York County,509,193,106,47,40,86,69,0,47,22,423,124,106,0,18,1598,297,1301
360610233000,36, New York,061, New York County,0,0,0,0,0,0,0,0,0,0,0,0,0,0,0,0,0,0
360610233001,36, New York,061, New York County,223,184,184,0,0,62,62,62,0,0,161,122,122,0,0,1179,193,986
360610233002,36, New York,061, New York County,315,199,94,0,105,34,34,0,0,34,281,165,94,0,71,1664,313,1351
360610233003,36, New York,061, New York County,417,308,132,0,176,32,32,0,0,32,385,276,132,0,144,1499,253,1246
360610234001,36, New York,061, New York County,308,133,89,44,0,80,0,0,0,0,228,133,89,44,0,1399,412,987
360610234002,36, New York,061, New York County,560,319,146,35,138,175,175,57,35,83,385,144,89,0,55,1987,361,1626
360610235011,36, New York,061, New York County,327,147,0,147,0,43,43,0,43,0,284,104,0,104,0,785,142,643
360610235012,36, New York,061, New York County,268,185,9,0,176,0,0,0,0,0,268,185,9,0,176,839,41,798
360610235013,36, New York,061, New York County,443,234,80,23,131,101,49,0,0,49,342,185,80,23,82,1368,180,1188
360610235014,36, New York,061, New York County,0,0,0,0,0,0,0,0,0,0,0,0,0,0,0,0,0,0
360610235015,36, New York,061, New York County,524,258,208,0,50,40,40,40,0,0,484,218,168,0,50,1789,252,1537
360610235021,36, New York,061, New York County,305,205,65,23,117,87,74,15,0,59,218,131,50,23,58,1088,226,862
360610236000,36, New York,061, New York County,0,0,0,0,0,0,0,0,0,0,0,0,0,0,0,0,0,0
360610236001,36, New York,061, New York County,453,362,50,20,292,23,23,0,0,23,430,339,50,20,269,1334,126,1208
360610236002,36, New York,061, New York County,421,150,88,0,62,182,45,0,0,45,239,105,88,0,17,1392,514,878
360610236003,36, New York,061, New York County,326,250,125,53,72,0,0,0,0,0,326,250,125,53,72,656,78,578
360610236004,36, New York,061, New York County,878,240,95,33,112,174,43,0,0,43,704,197,95,33,69,2721,413,2308
360610236005,36, New York,061, New York County,253,14,14,0,0,17,0,0,0,0,236,14,14,0,0,845,37,808
360610237000,36, New York,061, New York County,0,0,0,0,0,0,0,0,0,0,0,0,0,0,0,0,0,0
360610237001,36, New York,061, New York County,557,295,163,72,60,248,200,122,72,6,309,95,41,0,54,1888,682,1206
360610237002,36, New York,061, New York County,414,181,100,39,42,126,42,0,0,42,288,139,100,39,0,1398,241,1157
360610237003,36, New York,061, New York County,455,193,51,115,27,111,77,0,77,0,344,116,51,38,27,1286,384,902
360610238020,36, New York,061, New York County,0,0,0,0,0,0,0,0,0,0,0,0,0,0,0,0,0,0
360610238021,36, New York,061, New York County,1049,567,516,0,51,54,20,15,0,5,995,547,501,0,46,1802,216,1586
360610238022,36, New York,061, New York County,0,0,0,0,0,0,0,0,0,0,0,0,0,0,0,0,0,0
360610238023,36, New York,061, New York County,0,0,0,0,0,0,0,0,0,0,0,0,0,0,0,0,0,0
360610238030,36, New York,061, New York County,0,0,0,0,0,0,0,0,0,0,0,0,0,0,0,0,0,0
360610238031,36, New York,061, New York County,298,130,103,0,27,69,42,15,0,27,229,88,88,0,0,925,141,784
360610238032,36, New York,061, New York County,451,153,129,0,24,17,0,0,0,0,434,153,129,0,24,1416,44,1372
360610238040,36, New York,061, New York County,0,0,0,0,0,0,0,0,0,0,0,0,0,0,0,0,0,0
360610238041,36, New York,061, New York County,0,0,0,0,0,0,0,0,0,0,0,0,0,0,0,31,0,31
360610238042,36, New York,061, New York County,467,240,160,18,62,75,75,22,0,53,392,165,138,18,9,601,109,492
360610238043,36, New York,061, New York County,344,159,125,0,34,0,0,0,0,0,344,159,125,0,34,445,0,445
360610239001,36, New York,061, New York County,340,181,124,0,57,27,0,0,0,0,313,181,124,0,57,1214,105,1109
360610239002,36, New York,061, New York County,212,84,38,10,36,63,21,0,0,21,149,63,38,10,15,707,89,618
360610240000,36, New York,061, New York County,0,0,0,0,0,0,0,0,0,0,0,0,0,0,0,0,0,0
360610240001,36, New York,061, New York County,0,0,0,0,0,0,0,0,0,0,0,0,0,0,0,0,0,0
360610240002,36, New York,061, New York County,0,0,0,0,0,0,0,0,0,0,0,0,0,0,0,1883,1429,454
360610240003,36, New York,061, New York County,0,0,0,0,0,0,0,0,0,0,0,0,0,0,0,15,0,15
360610241000,36, New York,061, New York County,0,0,0,0,0,0,0,0,0,0,0,0,0,0,0,0,0,0
360610241001,36, New York,061, New York County,330,81,26,0,55,0,0,0,0,0,330,81,26,0,55,1727,104,1623
360610241002,36, New York,061, New York County,454,230,53,19,158,68,0,0,0,0,386,230,53,19,158,1272,110,1162
360610241003,36, New York,061, New York County,157,78,0,0,78,79,78,0,0,78,78,0,0,0,0,594,265,329
360610241004,36, New York,061, New York County,415,134,15,0,119,22,0,0,0,0,393,134,15,0,119,1344,100,1244
360610241005,36, New York,061, New York County,219,51,0,36,15,38,36,0,36,0,181,15,0,0,15,1162,329,833
360610242000,36, New York,061, New York County,0,0,0,0,0,0,0,0,0,0,0,0,0,0,0,0,0,0
360610242001,36, New York,061, New York County,483,345,113,17,215,161,96,0,0,96,322,249,113,17,119,1734,556,1178
360610242002,36, New York,061, New York County,352,202,17,0,185,106,87,17,0,70,246,115,0,0,115,864,211,653
360610242003,36, New York,061, New York County,233,79,33,37,9,29,9,0,0,9,204,70,33,37,0,696,151,545
360610243011,36, New York,061, New York County,473,229,14,0,215,95,70,0,0,70,378,159,14,0,145,1226,174,1052
360610243012,36, New York,061, New York County,332,58,29,9,20,12,12,0,0,12,320,46,29,9,8,1820,169,1651
360610243013,36, New York,061, New York County,144,112,73,0,39,39,39,0,0,39,105,73,73,0,0,207,18,189
360610243020,36, New York,061, New York County,0,0,0,0,0,0,0,0,0,0,0,0,0,0,0,0,0,0
360610243021,36, New York,061, New York County,697,386,23,0,363,277,202,0,0,202,420,184,23,0,161,1990,764,1226
360610243022,36, New York,061, New York County,770,222,34,0,188,246,165,34,0,131,524,57,0,0,57,2010,503,1507
360610243023,36, New York,061, New York County,546,373,83,43,247,205,160,66,0,94,341,213,17,43,153,1227,395,832
360610245001,36, New York,061, New York County,496,188,63,0,125,30,30,0,0,30,466,158,63,0,95,2285,245,2040
360610245002,36, New York,061, New York County,284,199,61,0,138,98,47,0,0,47,186,152,61,0,91,1870,495,1375
360610245003,36, New York,061, New York County,196,134,55,0,79,108,79,0,0,79,88,55,55,0,0,1194,488,706
360610245004,36, New York,061, New York County,376,294,178,0,116,69,25,0,0,25,307,269,178,0,91,1576,371,1205
360610245005,36, New York,061, New York County,454,206,70,34,102,174,102,0,0,102,280,104,70,34,0,1881,630,1251
360610245006,36, New York,061, New York County,129,94,0,74,20,20,20,0,0,20,109,74,0,74,0,855,179,676
360610245007,36, New York,061, New York County,116,0,0,0,0,0,0,0,0,0,116,0,0,0,0,523,153,370
360610247000,36, New York,061, New York County,0,0,0,0,0,0,0,0,0,0,0,0,0,0,0,0,0,0
360610247001,36, New York,061, New York County,345,32,32,0,0,41,0,0,0,0,304,32,32,0,0,875,143,732
360610247002,36, New York,061, New York County,446,170,126,0,44,79,0,0,0,0,367,170,126,0,44,1258,78,1180
360610247003,36, New York,061, New York County,272,28,0,0,28,0,0,0,0,0,272,28,0,0,28,1212,4,1208
360610247004,36, New York,061, New York County,141,74,74,0,0,0,0,0,0,0,141,74,74,0,0,710,80,630
360610247005,36, New York,061, New York County,146,49,49,0,0,53,0,0,0,0,93,49,49,0,0,1042,598,444
360610249001,36, New York,061, New York County,216,68,39,13,16,0,0,0,0,0,216,68,39,13,16,786,42,744
360610251001,36, New York,061, New York County,247,191,69,35,87,76,76,0,25,51,171,115,69,10,36,837,280,557
360610251002,36, New York,061, New York County,259,100,56,0,44,55,29,0,0,29,204,71,56,0,15,784,242,542
360610253001,36, New York,061, New York County,388,184,60,0,124,81,62,0,0,62,307,122,60,0,62,890,141,749
360610253002,36, New York,061, New York County,421,39,39,0,0,149,39,39,0,0,272,0,0,0,0,1237,302,935
360610253003,36, New York,061, New York County,440,323,48,40,235,44,44,0,0,44,396,279,48,40,191,777,52,725
360610253004,36, New York,061, New York County,182,42,42,0,0,0,0,0,0,0,182,42,42,0,0,554,29,525
360610253005,36, New York,061, New York County,287,117,55,62,0,12,0,0,0,0,275,117,55,62,0,1472,207,1265
360610253006,36, New York,061, New York County,331,138,102,0,36,14,0,0,0,0,317,138,102,0,36,1806,239,1567
360610255000,36, New York,061, New York County,0,0,0,0,0,0,0,0,0,0,0,0,0,0,0,0,0,0
360610255001,36, New York,061, New York County,233,117,103,0,14,13,0,0,0,0,220,117,103,0,14,506,123,383
360610255002,36, New York,061, New York County,447,171,53,0,118,85,0,0,0,0,362,171,53,0,118,1431,418,1013
360610255003,36, New York,061, New York County,501,43,11,31,1,91,0,0,0,0,410,43,11,31,1,1626,144,1482
360610255004,36, New York,061, New York County,107,35,0,35,0,30,0,0,0,0,77,35,0,35,0,351,106,245
360610257001,36, New York,061, New York County,170,67,52,15,0,17,0,0,0,0,153,67,52,15,0,968,200,768
360610257002,36, New York,061, New York County,250,93,86,0,7,30,7,0,0,7,220,86,86,0,0,970,166,804
360610257003,36, New York,061, New York County,529,280,218,0,62,89,19,0,0,19,440,261,218,0,43,1572,316,1256
360610259001,36, New York,061, New York County,641,410,134,64,212,47,33,0,0,33,594,377,134,64,179,1338,52,1286
360610259002,36, New York,061, New York County,579,283,80,35,168,113,39,15,0,24,466,244,65,35,144,1466,358,1108
360610261001,36, New York,061, New York County,639,321,0,70,251,228,163,0,0,163,411,158,0,70,88,1438,439,999
360610261002,36, New York,061, New York County,291,107,68,0,39,55,0,0,0,0,236,107,68,0,39,592,107,485
360610261003,36, New York,061, New York County,318,187,67,0,120,23,23,0,0,23,295,164,67,0,97,1112,150,962
360610261004,36, New York,061, New York County,220,112,59,0,53,53,53,0,0,53,167,59,59,0,0,660,139,521
360610261005,36, New York,061, New York County,560,337,90,101,146,272,198,0,52,146,288,139,90,49,0,1845,1021,824
360610261006,36, New York,061, New York County,244,39,0,0,39,36,19,0,0,19,208,20,0,0,20,811,240,571
360610261007,36, New York,061, New York County,462,144,37,107,0,32,0,0,0,0,430,144,37,107,0,1420,175,1245
360610263001,36, New York,061, New York County,452,221,96,15,110,91,60,0,0,60,361,161,96,15,50,1507,248,1259
360610263002,36, New York,061, New York County,282,202,105,11,86,17,17,0,0,17,265,185,105,11,69,1134,186,948
360610263003,36, New York,061, New York County,232,73,0,0,73,109,64,0,0,64,123,9,0,0,9,894,438,456
360610263004,36, New York,061, New York County,560,128,90,0,38,159,114,76,0,38,401,14,14,0,0,1627,340,1287
360610263005,36, New York,061, New York County,264,131,42,0,89,18,18,0,0,18,246,113,42,0,71,637,49,588
360610265001,36, New York,061, New York County,198,118,106,0,12,11,0,0,0,0,187,118,106,0,12,1004,191,813
360610265002,36, New York,061, New York County,434,138,118,0,20,50,0,0,0,0,384,138,118,0,20,1298,121,1177
360610265003,36, New York,061, New York County,130,69,69,0,0,0,0,0,0,0,130,69,69,0,0,625,13,612
360610265004,36, New York,061, New York County,436,186,83,37,66,0,0,0,0,0,436,186,83,37,66,2070,95,1975
360610265005,36, New York,061, New York County,155,139,21,72,46,21,21,21,0,0,134,118,0,72,46,487,80,407
360610267001,36, New York,061, New York County,388,136,76,0,60,57,18,0,0,18,331,118,76,0,42,1143,211,932
360610269001,36, New York,061, New York County,223,106,0,0,106,50,37,0,0,37,173,69,0,0,69,552,177,375
360610269002,36, New York,061, New York County,92,92,63,0,29,0,0,0,0,0,92,92,63,0,29,352,0,352
360610269003,36, New York,061, New York County,79,40,40,0,0,0,0,0,0,0,79,40,40,0,0,442,42,400
360610269004,36, New York,061, New York County,420,61,24,0,37,40,0,0,0,0,380,61,24,0,37,935,162,773
360610269005,36, New York,061, New York County,456,274,172,4,98,15,15,0,0,15,441,259,172,4,83,2302,206,2096
360610269006,36, New York,061, New York County,237,80,0,19,61,19,19,0,19,0,218,61,0,0,61,936,116,820
360610271001,36, New York,061, New York County,328,17,17,0,0,42,0,0,0,0,286,17,17,0,0,1105,161,944
360610271002,36, New York,061, New York County,182,120,36,0,84,52,52,0,0,52,130,68,36,0,32,769,173,596
360610271003,36, New York,061, New York County,355,22,13,0,9,53,0,0,0,0,302,22,13,0,9,1285,309,976
360610271004,36, New York,061, New York County,375,237,59,33,145,0,0,0,0,0,375,237,59,33,145,1629,113,1516
360610271005,36, New York,061, New York County,392,234,100,88,46,42,42,0,42,0,350,192,100,46,46,1207,160,1047
360610273001,36, New York,061, New York County,457,230,164,0,66,21,21,0,0,21,436,209,164,0,45,1112,47,1065
360610273002,36, New York,061, New York County,312,203,203,0,0,19,0,0,0,0,293,203,203,0,0,786,53,733
360610273003,36, New York,061, New York County,604,387,218,0,169,0,0,0,0,0,604,387,218,0,169,2078,57,2021
360610273004,36, New York,061, New York County,357,156,99,57,0,0,0,0,0,0,357,156,99,57,0,1351,73,1278
360610275000,36, New York,061, New York County,0,0,0,0,0,0,0,0,0,0,0,0,0,0,0,0,0,0
360610275001,36, New York,061, New York County,304,158,156,0,2,16,0,0,0,0,288,158,156,0,2,960,108,852
360610275002,36, New York,061, New York County,732,125,104,0,21,13,13,0,0,13,719,112,104,0,8,1637,78,1559
360610277001,36, New York,061, New York County,154,85,64,0,21,0,0,0,0,0,154,85,64,0,21,735,93,642
360610277002,36, New York,061, New York County,134,54,0,30,24,79,24,0,0,24,55,30,0,30,0,463,294,169
360610277003,36, New York,061, New York County,540,267,37,0,230,192,96,0,0,96,348,171,37,0,134,2049,468,1581
360610277004,36, New York,061, New York County,286,238,55,0,183,63,60,0,0,60,223,178,55,0,123,852,263,589
360610279001,36, New York,061, New York County,398,121,13,19,89,100,19,0,19,0,298,102,13,0,89,1057,191,866
360610279002,36, New York,061, New York County,425,256,129,20,107,23,23,0,0,23,402,233,129,20,84,751,54,697
360610279003,36, New York,061, New York County,447,160,40,0,120,55,44,0,0,44,392,116,40,0,76,892,177,715
360610279004,36, New York,061, New York County,395,229,80,0,149,97,97,0,0,97,298,132,80,0,52,1076,389,687
360610279005,36, New York,061, New York County,242,112,91,21,0,0,0,0,0,0,242,112,91,21,0,979,24,955
360610279006,36, New York,061, New York County,418,189,0,82,107,39,16,0,0,16,379,173,0,82,91,1088,176,912
360610279007,36, New York,061, New York County,116,57,57,0,0,0,0,0,0,0,116,57,57,0,0,419,0,419
360610281001,36, New York,061, New York County,162,86,78,0,8,0,0,0,0,0,162,86,78,0,8,724,0,724
360610281002,36, New York,061, New York County,563,296,240,11,45,13,0,0,0,0,550,296,240,11,45,1682,54,1628
360610283001,36, New York,061, New York County,117,58,25,0,33,9,0,0,0,0,108,58,25,0,33,452,40,412
360610283002,36, New York,061, New York County,887,424,310,0,114,96,67,67,0,0,791,357,243,0,114,2553,325,2228
360610283003,36, New York,061, New York County,334,143,48,0,95,80,80,0,0,80,254,63,48,0,15,992,195,797
360610283004,36, New York,061, New York County,565,198,49,53,96,88,46,6,0,40,477,152,43,53,56,1281,120,1161
360610285001,36, New York,061, New York County,641,386,147,139,100,155,106,26,80,0,486,280,121,59,100,1589,739,850
360610285002,36, New York,061, New York County,299,148,27,0,121,26,15,0,0,15,273,133,27,0,106,998,87,911
360610285003,36, New York,061, New York County,318,102,47,27,28,75,55,0,27,28,243,47,47,0,0,1018,186,832
360610285004,36, New York,061, New York County,413,232,80,0,152,103,80,80,0,0,310,152,0,0,152,1377,98,1279
360610287000,36, New York,061, New York County,0,0,0,0,0,0,0,0,0,0,0,0,0,0,0,0,0,0
360610287001,36, New York,061, New York County,199,42,31,0,11,0,0,0,0,0,199,42,31,0,11,748,2,746
360610287002,36, New York,061, New York County,317,146,84,27,35,26,0,0,0,0,291,146,84,27,35,977,84,893
360610287003,36, New York,061, New York County,290,117,54,0,63,61,31,0,0,31,229,86,54,0,32,1195,331,864
360610291001,36, New York,061, New York County,270,132,18,0,114,67,40,0,0,40,203,92,18,0,74,753,149,604
360610291002,36, New York,061, New York County,233,168,66,29,73,82,62,25,0,37,151,106,41,29,36,632,157,475
360610291003,36, New York,061, New York County,266,192,24,79,89,63,63,0,0,63,203,129,24,79,26,1152,289,863
360610291004,36, New York,061, New York County,366,142,91,0,51,66,0,0,0,0,300,142,91,0,51,1395,205,1190
360610291005,36, New York,061, New York County,625,281,202,0,79,39,39,0,0,39,586,242,202,0,40,1533,151,1382
360610291006,36, New York,061, New York County,343,243,103,0,140,0,0,0,0,0,343,243,103,0,140,1416,164,1252
360610291007,36, New York,061, New York County,166,47,47,0,0,30,0,0,0,0,136,47,47,0,0,592,110,482
360610293001,36, New York,061, New York County,529,286,127,0,159,240,240,110,0,130,289,46,17,0,29,1326,567,759
360610293002,36, New York,061, New York County,354,209,75,0,134,82,62,0,0,62,272,147,75,0,72,644,120,524
360610293003,36, New York,061, New York County,520,417,214,36,167,130,101,48,36,17,390,316,166,0,150,1284,201,1083
360610293004,36, New York,061, New York County,234,109,43,0,66,24,0,0,0,0,210,109,43,0,66,866,129,737
360610293005,36, New York,061, New York County,374,281,66,48,167,72,43,0,0,43,302,238,66,48,124,1047,138,909
360610295001,36, New York,061, New York County,499,186,176,0,10,16,0,0,0,0,483,186,176,0,10,1887,53,1834
360610295002,36, New York,061, New York County,246,56,31,0,25,35,25,0,0,25,211,31,31,0,0,1068,147,921
360610295003,36, New York,061, New York County,297,174,126,0,48,0,0,0,0,0,297,174,126,0,48,1101,0,1101
360610295004,36, New York,061, New York County,484,305,213,0,92,0,0,0,0,0,484,305,213,0,92,1385,81,1304
360610297000,36, New York,061, New York County,0,0,0,0,0,0,0,0,0,0,0,0,0,0,0,0,0,0
360610297001,36, New York,061, New York County,0,0,0,0,0,0,0,0,0,0,0,0,0,0,0,0,0,0
360610299000,36, New York,061, New York County,0,0,0,0,0,0,0,0,0,0,0,0,0,0,0,0,0,0
360610299001,36, New York,061, New York County,670,342,41,0,301,204,142,13,0,129,466,200,28,0,172,1928,597,1331
360610299002,36, New York,061, New York County,0,0,0,0,0,0,0,0,0,0,0,0,0,0,0,0,0,0
360610299003,36, New York,061, New York County,175,36,36,0,0,12,0,0,0,0,163,36,36,0,0,763,82,681
360610303001,36, New York,061, New York County,283,181,49,46,86,25,25,25,0,0,258,156,24,46,86,899,183,716
360610303002,36, New York,061, New York County,178,88,42,0,46,0,0,0,0,0,178,88,42,0,46,684,112,572
360610303003,36, New York,061, New York County,332,156,117,0,39,0,0,0,0,0,332,156,117,0,39,1284,64,1220
360610307001,36, New York,061, New York County,138,61,27,0,34,19,19,0,0,19,119,42,27,0,15,560,19,541
360610307002,36, New York,061, New York County,383,178,170,8,0,0,0,0,0,0,383,178,170,8,0,1170,45,1125
360610307003,36, New York,061, New York County,364,188,120,22,46,17,0,0,0,0,347,188,120,22,46,1373,100,1273
360610309001,36, New York,061, New York County,0,0,0,0,0,0,0,0,0,0,0,0,0,0,0,0,0,0
360610309002,36, New York,061, New York County,625,436,223,0,213,172,162,83,0,79,453,274,140,0,134,1406,268,1138
360610309003,36, New York,061, New York County,891,558,0,23,535,220,220,0,23,197,671,338,0,0,338,2039,441,1598
360610309004,36, New York,061, New York County,606,276,114,14,148,113,93,26,0,67,493,183,88,14,81,1577,164,1413
360610309005,36, New York,061, New York County,578,358,192,27,139,115,78,0,0,78,463,280,192,27,61,1458,300,1158
360610311000,36, New York,061, New York County,0,0,0,0,0,0,0,0,0,0,0,0,0,0,0,0,0,0
360610311001,36, New York,061, New York County,0,0,0,0,0,0,0,0,0,0,0,0,0,0,0,0,0,0
360610317030,36, New York,061, New York County,0,0,0,0,0,0,0,0,0,0,0,0,0,0,0,0,0,0
360610317031,36, New York,061, New York County,81,24,24,0,0,0,0,0,0,0,81,24,24,0,0,413,41,372
360610317032,36, New York,061, New York County,799,477,318,122,37,0,0,0,0,0,799,477,318,122,37,1517,0,1517
360610317033,36, New York,061, New York County,791,478,266,135,77,33,33,0,32,1,758,445,266,103,76,2268,51,2217
360610317040,36, New York,061, New York County,0,0,0,0,0,0,0,0,0,0,0,0,0,0,0,0,0,0
360610317041,36, New York,061, New York County,593,289,201,0,88,0,0,0,0,0,593,289,201,0,88,2743,137,2606
360610317042,36, New York,061, New York County,538,285,178,0,107,0,0,0,0,0,538,285,178,0,107,1431,151,1280
360610317043,36, New York,061, New York County,931,414,389,0,25,64,0,0,0,0,867,414,389,0,25,2659,64,2595
360610317044,36, New York,061, New York County,449,83,83,0,0,0,0,0,0,0,449,83,83,0,0,1333,0,1333
360610319000,36, New York,061, New York County,0,0,0,0,0,0,0,0,0,0,0,0,0,0,0,0,0,0
360610319001,36, New York,061, New York County,0,0,0,0,0,0,0,0,0,0,0,0,0,0,0,0,0,0
360710001001,36, New York,071, Orange County,138,23,23,0,0,0,0,0,0,0,138,23,23,0,0,476,72,404
360710001002,36, New York,071, Orange County,244,86,7,0,79,0,0,0,0,0,244,86,7,0,79,568,16,552
360710001003,36, New York,071, Orange County,47,47,0,0,47,13,13,0,0,13,34,34,0,0,34,55,14,41
360710001004,36, New York,071, Orange County,375,181,0,0,181,132,132,0,0,132,243,49,0,0,49,714,190,524
360710002001,36, New York,071, Orange County,451,263,157,30,76,56,56,19,28,9,395,207,138,2,67,986,112,874
360710002002,36, New York,071, Orange County,322,227,167,14,46,28,28,28,0,0,294,199,139,14,46,815,52,763
360710003011,36, New York,071, Orange County,68,66,0,0,66,0,0,0,0,0,68,66,0,0,66,176,95,81
360710003012,36, New York,071, Orange County,328,205,68,0,137,77,77,18,0,59,251,128,50,0,78,1066,428,638
360710003021,36, New York,071, Orange County,270,131,76,0,55,55,55,0,0,55,215,76,76,0,0,705,82,623
360710003022,36, New York,071, Orange County,596,378,148,67,163,40,14,0,14,0,556,364,148,53,163,1402,236,1166
360710003023,36, New York,071, Orange County,260,185,126,0,59,22,22,22,0,0,238,163,104,0,59,816,80,736
360710004001,36, New York,071, Orange County,168,118,9,0,109,71,71,0,0,71,97,47,9,0,38,666,224,442
360710004002,36, New York,071, Orange County,180,112,0,43,69,46,37,0,20,17,134,75,0,23,52,616,162,454
360710004003,36, New York,071, Orange County,211,184,29,0,155,0,0,0,0,0,211,184,29,0,155,557,72,485
360710004004,36, New York,071, Orange County,244,176,66,98,12,98,98,0,98,0,146,78,66,0,12,790,304,486
360710004005,36, New York,071, Orange County,257,188,0,131,57,188,188,0,131,57,69,0,0,0,0,640,402,238
360710005011,36, New York,071, Orange County,253,108,0,27,81,81,81,0,0,81,172,27,0,27,0,538,85,453
360710005012,36, New York,071, Orange County,160,68,0,0,68,127,58,0,0,58,33,10,0,0,10,875,450,425
360710005013,36, New York,071, Orange County,37,0,0,0,0,0,0,0,0,0,37,0,0,0,0,86,0,86
360710005021,36, New York,071, Orange County,259,161,49,66,46,66,66,0,66,0,193,95,49,0,46,577,87,490
360710005022,36, New York,071, Orange County,97,0,0,0,0,0,0,0,0,0,97,0,0,0,0,608,126,482
360710005023,36, New York,071, Orange County,231,191,68,65,58,40,40,0,0,40,191,151,68,65,18,581,58,523
360710005024,36, New York,071, Orange County,263,191,37,0,154,154,154,0,0,154,109,37,37,0,0,592,164,428
360710006001,36, New York,071, Orange County,331,214,73,57,84,65,56,0,0,56,266,158,73,57,28,1108,215,893
360710006002,36, New York,071, Orange County,328,139,98,0,41,145,0,0,0,0,183,139,98,0,41,1137,713,424
360710006003,36, New York,071, Orange County,157,120,21,0,99,12,0,0,0,0,145,120,21,0,99,370,192,178
360710011001,36, New York,071, Orange County,187,0,0,0,0,15,0,0,0,0,172,0,0,0,0,385,107,278
360710011002,36, New York,071, Orange County,321,178,155,0,23,115,101,78,0,23,206,77,77,0,0,549,67,482
360710011003,36, New York,071, Orange County,349,246,152,18,76,0,0,0,0,0,349,246,152,18,76,1362,216,1146
360710011004,36, New York,071, Orange County,268,134,90,44,0,0,0,0,0,0,268,134,90,44,0,672,24,648
360710012001,36, New York,071, Orange County,284,151,102,15,34,47,43,20,15,8,237,108,82,0,26,805,129,676
360710012002,36, New York,071, Orange County,254,206,84,8,114,58,58,0,8,50,196,148,84,0,64,399,75,324
360710013001,36, New York,071, Orange County,284,104,66,0,38,14,0,0,0,0,270,104,66,0,38,945,38,907
360710013002,36, New York,071, Orange County,619,258,225,0,33,72,0,0,0,0,547,258,225,0,33,1434,155,1279
360710015001,36, New York,071, Orange County,224,153,96,0,57,32,32,0,0,32,192,121,96,0,25,524,60,464
360710015002,36, New York,071, Orange County,683,287,146,68,73,41,41,0,0,41,642,246,146,68,32,1993,240,1753
360710015003,36, New York,071, Orange County,297,267,194,0,73,0,0,0,0,0,297,267,194,0,73,747,87,660
360710016011,36, New York,071, Orange County,660,510,341,64,105,81,69,69,0,0,579,441,272,64,105,2025,306,1719
360710016012,36, New York,071, Orange County,451,189,134,0,55,10,0,0,0,0,441,189,134,0,55,1188,49,1139
360710016021,36, New York,071, Orange County,391,196,185,0,11,0,0,0,0,0,391,196,185,0,11,1232,25,1207
360710016022,36, New York,071, Orange County,136,72,70,0,2,0,0,0,0,0,136,72,70,0,2,578,68,510
360710016023,36, New York,071, Orange County,125,30,26,0,4,0,0,0,0,0,125,30,26,0,4,454,26,428
360710021001,36, New York,071, Orange County,187,135,74,0,61,61,61,0,0,61,126,74,74,0,0,457,67,390
360710021002,36, New York,071, Orange County,351,176,93,68,15,79,49,0,34,15,272,127,93,34,0,1144,168,976
360710021003,36, New York,071, Orange County,179,118,42,41,35,52,28,28,0,0,127,90,14,41,35,634,221,413
360710022001,36, New York,071, Orange County,188,59,18,6,35,46,29,18,0,11,142,30,0,6,24,574,106,468
360710022002,36, New York,071, Orange County,176,70,13,0,57,0,0,0,0,0,176,70,13,0,57,670,56,614
360710022003,36, New York,071, Orange County,234,159,84,0,75,104,82,36,0,46,130,77,48,0,29,1273,360,913
360710023001,36, New York,071, Orange County,318,163,85,33,45,44,36,36,0,0,274,127,49,33,45,887,210,677
360710023002,36, New York,071, Orange County,214,153,130,10,13,21,7,0,0,7,193,146,130,10,6,760,148,612
360710101011,36, New York,071, Orange County,476,329,262,28,39,157,144,144,0,0,319,185,118,28,39,1454,428,1026
360710101012,36, New York,071, Orange County,264,118,118,0,0,0,0,0,0,0,264,118,118,0,0,834,11,823
360710101013,36, New York,071, Orange County,544,221,168,36,17,0,0,0,0,0,544,221,168,36,17,1475,25,1450
360710101021,36, New York,071, Orange County,242,144,144,0,0,0,0,0,0,0,242,144,144,0,0,656,22,634
360710101022,36, New York,071, Orange County,347,156,142,14,0,0,0,0,0,0,347,156,142,14,0,970,15,955
360710101023,36, New York,071, Orange County,389,84,84,0,0,0,0,0,0,0,389,84,84,0,0,1092,7,1085
360710101024,36, New York,071, Orange County,220,155,143,0,12,0,0,0,0,0,220,155,143,0,12,806,17,789
360710102001,36, New York,071, Orange County,296,63,53,0,10,0,0,0,0,0,296,63,53,0,10,1112,13,1099
360710102002,36, New York,071, Orange County,335,116,100,10,6,10,0,0,0,0,325,116,100,10,6,936,75,861
360710102003,36, New York,071, Orange County,400,122,45,36,41,12,0,0,0,0,388,122,45,36,41,1016,24,992
360710102004,36, New York,071, Orange County,389,140,95,0,45,18,7,7,0,0,371,133,88,0,45,1186,64,1122
360710103001,36, New York,071, Orange County,321,81,43,25,13,25,25,0,25,0,296,56,43,0,13,714,48,666
360710103002,36, New York,071, Orange County,320,212,158,0,54,29,29,29,0,0,291,183,129,0,54,881,60,821
360710103003,36, New York,071, Orange County,326,102,24,0,78,12,0,0,0,0,314,102,24,0,78,968,92,876
360710104001,36, New York,071, Orange County,305,171,160,0,11,13,13,13,0,0,292,158,147,0,11,653,52,601
360710104002,36, New York,071, Orange County,177,96,22,29,45,11,11,0,11,0,166,85,22,18,45,485,21,464
360710104003,36, New York,071, Orange County,567,183,93,19,71,19,19,0,19,0,548,164,93,0,71,1725,138,1587
360710105011,36, New York,071, Orange County,563,312,139,0,173,27,0,0,0,0,536,312,139,0,173,1517,157,1360
360710105012,36, New York,071, Orange County,371,192,145,14,33,0,0,0,0,0,371,192,145,14,33,1225,0,1225
360710105013,36, New York,071, Orange County,268,75,57,0,18,18,18,0,0,18,250,57,57,0,0,746,18,728
360710105021,36, New York,071, Orange County,327,165,154,0,11,0,0,0,0,0,327,165,154,0,11,847,39,808
360710105022,36, New York,071, Orange County,332,150,150,0,0,0,0,0,0,0,332,150,150,0,0,1047,21,1026
360710105023,36, New York,071, Orange County,168,33,33,0,0,0,0,0,0,0,168,33,33,0,0,591,0,591
360710105024,36, New York,071, Orange County,475,135,52,72,11,80,60,21,39,0,395,75,31,33,11,1526,138,1388
360710106011,36, New York,071, Orange County,624,264,251,0,13,0,0,0,0,0,624,264,251,0,13,1763,16,1747
360710106012,36, New York,071, Orange County,199,72,13,59,0,0,0,0,0,0,199,72,13,59,0,499,22,477
360710106021,36, New York,071, Orange County,394,230,198,0,32,9,9,0,0,9,385,221,198,0,23,1184,37,1147
360710106022,36, New York,071, Orange County,319,191,115,29,47,15,15,15,0,0,304,176,100,29,47,657,103,554
360710106023,36, New York,071, Orange County,259,68,68,0,0,0,0,0,0,0,259,68,68,0,0,686,5,681
360710107011,36, New York,071, Orange County,247,174,140,0,34,30,30,0,0,30,217,144,140,0,4,795,32,763
360710107012,36, New York,071, Orange County,239,151,117,0,34,17,0,0,0,0,222,151,117,0,34,928,115,813
360710107021,36, New York,071, Orange County,198,18,18,0,0,0,0,0,0,0,198,18,18,0,0,756,119,637
360710107022,36, New York,071, Orange County,392,110,39,0,71,31,31,0,0,31,361,79,39,0,40,1048,209,839
360710107023,36, New York,071, Orange County,174,127,98,13,16,16,16,0,0,16,158,111,98,13,0,629,146,483
360710107024,36, New York,071, Orange County,382,228,145,34,49,121,121,112,0,9,261,107,33,34,40,858,174,684
360710108011,36, New York,071, Orange County,182,162,162,0,0,0,0,0,0,0,182,162,162,0,0,806,37,769
360710108012,36, New York,071, Orange County,585,240,180,19,41,10,0,0,0,0,575,240,180,19,41,1709,147,1562
360710108013,36, New York,071, Orange County,242,128,42,9,77,0,0,0,0,0,242,128,42,9,77,944,74,870
360710108021,36, New York,071, Orange County,357,183,115,27,41,13,13,0,13,0,344,170,115,14,41,1260,169,1091
360710108022,36, New York,071, Orange County,280,40,19,12,9,0,0,0,0,0,280,40,19,12,9,1199,231,968
360710108023,36, New York,071, Orange County,526,298,205,80,13,80,80,0,80,0,446,218,205,0,13,1588,138,1450
360710109011,36, New York,071, Orange County,459,275,160,85,30,16,10,0,10,0,443,265,160,75,30,1264,112,1152
360710109012,36, New York,071, Orange County,366,173,115,41,17,25,0,0,0,0,341,173,115,41,17,1364,114,1250
360710109021,36, New York,071, Orange County,586,337,315,0,22,22,22,0,0,22,564,315,315,0,0,1521,108,1413
360710109022,36, New York,071, Orange County,255,91,91,0,0,0,0,0,0,0,255,91,91,0,0,886,31,855
360710109023,36, New York,071, Orange County,259,100,87,0,13,0,0,0,0,0,259,100,87,0,13,652,3,649
360710109024,36, New York,071, Orange County,280,127,92,7,28,10,10,0,0,10,270,117,92,7,18,952,34,918
360710110001,36, New York,071, Orange County,256,138,132,0,6,0,0,0,0,0,256,138,132,0,6,1025,38,987
360710110002,36, New York,071, Orange County,573,149,83,52,14,0,0,0,0,0,573,149,83,52,14,1420,80,1340
360710110003,36, New York,071, Orange County,228,119,119,0,0,16,16,16,0,0,212,103,103,0,0,555,91,464
360710110004,36, New York,071, Orange County,172,127,86,35,6,11,11,0,11,0,161,116,86,24,6,619,79,540
360710110005,36, New York,071, Orange County,137,68,55,0,13,0,0,0,0,0,137,68,55,0,13,474,44,430
360710111011,36, New York,071, Orange County,235,87,72,10,5,10,10,5,0,5,225,77,67,10,0,637,28,609
360710111012,36, New York,071, Orange County,679,412,263,0,149,46,30,12,0,18,633,382,251,0,131,1878,168,1710
360710111021,36, New York,071, Orange County,402,212,27,36,149,74,74,11,0,63,328,138,16,36,86,1450,161,1289
360710111022,36, New York,071, Orange County,452,195,126,17,52,32,32,32,0,0,420,163,94,17,52,1222,104,1118
360710111023,36, New York,071, Orange County,276,79,79,0,0,0,0,0,0,0,276,79,79,0,0,705,25,680
360710112001,36, New York,071, Orange County,241,111,59,25,27,13,0,0,0,0,228,111,59,25,27,747,43,704
360710112002,36, New York,071, Orange County,134,2,2,0,0,7,0,0,0,0,127,2,2,0,0,581,52,529
360710112003,36, New York,071, Orange County,250,160,0,76,84,76,76,0,76,0,174,84,0,0,84,668,146,522
360710112004,36, New York,071, Orange County,527,230,150,17,63,0,0,0,0,0,527,230,150,17,63,1498,16,1482
360710113011,36, New York,071, Orange County,376,161,20,24,117,58,58,0,0,58,318,103,20,24,59,994,200,794
360710113012,36, New York,071, Orange County,540,388,220,45,123,126,126,0,45,81,414,262,220,0,42,1276,416,860
360710113013,36, New York,071, Orange County,208,54,23,31,0,0,0,0,0,0,208,54,23,31,0,617,18,599
360710113021,36, New York,071, Orange County,238,56,33,0,23,40,23,0,0,23,198,33,33,0,0,1218,186,1032
360710113022,36, New York,071, Orange County,206,57,31,0,26,39,26,0,0,26,167,31,31,0,0,643,81,562
360710113023,36, New York,071, Orange County,227,152,135,17,0,0,0,0,0,0,227,152,135,17,0,665,16,649
360710114001,36, New York,071, Orange County,550,283,231,6,46,33,12,12,0,0,517,271,219,6,46,1622,115,1507
360710114002,36, New York,071, Orange County,238,54,31,0,23,11,0,0,0,0,227,54,31,0,23,709,54,655
360710114003,36, New York,071, Orange County,401,75,51,0,24,0,0,0,0,0,401,75,51,0,24,1135,18,1117
360710115001,36, New York,071, Orange County,31,0,0,0,0,0,0,0,0,0,31,0,0,0,0,63,0,63
360710115002,36, New York,071, Orange County,320,101,66,0,35,2,2,0,0,2,318,99,66,0,33,1112,9,1103
360710115003,36, New York,071, Orange County,199,93,93,0,0,0,0,0,0,0,199,93,93,0,0,598,7,591
360710115004,36, New York,071, Orange County,324,151,151,0,0,0,0,0,0,0,324,151,151,0,0,785,21,764
360710115005,36, New York,071, Orange County,515,249,158,35,56,28,22,10,10,2,487,227,148,25,54,1549,119,1430
360710116011,36, New York,071, Orange County,295,148,72,35,41,15,0,0,0,0,280,148,72,35,41,1158,132,1026
360710116012,36, New York,071, Orange County,377,156,101,13,42,71,37,20,0,17,306,119,81,13,25,1341,259,1082
360710116013,36, New York,071, Orange County,153,12,12,0,0,0,0,0,0,0,153,12,12,0,0,473,0,473
360710116021,36, New York,071, Orange County,171,66,19,42,5,5,5,0,0,5,166,61,19,42,0,454,14,440
360710116022,36, New York,071, Orange County,256,188,174,0,14,25,0,0,0,0,231,188,174,0,14,562,67,495
360710116023,36, New York,071, Orange County,353,150,93,57,0,0,0,0,0,0,353,150,93,57,0,944,35,909
360710116024,36, New York,071, Orange County,294,52,41,0,11,20,0,0,0,0,274,52,41,0,11,879,108,771
360710117011,36, New York,071, Orange County,554,293,245,13,35,10,0,0,0,0,544,293,245,13,35,1304,67,1237
360710117012,36, New York,071, Orange County,510,349,315,16,18,10,0,0,0,0,500,349,315,16,18,1524,56,1468
360710117013,36, New York,071, Orange County,130,60,60,0,0,0,0,0,0,0,130,60,60,0,0,498,24,474
360710117021,36, New York,071, Orange County,454,287,153,0,134,50,50,43,0,7,404,237,110,0,127,1145,107,1038
360710117022,36, New York,071, Orange County,479,214,133,0,81,49,49,0,0,49,430,165,133,0,32,1339,124,1215
360710117023,36, New York,071, Orange County,305,133,86,16,31,31,31,0,0,31,274,102,86,16,0,850,33,817
360710118011,36, New York,071, Orange County,540,154,113,23,18,31,18,0,0,18,509,136,113,23,0,1622,128,1494
360710118012,36, New York,071, Orange County,131,61,11,50,0,0,0,0,0,0,131,61,11,50,0,257,0,257
360710118013,36, New York,071, Orange County,718,380,318,36,26,22,22,22,0,0,696,358,296,36,26,1882,87,1795
360710118021,36, New York,071, Orange County,293,98,43,10,45,0,0,0,0,0,293,98,43,10,45,819,35,784
360710118022,36, New York,071, Orange County,372,137,84,8,45,0,0,0,0,0,372,137,84,8,45,1051,57,994
360710119001,36, New York,071, Orange County,412,191,170,0,21,17,17,17,0,0,395,174,153,0,21,1211,62,1149
360710119002,36, New York,071, Orange County,414,126,126,0,0,0,0,0,0,0,414,126,126,0,0,1165,35,1130
360710119003,36, New York,071, Orange County,12,0,0,0,0,0,0,0,0,0,12,0,0,0,0,80,41,39
360710119004,36, New York,071, Orange County,13,0,0,0,0,0,0,0,0,0,13,0,0,0,0,27,0,27
360710119005,36, New York,071, Orange County,525,337,301,13,23,22,22,22,0,0,503,315,279,13,23,1503,70,1433
360710121001,36, New York,071, Orange County,209,110,103,0,7,0,0,0,0,0,209,110,103,0,7,672,0,672
360710121002,36, New York,071, Orange County,246,126,84,0,42,0,0,0,0,0,246,126,84,0,42,461,0,461
360710121003,36, New York,071, Orange County,293,55,47,8,0,0,0,0,0,0,293,55,47,8,0,903,9,894
360710121004,36, New York,071, Orange County,175,40,40,0,0,0,0,0,0,0,175,40,40,0,0,615,16,599
360710122001,36, New York,071, Orange County,432,187,156,21,10,16,0,0,0,0,416,187,156,21,10,1454,51,1403
360710122002,36, New York,071, Orange County,286,106,81,0,25,0,0,0,0,0,286,106,81,0,25,877,16,861
360710122003,36, New York,071, Orange County,270,140,97,0,43,0,0,0,0,0,270,140,97,0,43,746,65,681
360710123001,36, New York,071, Orange County,251,90,77,0,13,94,0,0,0,0,157,90,77,0,13,558,0,558
360710123002,36, New York,071, Orange County,609,334,246,27,61,17,17,0,0,17,592,317,246,27,44,1547,49,1498
360710123003,36, New York,071, Orange County,257,163,74,0,89,28,28,0,0,28,229,135,74,0,61,695,28,667
360710123004,36, New York,071, Orange County,346,129,107,22,0,0,0,0,0,0,346,129,107,22,0,1071,18,1053
360710126011,36, New York,071, Orange County,630,284,216,39,29,9,0,0,0,0,621,284,216,39,29,1694,142,1552
360710126012,36, New York,071, Orange County,693,269,215,9,45,37,0,0,0,0,656,269,215,9,45,2122,167,1955
360710126021,36, New York,071, Orange County,232,94,94,0,0,0,0,0,0,0,232,94,94,0,0,776,25,751
360710126022,36, New York,071, Orange County,242,156,101,26,29,21,13,0,0,13,221,143,101,26,16,376,51,325
360710126023,36, New York,071, Orange County,148,92,13,0,79,5,5,0,0,5,143,87,13,0,74,709,61,648
360710127001,36, New York,071, Orange County,198,19,0,0,19,0,0,0,0,0,198,19,0,0,19,675,11,664
360710127002,36, New York,071, Orange County,151,77,54,10,13,0,0,0,0,0,151,77,54,10,13,407,106,301
360710127003,36, New York,071, Orange County,127,44,30,13,1,8,0,0,0,0,119,44,30,13,1,398,29,369
360710127004,36, New York,071, Orange County,314,190,99,9,82,105,82,0,0,82,209,108,99,9,0,686,130,556
360710127005,36, New York,071, Orange County,263,90,0,0,90,22,22,0,0,22,241,68,0,0,68,755,22,733
360710128001,36, New York,071, Orange County,211,124,124,0,0,0,0,0,0,0,211,124,124,0,0,589,13,576
360710128002,36, New York,071, Orange County,308,96,96,0,0,26,0,0,0,0,282,96,96,0,0,1230,110,1120
360710128003,36, New York,071, Orange County,158,40,40,0,0,0,0,0,0,0,158,40,40,0,0,488,0,488
360710128004,36, New York,071, Orange County,273,118,38,20,60,39,39,0,0,39,234,79,38,20,21,1080,196,884
360710128005,36, New York,071, Orange County,131,49,27,0,22,15,15,0,0,15,116,34,27,0,7,538,60,478
360710129001,36, New York,071, Orange County,302,101,73,6,22,0,0,0,0,0,302,101,73,6,22,789,20,769
360710129002,36, New York,071, Orange County,278,157,114,18,25,25,25,0,0,25,253,132,114,18,0,727,66,661
360710129003,36, New York,071, Orange County,339,162,116,41,5,5,0,0,0,0,334,162,116,41,5,908,18,890
360710130001,36, New York,071, Orange County,346,184,148,9,27,9,9,0,9,0,337,175,148,0,27,849,35,814
360710130002,36, New York,071, Orange County,246,92,64,0,28,20,8,0,0,8,226,84,64,0,20,669,82,587
360710130003,36, New York,071, Orange County,246,198,167,11,20,0,0,0,0,0,246,198,167,11,20,831,11,820
360710130004,36, New York,071, Orange County,199,64,34,0,30,0,0,0,0,0,199,64,34,0,30,932,42,890
360710131001,36, New York,071, Orange County,238,191,107,68,16,0,0,0,0,0,238,191,107,68,16,780,0,780
360710131002,36, New York,071, Orange County,285,93,48,13,32,0,0,0,0,0,285,93,48,13,32,858,19,839
360710131003,36, New York,071, Orange County,403,176,163,0,13,15,0,0,0,0,388,176,163,0,13,1290,59,1231
360710131004,36, New York,071, Orange County,167,19,19,0,0,0,0,0,0,0,167,19,19,0,0,400,0,400
360710131005,36, New York,071, Orange County,283,62,41,21,0,0,0,0,0,0,283,62,41,21,0,829,53,776
360710132011,36, New York,071, Orange County,271,114,107,0,7,0,0,0,0,0,271,114,107,0,7,746,0,746
360710132012,36, New York,071, Orange County,137,46,25,0,21,20,20,0,0,20,117,26,25,0,1,417,20,397
360710132013,36, New York,071, Orange County,319,116,76,0,40,18,0,0,0,0,301,116,76,0,40,1085,226,859
360710132014,36, New York,071, Orange County,606,244,144,34,66,18,0,0,0,0,588,244,144,34,66,1831,60,1771
360710132021,36, New York,071, Orange County,304,199,145,0,54,0,0,0,0,0,304,199,145,0,54,773,7,766
360710132022,36, New York,071, Orange County,246,115,98,4,13,15,9,7,0,2,231,106,91,4,11,807,66,741
360710133011,36, New York,071, Orange County,561,284,247,0,37,21,21,0,0,21,540,263,247,0,16,1737,50,1687
360710133012,36, New York,071, Orange County,310,225,225,0,0,31,31,31,0,0,279,194,194,0,0,1052,94,958
360710133013,36, New York,071, Orange County,262,50,50,0,0,0,0,0,0,0,262,50,50,0,0,779,49,730
360710133021,36, New York,071, Orange County,251,163,136,0,27,6,0,0,0,0,245,163,136,0,27,700,27,673
360710133022,36, New York,071, Orange County,239,110,90,0,20,0,0,0,0,0,239,110,90,0,20,852,17,835
360710134001,36, New York,071, Orange County,90,19,19,0,0,7,0,0,0,0,83,19,19,0,0,521,61,460
360710134002,36, New York,071, Orange County,133,18,15,3,0,0,0,0,0,0,133,18,15,3,0,381,20,361
360710134003,36, New York,071, Orange County,517,347,301,24,22,188,188,157,24,7,329,159,144,0,15,1316,527,789
360710135001,36, New York,071, Orange County,459,269,187,0,82,82,82,0,0,82,377,187,187,0,0,1355,82,1273
360710135002,36, New York,071, Orange County,668,377,377,0,0,0,0,0,0,0,668,377,377,0,0,1863,43,1820
360710135003,36, New York,071, Orange County,391,198,83,32,83,80,64,0,0,64,311,134,83,32,19,1227,174,1053
360710136001,36, New York,071, Orange County,945,789,695,31,63,22,11,0,11,0,923,778,695,20,63,2199,122,2077
360710137001,36, New York,071, Orange County,272,135,56,0,79,0,0,0,0,0,272,135,56,0,79,1075,48,1027
360710137002,36, New York,071, Orange County,278,134,103,31,0,17,17,17,0,0,261,117,86,31,0,994,76,918
360710138001,36, New York,071, Orange County,113,84,50,0,34,15,15,0,0,15,98,69,50,0,19,432,43,389
360710138002,36, New York,071, Orange County,435,219,201,0,18,14,0,0,0,0,421,219,201,0,18,1357,41,1316
360710138003,36, New York,071, Orange County,308,105,87,0,18,14,0,0,0,0,294,105,87,0,18,836,73,763
360710139001,36, New York,071, Orange County,202,100,100,0,0,0,0,0,0,0,202,100,100,0,0,495,17,478
360710139002,36, New York,071, Orange County,100,49,36,0,13,0,0,0,0,0,100,49,36,0,13,369,0,369
360710139003,36, New York,071, Orange County,347,201,186,0,15,10,0,0,0,0,337,201,186,0,15,816,36,780
360710139004,36, New York,071, Orange County,641,238,200,0,38,0,0,0,0,0,641,238,200,0,38,1951,15,1936
360710141011,36, New York,071, Orange County,246,134,134,0,0,69,69,69,0,0,177,65,65,0,0,525,75,450
360710141012,36, New York,071, Orange County,348,171,122,0,49,7,0,0,0,0,341,171,122,0,49,991,123,868
360710141013,36, New York,071, Orange County,565,278,223,0,55,2,2,2,0,0,563,276,221,0,55,1525,37,1488
360710141021,36, New York,071, Orange County,382,244,208,0,36,60,60,60,0,0,322,184,148,0,36,999,115,884
360710141022,36, New York,071, Orange County,249,153,104,0,49,0,0,0,0,0,249,153,104,0,49,810,0,810
360710141023,36, New York,071, Orange County,265,146,77,23,46,10,10,10,0,0,255,136,67,23,46,783,36,747
360710141024,36, New York,071, Orange County,482,206,130,0,76,56,22,17,0,5,426,184,113,0,71,1301,134,1167
360710142011,36, New York,071, Orange County,331,66,57,0,9,28,28,28,0,0,303,38,29,0,9,844,77,767
360710142012,36, New York,071, Orange County,242,124,76,44,4,0,0,0,0,0,242,124,76,44,4,540,4,536
360710142013,36, New York,071, Orange County,555,328,211,0,117,0,0,0,0,0,555,328,211,0,117,1429,0,1429
360710142021,36, New York,071, Orange County,263,47,47,0,0,0,0,0,0,0,263,47,47,0,0,800,0,800
360710142022,36, New York,071, Orange County,589,368,238,110,20,0,0,0,0,0,589,368,238,110,20,1296,6,1290
360710142023,36, New York,071, Orange County,312,160,134,0,26,0,0,0,0,0,312,160,134,0,26,848,26,822
360710142024,36, New York,071, Orange County,377,288,217,52,19,19,19,0,0,19,358,269,217,52,0,886,19,867
360710142025,36, New York,071, Orange County,326,81,40,0,41,0,0,0,0,0,326,81,40,0,41,1203,60,1143
360710143011,36, New York,071, Orange County,201,61,61,0,0,0,0,0,0,0,201,61,61,0,0,574,52,522
360710143012,36, New York,071, Orange County,320,32,32,0,0,71,0,0,0,0,249,32,32,0,0,1242,163,1079
360710143013,36, New York,071, Orange County,200,170,151,0,19,0,0,0,0,0,200,170,151,0,19,587,12,575
360710143014,36, New York,071, Orange County,368,144,127,0,17,0,0,0,0,0,368,144,127,0,17,1369,40,1329
360710143021,36, New York,071, Orange County,435,356,311,26,19,0,0,0,0,0,435,356,311,26,19,1281,46,1235
360710143022,36, New York,071, Orange County,661,243,144,24,75,24,24,0,24,0,637,219,144,0,75,2415,222,2193
360710143023,36, New York,071, Orange County,294,110,74,18,18,0,0,0,0,0,294,110,74,18,18,879,0,879
360710143024,36, New York,071, Orange County,495,205,128,20,57,0,0,0,0,0,495,205,128,20,57,1607,267,1340
360710144001,36, New York,071, Orange County,188,45,35,7,3,15,7,0,7,0,173,38,35,0,3,640,12,628
360710144002,36, New York,071, Orange County,452,238,220,0,18,29,10,0,0,10,423,228,220,0,8,987,99,888
360710144003,36, New York,071, Orange County,230,150,124,0,26,19,0,0,0,0,211,150,124,0,26,643,143,500
360710144004,36, New York,071, Orange County,421,173,146,6,21,19,19,0,0,19,402,154,146,6,2,1288,62,1226
360710145011,36, New York,071, Orange County,331,146,133,0,13,0,0,0,0,0,331,146,133,0,13,1029,37,992
360710145012,36, New York,071, Orange County,368,156,96,60,0,0,0,0,0,0,368,156,96,60,0,1065,21,1044
360710145013,36, New York,071, Orange County,431,153,113,0,40,0,0,0,0,0,431,153,113,0,40,1100,8,1092
360710145021,36, New York,071, Orange County,472,164,144,0,20,12,0,0,0,0,460,164,144,0,20,1649,46,1603
360710145022,36, New York,071, Orange County,361,112,91,0,21,22,0,0,0,0,339,112,91,0,21,1147,45,1102
360710145023,36, New York,071, Orange County,725,298,273,0,25,0,0,0,0,0,725,298,273,0,25,1738,128,1610
360710146011,36, New York,071, Orange County,74,0,0,0,0,14,0,0,0,0,60,0,0,0,0,723,77,646
360710146012,36, New York,071, Orange County,237,125,79,36,10,0,0,0,0,0,237,125,79,36,10,581,0,581
360710146013,36, New York,071, Orange County,258,100,0,23,77,32,32,0,0,32,226,68,0,23,45,641,100,541
360710146014,36, New York,071, Orange County,217,91,91,0,0,0,0,0,0,0,217,91,91,0,0,568,0,568
360710146021,36, New York,071, Orange County,297,140,97,24,19,19,19,0,0,19,278,121,97,24,0,796,77,719
360710146022,36, New York,071, Orange County,242,115,115,0,0,0,0,0,0,0,242,115,115,0,0,824,82,742
360710146023,36, New York,071, Orange County,371,141,141,0,0,38,0,0,0,0,333,141,141,0,0,924,77,847
360710147001,36, New York,071, Orange County,483,139,139,0,0,0,0,0,0,0,483,139,139,0,0,1305,0,1305
360710147002,36, New York,071, Orange County,738,239,224,0,15,15,15,0,0,15,723,224,224,0,0,2003,35,1968
360710148011,36, New York,071, Orange County,169,75,75,0,0,0,0,0,0,0,169,75,75,0,0,605,187,418
360710148012,36, New York,071, Orange County,411,177,132,23,22,54,54,54,0,0,357,123,78,23,22,894,0,894
360710148013,36, New York,071, Orange County,278,64,64,0,0,45,45,45,0,0,233,19,19,0,0,928,151,777
360710148021,36, New York,071, Orange County,218,90,90,0,0,0,0,0,0,0,218,90,90,0,0,577,0,577
360710148022,36, New York,071, Orange County,252,144,65,0,79,0,0,0,0,0,252,144,65,0,79,711,0,711
360710148023,36, New York,071, Orange County,204,113,57,0,56,0,0,0,0,0,204,113,57,0,56,722,28,694
360710149001,36, New York,071, Orange County,274,139,80,53,6,37,24,24,0,0,237,115,56,53,6,906,130,776
360710149002,36, New York,071, Orange County,307,45,44,0,1,3,1,0,0,1,304,44,44,0,0,678,8,670
360710149003,36, New York,071, Orange County,455,180,167,0,13,7,0,0,0,0,448,180,167,0,13,1356,58,1298
360710150031,36, New York,071, Orange County,305,227,227,0,0,156,88,88,0,0,149,139,139,0,0,829,511,318
360710150032,36, New York,071, Orange County,985,922,922,0,0,242,195,195,0,0,743,727,727,0,0,2133,485,1648
360710150033,36, New York,071, Orange County,494,393,393,0,0,153,138,138,0,0,341,255,255,0,0,940,279,661
360710150051,36, New York,071, Orange County,713,620,620,0,0,224,224,224,0,0,489,396,396,0,0,1721,471,1250
360710150052,36, New York,071, Orange County,463,406,367,0,39,191,191,191,0,0,272,215,176,0,39,996,397,599
360710150071,36, New York,071, Orange County,507,507,507,0,0,289,289,289,0,0,218,218,218,0,0,1365,815,550
360710150072,36, New York,071, Orange County,303,285,285,0,0,196,190,190,0,0,107,95,95,0,0,670,431,239
360710150073,36, New York,071, Orange County,149,149,149,0,0,104,104,104,0,0,45,45,45,0,0,340,250,90
360710150081,36, New York,071, Orange County,591,431,431,0,0,259,254,254,0,0,332,177,177,0,0,1452,670,782
360710150082,36, New York,071, Orange County,335,229,205,8,16,170,146,130,0,16,165,83,75,8,0,784,368,416
360710150091,36, New York,071, Orange County,411,316,316,0,0,141,136,136,0,0,270,180,180,0,0,810,256,554
360710150092,36, New York,071, Orange County,124,119,119,0,0,14,14,14,0,0,110,105,105,0,0,334,26,308
360710150101,36, New York,071, Orange County,149,79,79,0,0,84,67,67,0,0,65,12,12,0,0,330,166,164
360710150102,36, New York,071, Orange County,373,351,346,0,5,140,140,135,0,5,233,211,211,0,0,785,319,466
360710150103,36, New York,071, Orange County,342,280,269,0,11,81,77,66,0,11,261,203,203,0,0,877,253,624
360710151001,36, New York,071, Orange County,142,119,103,0,16,45,45,45,0,0,97,74,58,0,16,537,141,396
360710151002,36, New York,071, Orange County,316,114,62,52,0,0,0,0,0,0,316,114,62,52,0,755,39,716
360710151003,36, New York,071, Orange County,142,21,0,12,9,9,9,0,0,9,133,12,0,12,0,466,21,445
360710151004,36, New York,071, Orange County,193,161,88,56,17,17,17,0,0,17,176,144,88,56,0,591,197,394
360710151005,36, New York,071, Orange County,340,324,80,36,208,115,115,60,0,55,225,209,20,36,153,960,122,838
360710151006,36, New York,071, Orange County,161,67,13,0,54,0,0,0,0,0,161,67,13,0,54,582,207,375
360710152011,36, New York,071, Orange County,511,182,121,0,61,17,17,17,0,0,494,165,104,0,61,1384,102,1282
360710152012,36, New York,071, Orange County,583,382,339,20,23,35,0,0,0,0,548,382,339,20,23,1671,148,1523
360710152021,36, New York,071, Orange County,738,585,566,11,8,0,0,0,0,0,738,585,566,11,8,1496,0,1496
360710152022,36, New York,071, Orange County,430,188,145,0,43,19,19,0,0,19,411,169,145,0,24,1089,35,1054
360710152023,36, New York,071, Orange County,386,74,74,0,0,14,14,14,0,0,372,60,60,0,0,1041,48,993
360710152031,36, New York,071, Orange County,275,144,81,51,12,0,0,0,0,0,275,144,81,51,12,657,32,625
360710152032,36, New York,071, Orange County,161,110,110,0,0,0,0,0,0,0,161,110,110,0,0,351,0,351
360530301011,36, New York,053, Madison County,221,50,35,8,7,35,8,0,8,0,186,42,35,0,7,805,116,689
360530301012,36, New York,053, Madison County,210,38,9,0,29,18,18,0,0,18,192,20,9,0,11,984,83,901
360530301021,36, New York,053, Madison County,170,52,52,0,0,20,0,0,0,0,150,52,52,0,0,580,98,482
360530301022,36, New York,053, Madison County,450,311,67,22,222,94,94,6,6,82,356,217,61,16,140,1741,442,1299
360530301023,36, New York,053, Madison County,157,91,91,0,0,0,0,0,0,0,157,91,91,0,0,599,24,575
360530301024,36, New York,053, Madison County,290,245,156,28,61,4,4,0,4,0,286,241,156,24,61,945,19,926
360530301031,36, New York,053, Madison County,396,151,99,25,27,48,24,0,0,24,348,127,99,25,3,1163,103,1060
360530301032,36, New York,053, Madison County,237,79,69,0,10,13,0,0,0,0,224,79,69,0,10,735,29,706
360530301033,36, New York,053, Madison County,216,110,94,0,16,0,0,0,0,0,216,110,94,0,16,570,51,519
360530302001,36, New York,053, Madison County,201,82,82,0,0,7,0,0,0,0,194,82,82,0,0,604,56,548
360530302002,36, New York,053, Madison County,235,56,51,0,5,6,6,6,0,0,229,50,45,0,5,843,37,806
360530302003,36, New York,053, Madison County,431,188,162,15,11,3,2,0,0,2,428,186,162,15,9,1265,73,1192
360530303001,36, New York,053, Madison County,410,284,177,20,87,24,24,2,17,5,386,260,175,3,82,1233,103,1130
360530303002,36, New York,053, Madison County,332,204,80,66,58,63,33,0,0,33,269,171,80,66,25,1024,218,806
360530303003,36, New York,053, Madison County,182,76,64,0,12,12,12,0,0,12,170,64,64,0,0,572,19,553
360530303004,36, New York,053, Madison County,355,181,99,0,82,2,0,0,0,0,353,181,99,0,82,1245,24,1221
360530304011,36, New York,053, Madison County,177,112,73,4,35,19,2,0,0,2,158,110,73,4,33,521,65,456
360530304012,36, New York,053, Madison County,806,479,316,133,30,152,139,0,133,6,654,340,316,0,24,1969,209,1760
360530304013,36, New York,053, Madison County,391,159,85,41,33,50,24,0,0,24,341,135,85,41,9,1067,173,894
360530304021,36, New York,053, Madison County,483,148,117,0,31,15,0,0,0,0,468,148,117,0,31,1404,80,1324
360530304022,36, New York,053, Madison County,401,207,96,9,102,0,0,0,0,0,401,207,96,9,102,969,7,962
360530304031,36, New York,053, Madison County,430,140,64,0,76,0,0,0,0,0,430,140,64,0,76,1525,22,1503
360530304032,36, New York,053, Madison County,259,123,113,10,0,5,5,0,5,0,254,118,113,5,0,754,23,731
360530304033,36, New York,053, Madison County,317,113,99,0,14,9,5,0,0,5,308,108,99,0,9,948,42,906
360530304041,36, New York,053, Madison County,366,107,66,16,25,44,23,11,12,0,322,84,55,4,25,1183,124,1059
360530304042,36, New York,053, Madison County,414,178,134,23,21,37,29,20,0,9,377,149,114,23,12,1042,144,898
360530305011,36, New York,053, Madison County,314,107,66,5,36,3,3,3,0,0,311,104,63,5,36,875,62,813
360530305012,36, New York,053, Madison County,252,95,66,0,29,6,6,0,0,6,246,89,66,0,23,746,45,701
360530305021,36, New York,053, Madison County,545,184,146,21,17,0,0,0,0,0,545,184,146,21,17,1495,34,1461
360530305022,36, New York,053, Madison County,496,161,111,3,47,0,0,0,0,0,496,161,111,3,47,1450,26,1424
360530306011,36, New York,053, Madison County,488,172,101,36,35,17,14,7,0,7,471,158,94,36,28,1409,76,1333
360530306012,36, New York,053, Madison County,372,115,97,0,18,4,4,0,0,4,368,111,97,0,14,1109,31,1078
360530306021,36, New York,053, Madison County,259,94,71,6,17,5,5,2,3,0,254,89,69,3,17,731,24,707
360530306022,36, New York,053, Madison County,314,85,49,17,19,31,24,0,12,12,283,61,49,5,7,803,57,746
360530306023,36, New York,053, Madison County,381,166,110,16,40,24,6,6,0,0,357,160,104,16,40,1140,69,1071
360530307011,36, New York,053, Madison County,167,101,52,27,22,4,0,0,0,0,163,101,52,27,22,551,54,497
360530307012,36, New York,053, Madison County,218,58,13,0,45,25,25,0,0,25,193,33,13,0,20,638,72,566
360530307013,36, New York,053, Madison County,358,218,215,0,3,15,2,2,0,0,343,216,213,0,3,1012,108,904
360530307021,36, New York,053, Madison County,304,140,101,32,7,5,5,5,0,0,299,135,96,32,7,802,53,749
360530307022,36, New York,053, Madison County,205,66,58,4,4,30,4,0,4,0,175,62,58,0,4,641,117,524
360530308001,36, New York,053, Madison County,383,154,136,9,9,51,28,26,0,2,332,126,110,9,7,1242,234,1008
360530308002,36, New York,053, Madison County,305,94,89,3,2,17,6,5,0,1,288,88,84,3,1,930,70,860
360530308003,36, New York,053, Madison County,140,31,27,4,0,2,0,0,0,0,138,31,27,4,0,497,36,461
360530309001,36, New York,053, Madison County,176,56,52,4,0,14,0,0,0,0,162,56,52,4,0,623,56,567
360530309002,36, New York,053, Madison County,159,88,77,0,11,0,0,0,0,0,159,88,77,0,11,588,87,501
360530310001,36, New York,053, Madison County,325,118,91,5,22,18,18,0,0,18,307,100,91,5,4,1022,93,929
360530310002,36, New York,053, Madison County,682,174,105,53,16,115,44,0,28,16,567,130,105,25,0,1806,274,1532
360530310003,36, New York,053, Madison County,465,308,237,30,41,22,22,0,0,22,443,286,237,30,19,1182,46,1136
360530311001,36, New York,053, Madison County,388,146,93,30,23,45,25,14,6,5,343,121,79,24,18,1145,187,958
360530311002,36, New York,053, Madison County,243,72,53,0,19,22,19,8,0,11,221,53,45,0,8,720,66,654
361031101011,36, New York,103, Suffolk County,361,199,199,0,0,8,8,8,0,0,353,191,191,0,0,919,37,882
361031101012,36, New York,103, Suffolk County,329,129,124,5,0,19,0,0,0,0,310,129,124,5,0,778,51,727
361031101013,36, New York,103, Suffolk County,326,94,88,0,6,4,0,0,0,0,322,94,88,0,6,854,9,845
361031101031,36, New York,103, Suffolk County,272,75,10,65,0,0,0,0,0,0,272,75,10,65,0,970,41,929
361031101032,36, New York,103, Suffolk County,311,158,142,0,16,0,0,0,0,0,311,158,142,0,16,900,7,893
361031101041,36, New York,103, Suffolk County,367,225,225,0,0,0,0,0,0,0,367,225,225,0,0,1030,14,1016
361031101042,36, New York,103, Suffolk County,197,93,84,0,9,0,0,0,0,0,197,93,84,0,9,536,0,536
361031101043,36, New York,103, Suffolk County,189,136,136,0,0,0,0,0,0,0,189,136,136,0,0,449,9,440
361031102001,36, New York,103, Suffolk County,317,165,128,0,37,0,0,0,0,0,317,165,128,0,37,1243,16,1227
361031102002,36, New York,103, Suffolk County,267,93,93,0,0,0,0,0,0,0,267,93,93,0,0,723,0,723
361031102003,36, New York,103, Suffolk County,307,71,71,0,0,0,0,0,0,0,307,71,71,0,0,1018,73,945
361031102004,36, New York,103, Suffolk County,487,113,52,0,61,40,26,0,0,26,447,87,52,0,35,1481,189,1292
361031103001,36, New York,103, Suffolk County,296,56,56,0,0,7,0,0,0,0,289,56,56,0,0,718,37,681
361031103002,36, New York,103, Suffolk County,205,99,53,0,46,0,0,0,0,0,205,99,53,0,46,574,0,574
361031103003,36, New York,103, Suffolk County,175,26,26,0,0,0,0,0,0,0,175,26,26,0,0,709,47,662
361031103004,36, New York,103, Suffolk County,443,139,125,0,14,0,0,0,0,0,443,139,125,0,14,1353,25,1328
361031103005,36, New York,103, Suffolk County,263,89,82,0,7,0,0,0,0,0,263,89,82,0,7,740,30,710
361031104011,36, New York,103, Suffolk County,313,85,85,0,0,17,0,0,0,0,296,85,85,0,0,947,53,894
361031104012,36, New York,103, Suffolk County,325,130,112,18,0,36,0,0,0,0,289,130,112,18,0,813,103,710
361031104021,36, New York,103, Suffolk County,369,161,155,0,6,6,6,0,0,6,363,155,155,0,0,991,44,947
361031104022,36, New York,103, Suffolk County,604,214,201,0,13,6,0,0,0,0,598,214,201,0,13,1659,12,1647
361031105011,36, New York,103, Suffolk County,723,295,255,0,40,69,45,34,0,11,654,250,221,0,29,1979,215,1764
361031105012,36, New York,103, Suffolk County,195,62,62,0,0,0,0,0,0,0,195,62,62,0,0,556,0,556
361031105021,36, New York,103, Suffolk County,315,103,74,10,19,10,10,0,10,0,305,93,74,0,19,1024,45,979
361031105022,36, New York,103, Suffolk County,416,234,234,0,0,18,18,18,0,0,398,216,216,0,0,1134,50,1084
361031106011,36, New York,103, Suffolk County,378,198,110,0,88,0,0,0,0,0,378,198,110,0,88,1244,42,1202
361031106012,36, New York,103, Suffolk County,130,60,60,0,0,0,0,0,0,0,130,60,60,0,0,318,19,299
361031106013,36, New York,103, Suffolk County,164,103,103,0,0,17,17,17,0,0,147,86,86,0,0,468,33,435
361031106014,36, New York,103, Suffolk County,643,120,120,0,0,14,0,0,0,0,629,120,120,0,0,1708,80,1628
361031106021,36, New York,103, Suffolk County,211,55,20,0,35,0,0,0,0,0,211,55,20,0,35,749,23,726
361031106022,36, New York,103, Suffolk County,524,227,126,0,101,101,101,0,0,101,423,126,126,0,0,1409,305,1104
361031108011,36, New York,103, Suffolk County,396,119,89,17,13,0,0,0,0,0,396,119,89,17,13,1020,31,989
361031108012,36, New York,103, Suffolk County,233,119,86,8,25,22,17,0,0,17,211,102,86,8,8,539,39,500
361031108031,36, New York,103, Suffolk County,322,100,100,0,0,10,0,0,0,0,312,100,100,0,0,1259,103,1156
361031108032,36, New York,103, Suffolk County,361,128,128,0,0,10,0,0,0,0,351,128,128,0,0,835,35,800
361031108033,36, New York,103, Suffolk County,318,171,154,17,0,0,0,0,0,0,318,171,154,17,0,864,0,864
361031108034,36, New York,103, Suffolk County,469,155,119,0,36,19,19,0,0,19,450,136,119,0,17,1162,41,1121
361031108035,36, New York,103, Suffolk County,140,61,61,0,0,0,0,0,0,0,140,61,61,0,0,482,0,482
361031109011,36, New York,103, Suffolk County,108,27,27,0,0,0,0,0,0,0,108,27,27,0,0,447,0,447
361031109012,36, New York,103, Suffolk County,317,144,58,0,86,23,23,0,0,23,294,121,58,0,63,792,55,737
361031109013,36, New York,103, Suffolk County,146,5,0,0,5,0,0,0,0,0,146,5,0,0,5,673,84,589
361031109021,36, New York,103, Suffolk County,318,108,56,0,52,31,31,0,0,31,287,77,56,0,21,719,10,709
361031109022,36, New York,103, Suffolk County,269,123,34,21,68,71,46,0,21,25,198,77,34,0,43,1025,233,792
361031109023,36, New York,103, Suffolk County,447,152,75,22,55,11,11,0,0,11,436,141,75,22,44,1350,35,1315
361031110011,36, New York,103, Suffolk County,147,59,53,0,6,0,0,0,0,0,147,59,53,0,6,672,9,663
361031110012,36, New York,103, Suffolk County,373,123,57,18,48,0,0,0,0,0,373,123,57,18,48,1201,92,1109
361031110021,36, New York,103, Suffolk County,384,111,0,0,111,0,0,0,0,0,384,111,0,0,111,1236,112,1124
361031110022,36, New York,103, Suffolk County,267,129,101,0,28,28,28,0,0,28,239,101,101,0,0,736,67,669
361031110023,36, New York,103, Suffolk County,229,110,66,0,44,42,34,0,0,34,187,76,66,0,10,453,24,429
361031110024,36, New York,103, Suffolk County,387,250,189,21,40,0,0,0,0,0,387,250,189,21,40,1016,41,975
361031111011,36, New York,103, Suffolk County,234,153,122,0,31,0,0,0,0,0,234,153,122,0,31,795,0,795
361031111012,36, New York,103, Suffolk County,282,147,117,0,30,0,0,0,0,0,282,147,117,0,30,758,5,753
361031111021,36, New York,103, Suffolk County,280,133,125,0,8,116,109,109,0,0,164,24,16,0,8,861,336,525
361031111022,36, New York,103, Suffolk County,234,82,74,0,8,8,8,0,0,8,226,74,74,0,0,590,48,542
361031111031,36, New York,103, Suffolk County,659,388,254,58,76,243,211,211,0,0,416,177,43,58,76,1085,58,1027
361031111032,36, New York,103, Suffolk County,288,40,15,0,25,0,0,0,0,0,288,40,15,0,25,889,0,889
361031112011,36, New York,103, Suffolk County,313,227,74,63,90,0,0,0,0,0,313,227,74,63,90,943,243,700
361031112012,36, New York,103, Suffolk County,200,42,42,0,0,0,0,0,0,0,200,42,42,0,0,729,15,714
361031112013,36, New York,103, Suffolk County,287,168,168,0,0,0,0,0,0,0,287,168,168,0,0,691,0,691
361031112021,36, New York,103, Suffolk County,186,95,95,0,0,0,0,0,0,0,186,95,95,0,0,449,9,440
361031112022,36, New York,103, Suffolk County,568,227,210,0,17,0,0,0,0,0,568,227,210,0,17,2037,18,2019
361031112023,36, New York,103, Suffolk County,444,208,150,0,58,77,77,33,0,44,367,131,117,0,14,1476,131,1345
361031113001,36, New York,103, Suffolk County,524,240,137,11,92,35,35,10,0,25,489,205,127,11,67,1232,74,1158
361031113002,36, New York,103, Suffolk County,497,230,230,0,0,39,39,39,0,0,458,191,191,0,0,1260,126,1134
361031113003,36, New York,103, Suffolk County,334,176,176,0,0,0,0,0,0,0,334,176,176,0,0,995,61,934
361031114011,36, New York,103, Suffolk County,207,70,58,0,12,24,24,12,0,12,183,46,46,0,0,483,57,426
361031114012,36, New York,103, Suffolk County,206,84,75,0,9,0,0,0,0,0,206,84,75,0,9,552,8,544
361031114021,36, New York,103, Suffolk County,652,239,239,0,0,0,0,0,0,0,652,239,239,0,0,1697,26,1671
361031114022,36, New York,103, Suffolk County,244,120,107,0,13,13,0,0,0,0,231,120,107,0,13,982,91,891
361031114023,36, New York,103, Suffolk County,517,143,136,0,7,0,0,0,0,0,517,143,136,0,7,1325,0,1325
361031115031,36, New York,103, Suffolk County,335,187,174,0,13,1,1,1,0,0,334,186,173,0,13,968,9,959
361031115032,36, New York,103, Suffolk County,549,381,367,5,9,9,9,0,0,9,540,372,367,5,0,1897,46,1851
361031115033,36, New York,103, Suffolk County,209,53,53,0,0,44,0,0,0,0,165,53,53,0,0,890,143,747
361031115041,36, New York,103, Suffolk County,493,162,137,12,13,7,0,0,0,0,486,162,137,12,13,1350,48,1302
361031115061,36, New York,103, Suffolk County,499,211,172,39,0,13,0,0,0,0,486,211,172,39,0,1392,86,1306
361031115062,36, New York,103, Suffolk County,266,161,81,52,28,24,24,0,15,9,242,137,81,37,19,711,54,657
361031115071,36, New York,103, Suffolk County,259,186,131,0,55,0,0,0,0,0,259,186,131,0,55,902,15,887
361031115072,36, New York,103, Suffolk County,277,125,92,0,33,0,0,0,0,0,277,125,92,0,33,815,12,803
361031115081,36, New York,103, Suffolk County,642,356,239,49,68,0,0,0,0,0,642,356,239,49,68,1764,9,1755
361031115082,36, New York,103, Suffolk County,348,111,37,0,74,36,29,0,0,29,312,82,37,0,45,955,76,879
361031116011,36, New York,103, Suffolk County,521,294,256,0,38,29,0,0,0,0,492,294,256,0,38,1348,110,1238
361031116012,36, New York,103, Suffolk County,514,171,150,11,10,0,0,0,0,0,514,171,150,11,10,1536,30,1506
361031116021,36, New York,103, Suffolk County,132,55,55,0,0,0,0,0,0,0,132,55,55,0,0,385,25,360
361031116022,36, New York,103, Suffolk County,731,308,263,26,19,28,0,0,0,0,703,308,263,26,19,2116,126,1990
361031117011,36, New York,103, Suffolk County,223,140,87,0,53,0,0,0,0,0,223,140,87,0,53,855,63,792
361031117012,36, New York,103, Suffolk County,570,250,173,0,77,46,46,0,0,46,524,204,173,0,31,1427,46,1381
361031117013,36, New York,103, Suffolk County,635,270,240,18,12,56,18,0,18,0,579,252,240,0,12,1887,162,1725
361031117031,36, New York,103, Suffolk County,238,110,110,0,0,0,0,0,0,0,238,110,110,0,0,815,117,698
361031117032,36, New York,103, Suffolk County,310,147,95,0,52,52,52,0,0,52,258,95,95,0,0,899,58,841
361031117033,36, New York,103, Suffolk County,201,97,86,11,0,0,0,0,0,0,201,97,86,11,0,732,33,699
361031117041,36, New York,103, Suffolk County,297,150,150,0,0,0,0,0,0,0,297,150,150,0,0,741,43,698
361031117042,36, New York,103, Suffolk County,650,338,338,0,0,0,0,0,0,0,650,338,338,0,0,1894,33,1861
361031118011,36, New York,103, Suffolk County,303,151,151,0,0,0,0,0,0,0,303,151,151,0,0,964,104,860
361031118012,36, New York,103, Suffolk County,512,102,102,0,0,10,0,0,0,0,502,102,102,0,0,1888,33,1855
361031118013,36, New York,103, Suffolk County,747,310,289,0,21,0,0,0,0,0,747,310,289,0,21,1929,0,1929
361031118014,36, New York,103, Suffolk County,196,60,11,0,49,0,0,0,0,0,196,60,11,0,49,620,13,607
361031118021,36, New York,103, Suffolk County,248,74,63,11,0,0,0,0,0,0,248,74,63,11,0,571,11,560
361031118022,36, New York,103, Suffolk County,475,160,146,7,7,14,7,0,0,7,461,153,146,7,0,1352,23,1329
361031118031,36, New York,103, Suffolk County,310,136,129,0,7,7,7,0,0,7,303,129,129,0,0,809,14,795
361031118032,36, New York,103, Suffolk County,455,210,162,15,33,0,0,0,0,0,455,210,162,15,33,1092,6,1086
361031118041,36, New York,103, Suffolk County,301,126,106,0,20,15,0,0,0,0,286,126,106,0,20,800,39,761
361031118042,36, New York,103, Suffolk County,321,151,127,11,13,0,0,0,0,0,321,151,127,11,13,846,8,838
361031119001,36, New York,103, Suffolk County,209,56,56,0,0,0,0,0,0,0,209,56,56,0,0,729,71,658
361031119002,36, New York,103, Suffolk County,207,58,43,15,0,0,0,0,0,0,207,58,43,15,0,599,0,599
361031119003,36, New York,103, Suffolk County,303,145,98,0,47,6,0,0,0,0,297,145,98,0,47,855,52,803
361031119004,36, New York,103, Suffolk County,361,82,82,0,0,0,0,0,0,0,361,82,82,0,0,968,19,949
361031119005,36, New York,103, Suffolk County,160,65,35,30,0,0,0,0,0,0,160,65,35,30,0,446,7,439
361031119006,36, New York,103, Suffolk County,209,64,64,0,0,0,0,0,0,0,209,64,64,0,0,548,8,540
361031120011,36, New York,103, Suffolk County,484,189,160,29,0,8,0,0,0,0,476,189,160,29,0,1703,103,1600
361031120012,36, New York,103, Suffolk County,143,87,39,29,19,0,0,0,0,0,143,87,39,29,19,419,0,419
361031120013,36, New York,103, Suffolk County,149,100,89,0,11,8,0,0,0,0,141,100,89,0,11,443,35,408
361031120014,36, New York,103, Suffolk County,296,137,128,0,9,0,0,0,0,0,296,137,128,0,9,969,33,936
361031120021,36, New York,103, Suffolk County,587,170,146,0,24,0,0,0,0,0,587,170,146,0,24,1746,1,1745
361031120022,36, New York,103, Suffolk County,375,152,135,0,17,10,0,0,0,0,365,152,135,0,17,1056,62,994
361031120023,36, New York,103, Suffolk County,594,380,249,21,110,30,29,0,21,8,564,351,249,0,102,1404,19,1385
361031121021,36, New York,103, Suffolk County,479,155,155,0,0,0,0,0,0,0,479,155,155,0,0,1091,2,1089
361031121022,36, New York,103, Suffolk County,477,145,145,0,0,0,0,0,0,0,477,145,145,0,0,1224,29,1195
361031121031,36, New York,103, Suffolk County,294,140,129,0,11,0,0,0,0,0,294,140,129,0,11,981,0,981
361031121032,36, New York,103, Suffolk County,666,267,267,0,0,15,0,0,0,0,651,267,267,0,0,1751,42,1709
361031121033,36, New York,103, Suffolk County,275,69,69,0,0,0,0,0,0,0,275,69,69,0,0,859,40,819
361031121041,36, New York,103, Suffolk County,309,141,122,19,0,27,0,0,0,0,282,141,122,19,0,738,54,684
361031121042,36, New York,103, Suffolk County,253,150,115,19,16,0,0,0,0,0,253,150,115,19,16,860,55,805
361031122041,36, New York,103, Suffolk County,493,296,296,0,0,16,16,16,0,0,477,280,280,0,0,1247,37,1210
361031122042,36, New York,103, Suffolk County,286,113,103,0,10,0,0,0,0,0,286,113,103,0,10,767,35,732
361031122043,36, New York,103, Suffolk County,154,75,70,5,0,10,0,0,0,0,144,75,70,5,0,902,241,661
361031122111,36, New York,103, Suffolk County,414,159,159,0,0,30,0,0,0,0,384,159,159,0,0,1388,138,1250
361031122112,36, New York,103, Suffolk County,255,100,100,0,0,0,0,0,0,0,255,100,100,0,0,680,6,674
361031122113,36, New York,103, Suffolk County,355,165,124,0,41,0,0,0,0,0,355,165,124,0,41,948,6,942
361031122121,36, New York,103, Suffolk County,489,163,163,0,0,0,0,0,0,0,489,163,163,0,0,1367,4,1363
361031122122,36, New York,103, Suffolk County,540,181,181,0,0,0,0,0,0,0,540,181,181,0,0,1381,0,1381
361031122131,36, New York,103, Suffolk County,420,133,117,0,16,0,0,0,0,0,420,133,117,0,16,1283,88,1195
361031122132,36, New York,103, Suffolk County,490,215,198,0,17,0,0,0,0,0,490,215,198,0,17,1337,15,1322
361031122133,36, New York,103, Suffolk County,97,44,27,0,17,0,0,0,0,0,97,44,27,0,17,283,46,237
361031122134,36, New York,103, Suffolk County,374,163,163,0,0,0,0,0,0,0,374,163,163,0,0,816,0,816
361031122151,36, New York,103, Suffolk County,290,95,67,28,0,13,0,0,0,0,277,95,67,28,0,1215,13,1202
361031122152,36, New York,103, Suffolk County,224,93,93,0,0,0,0,0,0,0,224,93,93,0,0,1138,24,1114
361031122161,36, New York,103, Suffolk County,309,114,114,0,0,0,0,0,0,0,309,114,114,0,0,930,20,910
361031122162,36, New York,103, Suffolk County,242,158,144,0,14,58,45,31,0,14,184,113,113,0,0,680,121,559
361031122163,36, New York,103, Suffolk County,438,194,170,0,24,0,0,0,0,0,438,194,170,0,24,1240,19,1221
361031122171,36, New York,103, Suffolk County,691,339,305,0,34,0,0,0,0,0,691,339,305,0,34,1812,6,1806
361031122181,36, New York,103, Suffolk County,316,68,68,0,0,0,0,0,0,0,316,68,68,0,0,776,0,776
361031122182,36, New York,103, Suffolk County,383,111,111,0,0,0,0,0,0,0,383,111,111,0,0,1119,55,1064
361031122183,36, New York,103, Suffolk County,546,151,151,0,0,0,0,0,0,0,546,151,151,0,0,1857,0,1857
361031122184,36, New York,103, Suffolk County,219,175,108,0,67,0,0,0,0,0,219,175,108,0,67,620,14,606
361031122191,36, New York,103, Suffolk County,169,0,0,0,0,0,0,0,0,0,169,0,0,0,0,616,22,594
361031122192,36, New York,103, Suffolk County,337,85,44,41,0,0,0,0,0,0,337,85,44,41,0,806,65,741
361031122193,36, New York,103, Suffolk County,346,0,0,0,0,0,0,0,0,0,346,0,0,0,0,1156,50,1106
361031122201,36, New York,103, Suffolk County,449,286,174,22,90,0,0,0,0,0,449,286,174,22,90,1170,28,1142
361031122202,36, New York,103, Suffolk County,526,255,255,0,0,0,0,0,0,0,526,255,255,0,0,1280,44,1236
361031223001,36, New York,103, Suffolk County,591,299,239,47,13,3,3,0,0,3,588,296,239,47,10,1939,76,1863
361031223002,36, New York,103, Suffolk County,362,135,124,0,11,0,0,0,0,0,362,135,124,0,11,1010,12,998
361031223003,36, New York,103, Suffolk County,0,0,0,0,0,0,0,0,0,0,0,0,0,0,0,0,0,0
361031224051,36, New York,103, Suffolk County,498,178,147,7,24,0,0,0,0,0,498,178,147,7,24,1907,138,1769
361031224052,36, New York,103, Suffolk County,254,151,137,3,11,10,3,0,3,0,244,148,137,0,11,693,13,680
361031224061,36, New York,103, Suffolk County,266,181,84,36,61,0,0,0,0,0,266,181,84,36,61,1071,109,962
361031224062,36, New York,103, Suffolk County,327,242,112,34,96,82,82,36,0,46,245,160,76,34,50,1170,254,916
361031224063,36, New York,103, Suffolk County,504,287,85,141,61,12,0,0,0,0,492,287,85,141,61,1136,21,1115
361031224064,36, New York,103, Suffolk County,264,100,22,31,47,47,47,0,0,47,217,53,22,31,0,798,200,598
361031224071,36, New York,103, Suffolk County,138,56,50,0,6,6,6,6,0,0,132,50,44,0,6,509,72,437
361031224072,36, New York,103, Suffolk County,245,103,81,0,22,7,1,1,0,0,238,102,80,0,22,717,21,696
361031224081,36, New York,103, Suffolk County,394,225,129,59,37,16,16,16,0,0,378,209,113,59,37,1247,71,1176
361031224082,36, New York,103, Suffolk County,423,184,166,0,18,0,0,0,0,0,423,184,166,0,18,1195,26,1169
361031224083,36, New York,103, Suffolk County,0,0,0,0,0,0,0,0,0,0,0,0,0,0,0,14,14,0
361031225011,36, New York,103, Suffolk County,612,416,156,23,237,157,110,0,0,110,455,306,156,23,127,2115,467,1648
361031225012,36, New York,103, Suffolk County,289,29,29,0,0,0,0,0,0,0,289,29,29,0,0,1304,142,1162
361031225013,36, New York,103, Suffolk County,142,52,31,0,21,0,0,0,0,0,142,52,31,0,21,354,13,341
361031225021,36, New York,103, Suffolk County,252,154,105,0,49,0,0,0,0,0,252,154,105,0,49,686,44,642
361031225022,36, New York,103, Suffolk County,339,143,130,0,13,13,13,0,0,13,326,130,130,0,0,1132,32,1100
361031225023,36, New York,103, Suffolk County,168,62,15,0,47,0,0,0,0,0,168,62,15,0,47,549,40,509
361031225024,36, New York,103, Suffolk County,207,94,81,0,13,13,13,0,0,13,194,81,81,0,0,652,29,623
361031226021,36, New York,103, Suffolk County,643,279,279,0,0,0,0,0,0,0,643,279,279,0,0,1849,37,1812
361031226022,36, New York,103, Suffolk County,477,270,236,34,0,45,34,0,34,0,432,236,236,0,0,1608,80,1528
361031226031,36, New York,103, Suffolk County,398,137,122,0,15,11,11,11,0,0,387,126,111,0,15,1474,40,1434
361031226032,36, New York,103, Suffolk County,604,160,127,33,0,0,0,0,0,0,604,160,127,33,0,1902,55,1847
361031226033,36, New York,103, Suffolk County,292,74,62,0,12,23,0,0,0,0,269,74,62,0,12,1125,82,1043
361031226041,36, New York,103, Suffolk County,327,173,142,31,0,28,28,28,0,0,299,145,114,31,0,1042,61,981
361031226042,36, New York,103, Suffolk County,621,201,125,0,76,12,12,0,0,12,609,189,125,0,64,1755,12,1743
361031226051,36, New York,103, Suffolk County,190,111,111,0,0,4,0,0,0,0,186,111,111,0,0,755,42,713
361031226052,36, New York,103, Suffolk County,300,126,126,0,0,0,0,0,0,0,300,126,126,0,0,886,35,851
361031227041,36, New York,103, Suffolk County,600,244,162,39,43,17,9,0,0,9,583,235,162,39,34,1969,208,1761
361031227051,36, New York,103, Suffolk County,415,164,144,0,20,9,0,0,0,0,406,164,144,0,20,1251,32,1219
361031227052,36, New York,103, Suffolk County,312,161,146,0,15,4,0,0,0,0,308,161,146,0,15,1127,36,1091
361031227061,36, New York,103, Suffolk County,299,177,89,0,88,13,13,0,0,13,286,164,89,0,75,657,29,628
361031227062,36, New York,103, Suffolk County,257,73,73,0,0,18,18,18,0,0,239,55,55,0,0,773,70,703
361031227063,36, New York,103, Suffolk County,371,184,155,0,29,14,14,14,0,0,357,170,141,0,29,1196,63,1133
361031227071,36, New York,103, Suffolk County,367,184,145,14,25,0,0,0,0,0,367,184,145,14,25,1424,9,1415
361031227072,36, New York,103, Suffolk County,323,136,136,0,0,0,0,0,0,0,323,136,136,0,0,865,0,865
361031228011,36, New York,103, Suffolk County,373,216,203,0,13,14,0,0,0,0,359,216,203,0,13,1386,166,1220
361031228012,36, New York,103, Suffolk County,126,44,44,0,0,5,0,0,0,0,121,44,44,0,0,522,31,491
361031228013,36, New York,103, Suffolk County,102,54,54,0,0,54,54,54,0,0,48,0,0,0,0,829,133,696
361031228014,36, New York,103, Suffolk County,381,266,219,0,47,0,0,0,0,0,381,266,219,0,47,1299,74,1225
361031228021,36, New York,103, Suffolk County,567,182,127,13,42,0,0,0,0,0,567,182,127,13,42,1740,109,1631
361031228022,36, New York,103, Suffolk County,704,412,399,3,10,0,0,0,0,0,704,412,399,3,10,2006,51,1955
361031229011,36, New York,103, Suffolk County,475,223,138,31,54,27,19,9,0,10,448,204,129,31,44,1309,94,1215
361031229012,36, New York,103, Suffolk County,266,50,39,0,11,0,0,0,0,0,266,50,39,0,11,702,0,702
361031229013,36, New York,103, Suffolk County,833,307,239,33,35,44,24,24,0,0,789,283,215,33,35,2899,141,2758
361031229021,36, New York,103, Suffolk County,372,139,139,0,0,25,0,0,0,0,347,139,139,0,0,1338,106,1232
361031229022,36, New York,103, Suffolk County,324,117,90,0,27,17,17,17,0,0,307,100,73,0,27,1109,47,1062
361031229023,36, New York,103, Suffolk County,342,200,99,0,101,0,0,0,0,0,342,200,99,0,101,934,54,880
361031230011,36, New York,103, Suffolk County,367,154,124,30,0,0,0,0,0,0,367,154,124,30,0,1101,38,1063
361031230012,36, New York,103, Suffolk County,374,147,127,0,20,0,0,0,0,0,374,147,127,0,20,1167,12,1155
361031230013,36, New York,103, Suffolk County,759,295,189,54,52,52,24,0,24,0,707,271,189,30,52,2383,222,2161
361031230021,36, New York,103, Suffolk County,526,138,102,0,36,15,0,0,0,0,511,138,102,0,36,1759,122,1637
361031230022,36, New York,103, Suffolk County,228,67,26,10,31,10,10,0,10,0,218,57,26,0,31,1044,158,886
361031230023,36, New York,103, Suffolk County,263,203,163,25,15,34,34,23,11,0,229,169,140,14,15,850,109,741
361031231011,36, New York,103, Suffolk County,378,160,160,0,0,0,0,0,0,0,378,160,160,0,0,1399,37,1362
361031231012,36, New York,103, Suffolk County,192,84,75,9,0,0,0,0,0,0,192,84,75,9,0,616,20,596
361031231013,36, New York,103, Suffolk County,288,106,77,17,12,12,12,0,0,12,276,94,77,17,0,893,30,863
361031231021,36, New York,103, Suffolk County,275,107,107,0,0,0,0,0,0,0,275,107,107,0,0,808,21,787
361031231022,36, New York,103, Suffolk County,483,222,171,18,33,16,16,0,0,16,467,206,171,18,17,1543,27,1516
361031231023,36, New York,103, Suffolk County,147,16,16,0,0,8,8,8,0,0,139,8,8,0,0,559,16,543
361031232011,36, New York,103, Suffolk County,258,82,59,15,8,32,15,0,15,0,226,67,59,0,8,845,81,764
361031232012,36, New York,103, Suffolk County,148,91,72,0,19,0,0,0,0,0,148,91,72,0,19,544,11,533
361031232031,36, New York,103, Suffolk County,248,134,69,0,65,0,0,0,0,0,248,134,69,0,65,925,22,903
361031232032,36, New York,103, Suffolk County,477,149,9,0,140,17,17,0,0,17,460,132,9,0,123,1467,44,1423
361031232041,36, New York,103, Suffolk County,519,357,156,15,186,46,46,20,0,26,473,311,136,15,160,1775,219,1556
361031232042,36, New York,103, Suffolk County,280,157,134,0,23,23,23,0,0,23,257,134,134,0,0,902,103,799
361031232043,36, New York,103, Suffolk County,249,187,126,61,0,15,15,0,15,0,234,172,126,46,0,1245,302,943
361031233031,36, New York,103, Suffolk County,400,0,0,0,0,31,0,0,0,0,369,0,0,0,0,1402,74,1328
361031233032,36, New York,103, Suffolk County,307,211,148,0,63,63,63,0,0,63,244,148,148,0,0,891,146,745
361031233033,36, New York,103, Suffolk County,404,268,166,0,102,38,38,0,0,38,366,230,166,0,64,1456,38,1418
361031233041,36, New York,103, Suffolk County,173,30,0,0,30,0,0,0,0,0,173,30,0,0,30,730,36,694
361031233042,36, New York,103, Suffolk County,150,58,16,32,10,30,0,0,0,0,120,58,16,32,10,340,60,280
361031233043,36, New York,103, Suffolk County,493,274,192,0,82,0,0,0,0,0,493,274,192,0,82,1540,0,1540
361031233044,36, New York,103, Suffolk County,231,14,0,14,0,0,0,0,0,0,231,14,0,14,0,1065,50,1015
361031234011,36, New York,103, Suffolk County,294,146,87,41,18,5,5,5,0,0,289,141,82,41,18,998,32,966
361031234012,36, New York,103, Suffolk County,365,99,55,0,44,0,0,0,0,0,365,99,55,0,44,1014,12,1002
361031234013,36, New York,103, Suffolk County,231,94,47,21,26,26,26,0,0,26,205,68,47,21,0,741,72,669
361031234031,36, New York,103, Suffolk County,331,163,89,66,8,0,0,0,0,0,331,163,89,66,8,849,0,849
361031234032,36, New York,103, Suffolk County,70,9,9,0,0,0,0,0,0,0,70,9,9,0,0,332,8,324
361031234041,36, New York,103, Suffolk County,141,67,67,0,0,0,0,0,0,0,141,67,67,0,0,477,20,457
361031234042,36, New York,103, Suffolk County,752,256,192,50,14,50,50,0,50,0,702,206,192,0,14,1969,60,1909
361031234043,36, New York,103, Suffolk County,572,199,128,0,71,83,47,47,0,0,489,152,81,0,71,1713,94,1619
361031235001,36, New York,103, Suffolk County,297,156,156,0,0,0,0,0,0,0,297,156,156,0,0,731,0,731
361031235002,36, New York,103, Suffolk County,166,18,0,0,18,0,0,0,0,0,166,18,0,0,18,719,46,673
361031235003,36, New York,103, Suffolk County,193,36,19,0,17,0,0,0,0,0,193,36,19,0,17,815,109,706
361031235004,36, New York,103, Suffolk County,369,128,128,0,0,20,0,0,0,0,349,128,128,0,0,1169,73,1096
361031235005,36, New York,103, Suffolk County,309,141,70,0,71,101,19,0,0,19,208,122,70,0,52,742,215,527
361031236001,36, New York,103, Suffolk County,319,90,81,0,9,9,9,0,0,9,310,81,81,0,0,1013,57,956
361031236002,36, New York,103, Suffolk County,319,133,73,0,60,0,0,0,0,0,319,133,73,0,60,844,41,803
361031236003,36, New York,103, Suffolk County,452,47,47,0,0,0,0,0,0,0,452,47,47,0,0,1181,0,1181
361031237011,36, New York,103, Suffolk County,457,266,149,92,25,44,44,0,44,0,413,222,149,48,25,1214,108,1106
361031237012,36, New York,103, Suffolk County,746,326,145,40,141,22,22,22,0,0,724,304,123,40,141,1750,73,1677
361031237013,36, New York,103, Suffolk County,394,172,54,20,98,8,8,0,8,0,386,164,54,12,98,1291,34,1257
361031237031,36, New York,103, Suffolk County,187,98,50,0,48,20,20,0,0,20,167,78,50,0,28,411,51,360
361031237032,36, New York,103, Suffolk County,568,274,116,140,18,0,0,0,0,0,568,274,116,140,18,1372,70,1302
361031237033,36, New York,103, Suffolk County,135,58,58,0,0,48,0,0,0,0,87,58,58,0,0,317,63,254
361031237041,36, New York,103, Suffolk County,502,274,259,0,15,198,114,114,0,0,304,160,145,0,15,1293,533,760
361031237042,36, New York,103, Suffolk County,136,40,20,0,20,0,0,0,0,0,136,40,20,0,20,474,53,421
361031237043,36, New York,103, Suffolk County,361,165,110,0,55,25,0,0,0,0,336,165,110,0,55,947,68,879
361031238011,36, New York,103, Suffolk County,354,224,216,0,8,10,10,10,0,0,344,214,206,0,8,1235,45,1190
361031238012,36, New York,103, Suffolk County,189,58,58,0,0,0,0,0,0,0,189,58,58,0,0,828,0,828
361031238013,36, New York,103, Suffolk County,461,167,81,0,86,59,51,0,0,51,402,116,81,0,35,1483,124,1359
361031238021,36, New York,103, Suffolk County,243,86,77,0,9,9,0,0,0,0,234,86,77,0,9,924,34,890
361031238022,36, New York,103, Suffolk County,571,238,186,31,21,69,29,0,10,19,502,209,186,21,2,1769,161,1608
361031239001,36, New York,103, Suffolk County,392,70,70,0,0,126,0,0,0,0,266,70,70,0,0,1522,394,1128
361031239002,36, New York,103, Suffolk County,325,170,170,0,0,13,13,13,0,0,312,157,157,0,0,895,26,869
361031239003,36, New York,103, Suffolk County,484,167,160,7,0,0,0,0,0,0,484,167,160,7,0,1623,63,1560
361031240011,36, New York,103, Suffolk County,457,265,185,61,19,26,26,26,0,0,431,239,159,61,19,1624,103,1521
361031240012,36, New York,103, Suffolk County,439,215,215,0,0,19,0,0,0,0,420,215,215,0,0,1573,54,1519
361031240013,36, New York,103, Suffolk County,126,92,23,29,40,0,0,0,0,0,126,92,23,29,40,399,18,381
361031240021,36, New York,103, Suffolk County,326,118,88,0,30,0,0,0,0,0,326,118,88,0,30,879,10,869
361031240022,36, New York,103, Suffolk County,515,221,205,0,16,0,0,0,0,0,515,221,205,0,16,1663,43,1620
361031241011,36, New York,103, Suffolk County,345,146,114,2,30,37,37,37,0,0,308,109,77,2,30,975,196,779
361031241012,36, New York,103, Suffolk County,249,65,5,0,60,8,0,0,0,0,241,65,5,0,60,668,22,646
361031241013,36, New York,103, Suffolk County,404,159,104,0,55,12,12,12,0,0,392,147,92,0,55,1496,122,1374
361031241021,36, New York,103, Suffolk County,274,71,58,0,13,22,22,22,0,0,252,49,36,0,13,889,100,789
361031241022,36, New York,103, Suffolk County,242,66,66,0,0,11,0,0,0,0,231,66,66,0,0,626,57,569
361031241023,36, New York,103, Suffolk County,405,252,127,25,100,0,0,0,0,0,405,252,127,25,100,1280,102,1178
361031242001,36, New York,103, Suffolk County,251,124,95,0,29,5,0,0,0,0,246,124,95,0,29,945,39,906
361031242002,36, New York,103, Suffolk County,134,72,52,0,20,0,0,0,0,0,134,72,52,0,20,629,0,629
361031242003,36, New York,103, Suffolk County,272,200,156,0,44,0,0,0,0,0,272,200,156,0,44,734,64,670
361031242004,36, New York,103, Suffolk County,321,142,102,0,40,0,0,0,0,0,321,142,102,0,40,1102,38,1064
361031242005,36, New York,103, Suffolk County,401,179,150,0,29,0,0,0,0,0,401,179,150,0,29,1182,14,1168
361031243011,36, New York,103, Suffolk County,214,98,71,14,13,0,0,0,0,0,214,98,71,14,13,898,17,881
361031243012,36, New York,103, Suffolk County,154,6,6,0,0,0,0,0,0,0,154,6,6,0,0,677,39,638
361031243021,36, New York,103, Suffolk County,212,93,55,21,17,17,17,0,0,17,195,76,55,21,0,992,118,874
361031243022,36, New York,103, Suffolk County,477,57,36,21,0,0,0,0,0,0,477,57,36,21,0,1359,62,1297
361031243023,36, New York,103, Suffolk County,527,229,111,63,55,29,29,29,0,0,498,200,82,63,55,1380,95,1285
361031244011,36, New York,103, Suffolk County,83,2,2,0,0,0,0,0,0,0,83,2,2,0,0,613,45,568
361031244012,36, New York,103, Suffolk County,203,86,78,0,8,0,0,0,0,0,203,86,78,0,8,715,12,703
361031244013,36, New York,103, Suffolk County,334,179,126,9,44,35,0,0,0,0,299,179,126,9,44,1304,128,1176
361031244021,36, New York,103, Suffolk County,617,155,137,0,18,0,0,0,0,0,617,155,137,0,18,1880,19,1861
361031244022,36, New York,103, Suffolk County,247,150,137,0,13,0,0,0,0,0,247,150,137,0,13,740,12,728
361031244023,36, New York,103, Suffolk County,139,0,0,0,0,18,0,0,0,0,121,0,0,0,0,604,43,561
361031245001,36, New York,103, Suffolk County,325,212,191,9,12,0,0,0,0,0,325,212,191,9,12,765,0,765
361031245002,36, New York,103, Suffolk County,258,74,74,0,0,0,0,0,0,0,258,74,74,0,0,738,94,644
361031245003,36, New York,103, Suffolk County,295,146,92,0,54,0,0,0,0,0,295,146,92,0,54,997,31,966
361031245004,36, New York,103, Suffolk County,515,172,156,0,16,0,0,0,0,0,515,172,156,0,16,1485,30,1455
361031246011,36, New York,103, Suffolk County,249,85,58,0,27,15,15,0,0,15,234,70,58,0,12,834,34,800
361031246012,36, New York,103, Suffolk County,282,23,23,0,0,0,0,0,0,0,282,23,23,0,0,700,19,681
361031246013,36, New York,103, Suffolk County,200,118,83,0,35,8,8,0,0,8,192,110,83,0,27,617,8,609
361031246021,36, New York,103, Suffolk County,434,217,211,0,6,0,0,0,0,0,434,217,211,0,6,1278,0,1278
361031246022,36, New York,103, Suffolk County,327,95,95,0,0,0,0,0,0,0,327,95,95,0,0,998,23,975
361031246023,36, New York,103, Suffolk County,304,140,80,39,21,0,0,0,0,0,304,140,80,39,21,1244,17,1227
361031347021,36, New York,103, Suffolk County,336,187,134,0,53,0,0,0,0,0,336,187,134,0,53,752,0,752
361031347022,36, New York,103, Suffolk County,700,220,220,0,0,0,0,0,0,0,700,220,220,0,0,2145,21,2124
361031347023,36, New York,103, Suffolk County,282,45,24,0,21,22,0,0,0,0,260,45,24,0,21,989,108,881
361031347024,36, New York,103, Suffolk County,229,202,139,0,63,0,0,0,0,0,229,202,139,0,63,803,0,803
361031347031,36, New York,103, Suffolk County,477,244,232,0,12,0,0,0,0,0,477,244,232,0,12,1257,16,1241
361031347032,36, New York,103, Suffolk County,265,98,95,0,3,0,0,0,0,0,265,98,95,0,3,624,0,624
361031347033,36, New York,103, Suffolk County,321,136,136,0,0,0,0,0,0,0,321,136,136,0,0,1129,0,1129
361031347041,36, New York,103, Suffolk County,498,199,166,5,28,0,0,0,0,0,498,199,166,5,28,1225,6,1219
361031347042,36, New York,103, Suffolk County,162,93,41,7,45,11,11,11,0,0,151,82,30,7,45,845,65,780
361031349021,36, New York,103, Suffolk County,485,142,123,11,8,0,0,0,0,0,485,142,123,11,8,1641,14,1627
361031349022,36, New York,103, Suffolk County,336,64,64,0,0,0,0,0,0,0,336,64,64,0,0,1347,0,1347
361031349023,36, New York,103, Suffolk County,378,170,170,0,0,0,0,0,0,0,378,170,170,0,0,1075,20,1055
361031349061,36, New York,103, Suffolk County,385,132,132,0,0,0,0,0,0,0,385,132,132,0,0,1136,0,1136
361031349062,36, New York,103, Suffolk County,536,259,216,12,31,0,0,0,0,0,536,259,216,12,31,1641,0,1641
361031349063,36, New York,103, Suffolk County,157,66,29,19,18,0,0,0,0,0,157,66,29,19,18,775,119,656
361031349064,36, New York,103, Suffolk County,169,30,30,0,0,0,0,0,0,0,169,30,30,0,0,615,0,615
361031349071,36, New York,103, Suffolk County,404,130,114,16,0,10,0,0,0,0,394,130,114,16,0,1353,81,1272
361031349072,36, New York,103, Suffolk County,556,269,239,15,15,0,0,0,0,0,556,269,239,15,15,1369,24,1345
361031349081,36, New York,103, Suffolk County,548,296,296,0,0,0,0,0,0,0,548,296,296,0,0,1337,21,1316
361031349082,36, New York,103, Suffolk County,357,103,64,39,0,0,0,0,0,0,357,103,64,39,0,929,52,877
361031349091,36, New York,103, Suffolk County,319,211,161,42,8,0,0,0,0,0,319,211,161,42,8,912,0,912
361031349092,36, New York,103, Suffolk County,429,173,147,7,19,16,13,0,0,13,413,160,147,7,6,1364,48,1316
361031349093,36, New York,103, Suffolk County,379,180,176,4,0,13,0,0,0,0,366,180,176,4,0,980,27,953
361031350021,36, New York,103, Suffolk County,272,90,55,7,28,0,0,0,0,0,272,90,55,7,28,831,17,814
361031350022,36, New York,103, Suffolk County,492,273,222,18,33,0,0,0,0,0,492,273,222,18,33,1654,0,1654
361031350023,36, New York,103, Suffolk County,517,230,207,0,23,0,0,0,0,0,517,230,207,0,23,1467,1,1466
361031350031,36, New York,103, Suffolk County,312,177,166,0,11,8,0,0,0,0,304,177,166,0,11,754,21,733
361031350032,36, New York,103, Suffolk County,526,190,149,29,12,12,12,0,0,12,514,178,149,29,0,1292,66,1226
361031350033,36, New York,103, Suffolk County,597,338,262,0,76,0,0,0,0,0,597,338,262,0,76,1713,0,1713
361031350041,36, New York,103, Suffolk County,453,170,110,53,7,12,3,3,0,0,441,167,107,53,7,1206,62,1144
361031350042,36, New York,103, Suffolk County,410,202,176,5,21,4,4,4,0,0,406,198,172,5,21,1147,24,1123
361031350051,36, New York,103, Suffolk County,417,74,74,0,0,6,0,0,0,0,411,74,74,0,0,1002,28,974
361031350052,36, New York,103, Suffolk County,196,0,0,0,0,0,0,0,0,0,196,0,0,0,0,899,56,843
361031350053,36, New York,103, Suffolk County,227,123,104,19,0,0,0,0,0,0,227,123,104,19,0,633,0,633
361031351011,36, New York,103, Suffolk County,453,221,195,15,11,9,0,0,0,0,444,221,195,15,11,1051,20,1031
361031351012,36, New York,103, Suffolk County,612,211,186,12,13,9,0,0,0,0,603,211,186,12,13,1932,61,1871
361031351021,36, New York,103, Suffolk County,536,166,166,0,0,40,0,0,0,0,496,166,166,0,0,1586,133,1453
361031351022,36, New York,103, Suffolk County,711,314,291,0,23,6,0,0,0,0,705,314,291,0,23,2135,42,2093
361031351031,36, New York,103, Suffolk County,345,182,105,16,61,0,0,0,0,0,345,182,105,16,61,811,16,795
361031351032,36, New York,103, Suffolk County,451,261,233,0,28,0,0,0,0,0,451,261,233,0,28,1130,0,1130
361031351033,36, New York,103, Suffolk County,529,216,216,0,0,10,0,0,0,0,519,216,216,0,0,1437,19,1418
361031351041,36, New York,103, Suffolk County,455,214,166,31,17,9,0,0,0,0,446,214,166,31,17,1066,29,1037
361031351042,36, New York,103, Suffolk County,287,185,185,0,0,0,0,0,0,0,287,185,185,0,0,732,19,713
361031351043,36, New York,103, Suffolk County,305,177,168,9,0,0,0,0,0,0,305,177,168,9,0,887,0,887
361031351044,36, New York,103, Suffolk County,368,225,169,42,14,0,0,0,0,0,368,225,169,42,14,960,0,960
361031352011,36, New York,103, Suffolk County,516,198,175,0,23,13,13,6,0,7,503,185,169,0,16,1461,50,1411
361031352051,36, New York,103, Suffolk County,381,191,173,0,18,0,0,0,0,0,381,191,173,0,18,1141,37,1104
361031352052,36, New York,103, Suffolk County,555,213,213,0,0,0,0,0,0,0,555,213,213,0,0,1720,39,1681
361031352053,36, New York,103, Suffolk County,340,121,121,0,0,0,0,0,0,0,340,121,121,0,0,1034,2,1032
361031352081,36, New York,103, Suffolk County,378,130,123,0,7,0,0,0,0,0,378,130,123,0,7,1041,36,1005
361031352082,36, New York,103, Suffolk County,363,157,140,0,17,0,0,0,0,0,363,157,140,0,17,1024,18,1006
361031352091,36, New York,103, Suffolk County,511,259,207,31,21,21,21,11,0,10,490,238,196,31,11,1297,43,1254
361031352092,36, New York,103, Suffolk County,363,102,102,0,0,24,0,0,0,0,339,102,102,0,0,1309,72,1237
361031353031,36, New York,103, Suffolk County,217,55,27,16,12,0,0,0,0,0,217,55,27,16,12,684,12,672
361031353032,36, New York,103, Suffolk County,365,202,141,0,61,11,0,0,0,0,354,202,141,0,61,1183,31,1152
361031353033,36, New York,103, Suffolk County,488,184,158,0,26,17,17,0,0,17,471,167,158,0,9,1224,37,1187
361031353051,36, New York,103, Suffolk County,441,181,169,12,0,9,0,0,0,0,432,181,169,12,0,1259,54,1205
361031353061,36, New York,103, Suffolk County,556,166,151,5,10,0,0,0,0,0,556,166,151,5,10,1733,0,1733
361031353062,36, New York,103, Suffolk County,188,112,79,33,0,34,34,34,0,0,154,78,45,33,0,571,68,503
361031353063,36, New York,103, Suffolk County,333,134,93,41,0,25,0,0,0,0,308,134,93,41,0,1044,164,880
361031353064,36, New York,103, Suffolk County,258,151,151,0,0,0,0,0,0,0,258,151,151,0,0,665,8,657
361031354011,36, New York,103, Suffolk County,275,145,91,0,54,16,16,0,0,16,259,129,91,0,38,869,80,789
361031354012,36, New York,103, Suffolk County,536,306,217,0,89,27,27,0,0,27,509,279,217,0,62,1462,155,1307
361031354013,36, New York,103, Suffolk County,329,184,119,47,18,12,0,0,0,0,317,184,119,47,18,909,28,881
361031354014,36, New York,103, Suffolk County,377,202,191,0,11,13,0,0,0,0,364,202,191,0,11,1093,98,995
361031354021,36, New York,103, Suffolk County,712,327,327,0,0,0,0,0,0,0,712,327,327,0,0,1883,0,1883
361031354022,36, New York,103, Suffolk County,199,108,108,0,0,0,0,0,0,0,199,108,108,0,0,441,15,426
361031354023,36, New York,103, Suffolk County,414,226,209,0,17,0,0,0,0,0,414,226,209,0,17,1116,0,1116
361031354024,36, New York,103, Suffolk County,203,14,14,0,0,65,0,0,0,0,138,14,14,0,0,466,137,329
361031354025,36, New York,103, Suffolk County,627,127,90,37,0,14,0,0,0,0,613,127,90,37,0,1742,46,1696
361031354031,36, New York,103, Suffolk County,251,146,98,0,48,53,44,0,0,44,198,102,98,0,4,785,62,723
361031354032,36, New York,103, Suffolk County,515,229,210,0,19,52,9,0,0,9,463,220,210,0,10,1623,156,1467
361031354033,36, New York,103, Suffolk County,240,126,81,0,45,0,0,0,0,0,240,126,81,0,45,871,68,803
361031355001,36, New York,103, Suffolk County,602,88,88,0,0,64,14,14,0,0,538,74,74,0,0,1836,164,1672
361031355002,36, New York,103, Suffolk County,753,242,215,9,18,8,8,0,0,8,745,234,215,9,10,2091,110,1981
361031456011,36, New York,103, Suffolk County,295,194,145,49,0,35,35,35,0,0,260,159,110,49,0,684,138,546
361031456012,36, New York,103, Suffolk County,244,187,130,0,57,12,12,0,0,12,232,175,130,0,45,711,42,669
361031456013,36, New York,103, Suffolk County,248,135,119,16,0,37,37,37,0,0,211,98,82,16,0,577,25,552
361031456014,36, New York,103, Suffolk County,305,184,125,59,0,0,0,0,0,0,305,184,125,59,0,864,26,838
361031456021,36, New York,103, Suffolk County,421,126,57,40,29,6,0,0,0,0,415,126,57,40,29,1446,61,1385
361031456022,36, New York,103, Suffolk County,297,117,40,58,19,21,0,0,0,0,276,117,40,58,19,810,137,673
361031456023,36, New York,103, Suffolk County,362,109,68,41,0,0,0,0,0,0,362,109,68,41,0,1456,46,1410
361031456024,36, New York,103, Suffolk County,398,121,64,45,12,24,24,0,12,12,374,97,64,33,0,1312,29,1283
361031456031,36, New York,103, Suffolk County,477,250,78,42,130,35,35,0,0,35,442,215,78,42,95,1415,84,1331
361031456032,36, New York,103, Suffolk County,368,113,61,12,40,0,0,0,0,0,368,113,61,12,40,1248,40,1208
361031456033,36, New York,103, Suffolk County,444,258,81,81,96,24,10,0,0,10,420,248,81,81,86,1377,44,1333
361031456041,36, New York,103, Suffolk County,444,307,191,62,54,0,0,0,0,0,444,307,191,62,54,1113,87,1026
361031456042,36, New York,103, Suffolk County,161,101,12,64,25,0,0,0,0,0,161,101,12,64,25,468,0,468
361031456043,36, New York,103, Suffolk County,266,139,109,30,0,0,0,0,0,0,266,139,109,30,0,754,28,726
361031456051,36, New York,103, Suffolk County,478,348,291,15,42,28,19,0,0,19,450,329,291,15,23,1053,44,1009
361031456052,36, New York,103, Suffolk County,297,257,219,29,9,21,21,0,21,0,276,236,219,8,9,1009,73,936
361031457011,36, New York,103, Suffolk County,128,20,14,0,6,0,0,0,0,0,128,20,14,0,6,598,97,501
361031457012,36, New York,103, Suffolk County,263,110,81,0,29,0,0,0,0,0,263,110,81,0,29,791,0,791
361031457013,36, New York,103, Suffolk County,522,173,127,0,46,14,14,14,0,0,508,159,113,0,46,1274,78,1196
361031457014,36, New York,103, Suffolk County,281,103,79,17,7,20,11,11,0,0,261,92,68,17,7,837,29,808
361031457021,36, New York,103, Suffolk County,383,137,120,17,0,44,31,31,0,0,339,106,89,17,0,1160,185,975
361031457022,36, New York,103, Suffolk County,621,226,195,0,31,64,64,64,0,0,557,162,131,0,31,2229,279,1950
361031457023,36, New York,103, Suffolk County,438,270,190,18,62,17,17,17,0,0,421,253,173,18,62,1095,7,1088
361031457031,36, New York,103, Suffolk County,381,207,94,70,43,0,0,0,0,0,381,207,94,70,43,1168,79,1089
361031457032,36, New York,103, Suffolk County,188,99,89,0,10,0,0,0,0,0,188,99,89,0,10,1120,179,941
361031457033,36, New York,103, Suffolk County,369,239,159,10,70,0,0,0,0,0,369,239,159,10,70,827,180,647
361031457051,36, New York,103, Suffolk County,445,232,167,4,61,105,15,0,0,15,340,217,167,4,46,1689,365,1324
361031457052,36, New York,103, Suffolk County,78,58,58,0,0,0,0,0,0,0,78,58,58,0,0,618,73,545
361031457061,36, New York,103, Suffolk County,469,270,179,27,64,26,0,0,0,0,443,270,179,27,64,1456,146,1310
361031457062,36, New York,103, Suffolk County,494,184,65,61,58,7,7,0,0,7,487,177,65,61,51,1414,62,1352
361031458031,36, New York,103, Suffolk County,359,123,107,10,6,0,0,0,0,0,359,123,107,10,6,1037,17,1020
361031458032,36, New York,103, Suffolk County,583,136,123,0,13,68,0,0,0,0,515,136,123,0,13,1571,15,1556
361031458033,36, New York,103, Suffolk County,415,271,105,0,166,8,0,0,0,0,407,271,105,0,166,1370,71,1299
361031458041,36, New York,103, Suffolk County,525,234,107,38,89,6,0,0,0,0,519,234,107,38,89,1274,61,1213
361031458042,36, New York,103, Suffolk County,294,88,75,0,13,0,0,0,0,0,294,88,75,0,13,836,21,815
361031458043,36, New York,103, Suffolk County,86,34,27,7,0,9,0,0,0,0,77,34,27,7,0,413,57,356
361031458071,36, New York,103, Suffolk County,706,229,190,10,29,0,0,0,0,0,706,229,190,10,29,1836,10,1826
361031458072,36, New York,103, Suffolk County,470,178,153,0,25,0,0,0,0,0,470,178,153,0,25,1521,0,1521
361031458081,36, New York,103, Suffolk County,496,202,137,0,65,8,8,8,0,0,488,194,129,0,65,1336,22,1314
361031458082,36, New York,103, Suffolk County,309,64,59,5,0,5,0,0,0,0,304,64,59,5,0,1144,41,1103
361031458091,36, New York,103, Suffolk County,121,92,58,0,34,8,8,8,0,0,113,84,50,0,34,566,68,498
361031458092,36, New York,103, Suffolk County,292,128,70,25,33,0,0,0,0,0,292,128,70,25,33,972,47,925
361031458101,36, New York,103, Suffolk County,162,17,17,0,0,0,0,0,0,0,162,17,17,0,0,684,62,622
361031458102,36, New York,103, Suffolk County,236,128,74,0,54,31,11,0,0,11,205,117,74,0,43,668,51,617
361031458103,36, New York,103, Suffolk County,400,130,98,7,25,0,0,0,0,0,400,130,98,7,25,1445,60,1385
361031459011,36, New York,103, Suffolk County,282,120,92,19,9,10,10,10,0,0,272,110,82,19,9,958,90,868
361031459012,36, New York,103, Suffolk County,431,211,142,8,61,27,24,24,0,0,404,187,118,8,61,1407,118,1289
361031459031,36, New York,103, Suffolk County,339,149,15,74,60,0,0,0,0,0,339,149,15,74,60,1288,150,1138
361031459032,36, New York,103, Suffolk County,596,377,267,104,6,0,0,0,0,0,596,377,267,104,6,1885,165,1720
361031459033,36, New York,103, Suffolk County,223,53,9,0,44,0,0,0,0,0,223,53,9,0,44,533,0,533
361031459034,36, New York,103, Suffolk County,353,228,143,0,85,23,23,0,0,23,330,205,143,0,62,1066,108,958
361031459041,36, New York,103, Suffolk County,399,344,85,163,96,239,239,0,163,76,160,105,85,0,20,906,352,554
361031459042,36, New York,103, Suffolk County,417,254,197,25,32,11,0,0,0,0,406,254,197,25,32,1717,174,1543
361031459051,36, New York,103, Suffolk County,229,118,97,0,21,0,0,0,0,0,229,118,97,0,21,889,13,876
361031459052,36, New York,103, Suffolk County,388,204,204,0,0,0,0,0,0,0,388,204,204,0,0,1391,279,1112
361031459053,36, New York,103, Suffolk County,235,140,45,42,53,65,65,0,33,32,170,75,45,9,21,687,65,622
361031460011,36, New York,103, Suffolk County,427,204,204,0,0,0,0,0,0,0,427,204,204,0,0,1085,8,1077
361031460012,36, New York,103, Suffolk County,217,67,51,16,0,0,0,0,0,0,217,67,51,16,0,755,0,755
361031460013,36, New York,103, Suffolk County,306,225,156,61,8,0,0,0,0,0,306,225,156,61,8,690,43,647
361031460021,36, New York,103, Suffolk County,430,238,187,21,30,0,0,0,0,0,430,238,187,21,30,1162,129,1033
361031460022,36, New York,103, Suffolk County,338,113,74,11,28,13,0,0,0,0,325,113,74,11,28,1194,15,1179
361031460023,36, New York,103, Suffolk County,327,198,189,6,3,42,42,42,0,0,285,156,147,6,3,1052,52,1000
361031460041,36, New York,103, Suffolk County,88,88,77,0,11,0,0,0,0,0,88,88,77,0,11,274,91,183
361031460042,36, New York,103, Suffolk County,209,181,124,39,18,39,39,0,39,0,170,142,124,0,18,615,105,510
361031460051,36, New York,103, Suffolk County,438,233,190,43,0,0,0,0,0,0,438,233,190,43,0,1020,0,1020
361031460052,36, New York,103, Suffolk County,391,142,57,0,85,91,0,0,0,0,300,142,57,0,85,1247,203,1044
361031460053,36, New York,103, Suffolk County,575,379,215,70,94,9,0,0,0,0,566,379,215,70,94,2013,86,1927
361031461021,36, New York,103, Suffolk County,284,172,134,0,38,0,0,0,0,0,284,172,134,0,38,689,35,654
361031461022,36, New York,103, Suffolk County,186,78,69,9,0,0,0,0,0,0,186,78,69,9,0,595,14,581
361031461031,36, New York,103, Suffolk County,326,147,131,16,0,16,16,0,16,0,310,131,131,0,0,1122,60,1062
361031461032,36, New York,103, Suffolk County,753,381,284,37,60,8,0,0,0,0,745,381,284,37,60,2132,70,2062
361031461051,36, New York,103, Suffolk County,225,51,51,0,0,0,0,0,0,0,225,51,51,0,0,665,63,602
361031461052,36, New York,103, Suffolk County,604,237,198,39,0,0,0,0,0,0,604,237,198,39,0,1871,2,1869
361031461053,36, New York,103, Suffolk County,610,321,191,69,61,75,69,0,69,0,535,252,191,0,61,2210,328,1882
361031461061,36, New York,103, Suffolk County,375,132,69,19,44,0,0,0,0,0,375,132,69,19,44,1121,0,1121
361031461062,36, New York,103, Suffolk County,632,165,59,56,50,134,0,0,0,0,498,165,59,56,50,1706,314,1392
361031462011,36, New York,103, Suffolk County,462,348,276,23,49,24,0,0,0,0,438,348,276,23,49,1147,54,1093
361031462012,36, New York,103, Suffolk County,569,349,181,33,135,37,37,37,0,0,532,312,144,33,135,1998,35,1963
361031462021,36, New York,103, Suffolk County,312,98,54,0,44,41,41,41,0,0,271,57,13,0,44,809,85,724
361031462022,36, New York,103, Suffolk County,277,199,109,0,90,42,20,0,0,20,235,179,109,0,70,735,142,593
361031462023,36, New York,103, Suffolk County,420,218,180,15,23,0,0,0,0,0,420,218,180,15,23,1634,23,1611
361031462031,36, New York,103, Suffolk County,233,127,92,14,21,14,14,0,14,0,219,113,92,0,21,599,79,520
361031462032,36, New York,103, Suffolk County,382,201,23,69,109,25,25,0,0,25,357,176,23,69,84,1096,100,996
361031462033,36, New York,103, Suffolk County,296,132,70,0,62,35,35,0,0,35,261,97,70,0,27,984,99,885
361031462041,36, New York,103, Suffolk County,566,207,108,0,99,15,0,0,0,0,551,207,108,0,99,1588,65,1523
361031462042,36, New York,103, Suffolk County,223,143,88,55,0,0,0,0,0,0,223,143,88,55,0,574,24,550
361031462043,36, New York,103, Suffolk County,568,305,244,0,61,0,0,0,0,0,568,305,244,0,61,1182,17,1165
361031462051,36, New York,103, Suffolk County,193,83,62,8,13,13,13,13,0,0,180,70,49,8,13,589,30,559
361031462052,36, New York,103, Suffolk County,293,130,99,0,31,19,9,0,0,9,274,121,99,0,22,910,42,868
361031462061,36, New York,103, Suffolk County,145,63,42,13,8,26,14,14,0,0,119,49,28,13,8,441,46,395
361031462062,36, New York,103, Suffolk County,296,93,74,0,19,0,0,0,0,0,296,93,74,0,19,999,52,947
361031463001,36, New York,103, Suffolk County,216,41,29,0,12,10,0,0,0,0,206,41,29,0,12,905,61,844
361031463002,36, New York,103, Suffolk County,358,46,35,0,11,0,0,0,0,0,358,46,35,0,11,1122,78,1044
361031464021,36, New York,103, Suffolk County,420,111,93,18,0,5,0,0,0,0,415,111,93,18,0,1285,54,1231
361031464022,36, New York,103, Suffolk County,392,124,97,0,27,21,0,0,0,0,371,124,97,0,27,1103,55,1048
361031464023,36, New York,103, Suffolk County,270,137,137,0,0,0,0,0,0,0,270,137,137,0,0,747,10,737
361031464031,36, New York,103, Suffolk County,676,340,266,19,55,40,40,38,0,2,636,300,228,19,53,1476,53,1423
361031464032,36, New York,103, Suffolk County,580,408,166,0,242,68,68,0,0,68,512,340,166,0,174,1836,183,1653
361031464041,36, New York,103, Suffolk County,408,223,135,43,45,26,17,0,0,17,382,206,135,43,28,1233,46,1187
361031464042,36, New York,103, Suffolk County,178,100,22,44,34,0,0,0,0,0,178,100,22,44,34,692,36,656
361031465001,36, New York,103, Suffolk County,420,211,167,6,38,0,0,0,0,0,420,211,167,6,38,1188,0,1188
361031465002,36, New York,103, Suffolk County,237,146,146,0,0,0,0,0,0,0,237,146,146,0,0,659,7,652
361031465003,36, New York,103, Suffolk County,351,100,72,28,0,0,0,0,0,0,351,100,72,28,0,1030,0,1030
361031465004,36, New York,103, Suffolk County,384,177,127,0,50,47,35,0,0,35,337,142,127,0,15,1182,132,1050
361031466071,36, New York,103, Suffolk County,247,71,33,0,38,0,0,0,0,0,247,71,33,0,38,945,103,842
361031466072,36, New York,103, Suffolk County,388,204,115,7,82,62,56,0,0,56,326,148,115,7,26,913,114,799
361031466081,36, New York,103, Suffolk County,177,21,17,0,4,9,0,0,0,0,168,21,17,0,4,638,28,610
361031466082,36, New York,103, Suffolk County,207,61,55,6,0,0,0,0,0,0,207,61,55,6,0,793,38,755
361031466083,36, New York,103, Suffolk County,254,190,129,0,61,64,55,0,0,55,190,135,129,0,6,700,214,486
361031466111,36, New York,103, Suffolk County,619,335,99,86,150,29,29,0,0,29,590,306,99,86,121,1529,61,1468
361031466112,36, New York,103, Suffolk County,244,163,146,0,17,0,0,0,0,0,244,163,146,0,17,790,13,777
361031466121,36, New York,103, Suffolk County,286,157,84,14,59,32,32,32,0,0,254,125,52,14,59,773,78,695
361031466122,36, New York,103, Suffolk County,606,227,212,0,15,4,0,0,0,0,602,227,212,0,15,1938,31,1907
361031466123,36, New York,103, Suffolk County,399,232,209,18,5,0,0,0,0,0,399,232,209,18,5,1147,0,1147
361031466131,36, New York,103, Suffolk County,290,122,104,0,18,8,8,0,0,8,282,114,104,0,10,775,36,739
361031466132,36, New York,103, Suffolk County,674,357,266,75,16,0,0,0,0,0,674,357,266,75,16,1979,18,1961
361031466141,36, New York,103, Suffolk County,494,204,181,0,23,0,0,0,0,0,494,204,181,0,23,1357,10,1347
361031466142,36, New York,103, Suffolk County,213,58,36,0,22,0,0,0,0,0,213,58,36,0,22,759,0,759
361031466143,36, New York,103, Suffolk County,724,395,312,0,83,60,60,29,0,31,664,335,283,0,52,1694,80,1614
361031466161,36, New York,103, Suffolk County,494,164,138,0,26,0,0,0,0,0,494,164,138,0,26,1615,216,1399
361031466162,36, New York,103, Suffolk County,386,180,180,0,0,0,0,0,0,0,386,180,180,0,0,1038,2,1036
361031466163,36, New York,103, Suffolk County,111,78,78,0,0,0,0,0,0,0,111,78,78,0,0,549,83,466
361031466171,36, New York,103, Suffolk County,393,169,169,0,0,0,0,0,0,0,393,169,169,0,0,983,27,956
361031466172,36, New York,103, Suffolk County,377,150,76,31,43,0,0,0,0,0,377,150,76,31,43,1172,24,1148
361031466181,36, New York,103, Suffolk County,351,151,52,31,68,9,0,0,0,0,342,151,52,31,68,1176,55,1121
361031466182,36, New York,103, Suffolk County,392,116,103,0,13,17,8,0,0,8,375,108,103,0,5,1303,84,1219
361031466183,36, New York,103, Suffolk County,395,248,242,0,6,0,0,0,0,0,395,248,242,0,6,1055,0,1055
361031466184,36, New York,103, Suffolk County,267,108,72,14,22,5,5,0,0,5,262,103,72,14,17,688,5,683
361031466191,36, New York,103, Suffolk County,336,109,94,15,0,0,0,0,0,0,336,109,94,15,0,816,0,816
361031466192,36, New York,103, Suffolk County,457,212,120,14,78,7,7,7,0,0,450,205,113,14,78,1245,93,1152
361031466201,36, New York,103, Suffolk County,523,154,154,0,0,0,0,0,0,0,523,154,154,0,0,1946,8,1938
361031467031,36, New York,103, Suffolk County,410,190,139,37,14,4,4,4,0,0,406,186,135,37,14,1451,21,1430
361031467032,36, New York,103, Suffolk County,339,182,126,43,13,31,20,0,20,0,308,162,126,23,13,1149,142,1007
361031467041,36, New York,103, Suffolk County,189,77,77,0,0,0,0,0,0,0,189,77,77,0,0,646,5,641
361031467042,36, New York,103, Suffolk County,339,115,73,0,42,16,9,9,0,0,323,106,64,0,42,1274,50,1224
361031467051,36, New York,103, Suffolk County,367,68,50,0,18,17,17,17,0,0,350,51,33,0,18,1319,36,1283
361031467052,36, New York,103, Suffolk County,402,175,166,0,9,6,0,0,0,0,396,175,166,0,9,1157,13,1144
361031467061,36, New York,103, Suffolk County,231,104,95,0,9,0,0,0,0,0,231,104,95,0,9,770,10,760
361031467062,36, New York,103, Suffolk County,437,202,161,8,33,8,8,0,0,8,429,194,161,8,25,1134,23,1111
361031468001,36, New York,103, Suffolk County,417,194,97,97,0,0,0,0,0,0,417,194,97,97,0,1341,17,1324
361031468002,36, New York,103, Suffolk County,729,300,194,41,65,0,0,0,0,0,729,300,194,41,65,2279,191,2088
361031468003,36, New York,103, Suffolk County,310,78,71,7,0,0,0,0,0,0,310,78,71,7,0,926,29,897
361031468004,36, New York,103, Suffolk County,151,97,97,0,0,8,0,0,0,0,143,97,97,0,0,601,54,547
361031469011,36, New York,103, Suffolk County,595,367,341,0,26,10,0,0,0,0,585,367,341,0,26,1512,20,1492
361031469012,36, New York,103, Suffolk County,192,76,27,12,37,0,0,0,0,0,192,76,27,12,37,614,55,559
361031469013,36, New York,103, Suffolk County,623,226,197,11,18,0,0,0,0,0,623,226,197,11,18,1795,18,1777
361031469021,36, New York,103, Suffolk County,319,49,49,0,0,0,0,0,0,0,319,49,49,0,0,880,18,862
361031469022,36, New York,103, Suffolk County,303,183,142,0,41,8,1,0,0,1,295,182,142,0,40,854,14,840
361031469023,36, New York,103, Suffolk County,344,173,173,0,0,0,0,0,0,0,344,173,173,0,0,953,8,945
361031470011,36, New York,103, Suffolk County,325,125,125,0,0,22,22,22,0,0,303,103,103,0,0,951,44,907
361031470012,36, New York,103, Suffolk County,200,156,137,0,19,0,0,0,0,0,200,156,137,0,19,471,0,471
361031470013,36, New York,103, Suffolk County,734,408,389,0,19,8,8,0,0,8,726,400,389,0,11,1988,47,1941
361031470031,36, New York,103, Suffolk County,689,260,250,10,0,0,0,0,0,0,689,260,250,10,0,1854,9,1845
361031470032,36, New York,103, Suffolk County,341,118,109,0,9,28,0,0,0,0,313,118,109,0,9,1289,72,1217
361031470033,36, New York,103, Suffolk County,126,22,22,0,0,0,0,0,0,0,126,22,22,0,0,470,0,470
361031470041,36, New York,103, Suffolk County,25,12,6,0,6,0,0,0,0,0,25,12,6,0,6,66,0,66
361031471001,36, New York,103, Suffolk County,329,162,152,10,0,0,0,0,0,0,329,162,152,10,0,814,6,808
361031471002,36, New York,103, Suffolk County,203,74,58,10,6,0,0,0,0,0,203,74,58,10,6,560,0,560
361031471003,36, New York,103, Suffolk County,337,164,142,16,6,0,0,0,0,0,337,164,142,16,6,851,0,851
361031472011,36, New York,103, Suffolk County,216,154,154,0,0,16,16,16,0,0,200,138,138,0,0,628,53,575
361031472012,36, New York,103, Suffolk County,282,52,0,0,52,27,27,0,0,27,255,25,0,0,25,1216,157,1059
361031472013,36, New York,103, Suffolk County,102,53,36,0,17,0,0,0,0,0,102,53,36,0,17,557,34,523
361031472014,36, New York,103, Suffolk County,212,132,132,0,0,0,0,0,0,0,212,132,132,0,0,676,0,676
361031472021,36, New York,103, Suffolk County,352,60,25,0,35,0,0,0,0,0,352,60,25,0,35,1298,21,1277
361031472022,36, New York,103, Suffolk County,230,125,76,0,49,49,49,0,0,49,181,76,76,0,0,497,74,423
361031473011,36, New York,103, Suffolk County,314,53,19,32,2,0,0,0,0,0,314,53,19,32,2,1121,8,1113
361031473012,36, New York,103, Suffolk County,422,279,159,14,106,106,106,0,0,106,316,173,159,14,0,781,130,651
361031473021,36, New York,103, Suffolk County,249,113,113,0,0,0,0,0,0,0,249,113,113,0,0,919,0,919
361031473022,36, New York,103, Suffolk County,197,169,150,0,19,19,19,0,0,19,178,150,150,0,0,438,96,342
361031473023,36, New York,103, Suffolk County,152,93,0,16,77,0,0,0,0,0,152,93,0,16,77,941,180,761
361031473024,36, New York,103, Suffolk County,358,154,142,0,12,0,0,0,0,0,358,154,142,0,12,963,0,963
361031474011,36, New York,103, Suffolk County,314,71,15,0,56,38,38,0,0,38,276,33,15,0,18,961,38,923
361031474012,36, New York,103, Suffolk County,483,75,75,0,0,26,0,0,0,0,457,75,75,0,0,1605,213,1392
361031474013,36, New York,103, Suffolk County,515,250,234,0,16,0,0,0,0,0,515,250,234,0,16,1503,0,1503
361031474014,36, New York,103, Suffolk County,143,61,61,0,0,0,0,0,0,0,143,61,61,0,0,522,117,405
361031474021,36, New York,103, Suffolk County,264,135,97,14,24,0,0,0,0,0,264,135,97,14,24,669,0,669
361031474022,36, New York,103, Suffolk County,272,122,113,0,9,0,0,0,0,0,272,122,113,0,9,823,11,812
361031474023,36, New York,103, Suffolk County,303,57,57,0,0,0,0,0,0,0,303,57,57,0,0,945,10,935
361031475021,36, New York,103, Suffolk County,430,142,142,0,0,0,0,0,0,0,430,142,142,0,0,1221,25,1196
361031475022,36, New York,103, Suffolk County,171,65,65,0,0,0,0,0,0,0,171,65,65,0,0,643,0,643
361031475023,36, New York,103, Suffolk County,490,273,243,30,0,23,0,0,0,0,467,273,243,30,0,1355,50,1305
361031475024,36, New York,103, Suffolk County,264,131,131,0,0,0,0,0,0,0,264,131,131,0,0,725,8,717
361031475025,36, New York,103, Suffolk County,103,0,0,0,0,0,0,0,0,0,103,0,0,0,0,367,0,367
361031475031,36, New York,103, Suffolk County,164,60,17,0,43,22,0,0,0,0,142,60,17,0,43,515,61,454
361031475032,36, New York,103, Suffolk County,361,87,79,0,8,0,0,0,0,0,361,87,79,0,8,1205,8,1197
361031475041,36, New York,103, Suffolk County,97,42,42,0,0,0,0,0,0,0,97,42,42,0,0,385,1,384
361031475042,36, New York,103, Suffolk County,105,51,51,0,0,0,0,0,0,0,105,51,51,0,0,383,0,383
361031475051,36, New York,103, Suffolk County,209,110,82,0,28,0,0,0,0,0,209,110,82,0,28,683,30,653
361031475052,36, New York,103, Suffolk County,669,351,292,0,59,18,0,0,0,0,651,351,292,0,59,1794,84,1710
361031475053,36, New York,103, Suffolk County,309,166,146,0,20,0,0,0,0,0,309,166,146,0,20,1435,84,1351
361031475054,36, New York,103, Suffolk County,350,179,69,96,14,0,0,0,0,0,350,179,69,96,14,1125,105,1020
361031475055,36, New York,103, Suffolk County,96,0,0,0,0,0,0,0,0,0,96,0,0,0,0,396,0,396
361031476011,36, New York,103, Suffolk County,344,100,91,0,9,7,7,7,0,0,337,93,84,0,9,1021,30,991
361031476012,36, New York,103, Suffolk County,291,106,96,0,10,0,0,0,0,0,291,106,96,0,10,1083,45,1038
361031476021,36, New York,103, Suffolk County,284,165,165,0,0,0,0,0,0,0,284,165,165,0,0,871,47,824
361031476022,36, New York,103, Suffolk County,248,100,100,0,0,0,0,0,0,0,248,100,100,0,0,930,102,828
361031476023,36, New York,103, Suffolk County,148,97,79,0,18,28,28,28,0,0,120,69,51,0,18,501,102,399
361031476024,36, New York,103, Suffolk County,512,68,68,0,0,32,0,0,0,0,480,68,68,0,0,1876,115,1761
361031477011,36, New York,103, Suffolk County,467,243,243,0,0,0,0,0,0,0,467,243,243,0,0,1338,21,1317
361031477012,36, New York,103, Suffolk County,367,83,52,0,31,18,18,0,0,18,349,65,52,0,13,1339,34,1305
361031477021,36, New York,103, Suffolk County,361,226,187,23,16,0,0,0,0,0,361,226,187,23,16,938,0,938
361031477022,36, New York,103, Suffolk County,396,82,71,0,11,0,0,0,0,0,396,82,71,0,11,1050,25,1025
361031477023,36, New York,103, Suffolk County,439,108,73,12,23,11,11,0,0,11,428,97,73,12,12,1276,87,1189
361031477024,36, New York,103, Suffolk County,269,141,118,0,23,23,23,0,0,23,246,118,118,0,0,727,23,704
361031478021,36, New York,103, Suffolk County,226,106,106,0,0,0,0,0,0,0,226,106,106,0,0,708,11,697
361031478022,36, New York,103, Suffolk County,314,100,100,0,0,0,0,0,0,0,314,100,100,0,0,896,61,835
361031478023,36, New York,103, Suffolk County,430,135,81,16,38,0,0,0,0,0,430,135,81,16,38,1198,54,1144
361031478031,36, New York,103, Suffolk County,521,161,116,0,45,0,0,0,0,0,521,161,116,0,45,1498,79,1419
361031478032,36, New York,103, Suffolk County,294,141,132,0,9,0,0,0,0,0,294,141,132,0,9,1015,56,959
361031478041,36, New York,103, Suffolk County,632,351,297,0,54,42,34,0,0,34,590,317,297,0,20,1658,85,1573
361031478042,36, New York,103, Suffolk County,183,70,59,0,11,11,11,0,0,11,172,59,59,0,0,543,55,488
361031478043,36, New York,103, Suffolk County,357,135,115,10,10,10,10,0,0,10,347,125,115,10,0,888,25,863
361031478044,36, New York,103, Suffolk County,425,269,223,0,46,0,0,0,0,0,425,269,223,0,46,1029,6,1023
361031479011,36, New York,103, Suffolk County,738,279,169,57,53,11,11,11,0,0,727,268,158,57,53,2055,90,1965
361031479012,36, New York,103, Suffolk County,199,10,10,0,0,10,0,0,0,0,189,10,10,0,0,699,48,651
361031479013,36, New York,103, Suffolk County,279,121,54,14,53,9,0,0,0,0,270,121,54,14,53,799,67,732
361031479021,36, New York,103, Suffolk County,320,140,140,0,0,0,0,0,0,0,320,140,140,0,0,921,0,921
361031479022,36, New York,103, Suffolk County,368,187,80,14,93,0,0,0,0,0,368,187,80,14,93,955,11,944
361031479023,36, New York,103, Suffolk County,423,112,85,0,27,129,0,0,0,0,294,112,85,0,27,1002,223,779
361031479024,36, New York,103, Suffolk County,285,152,114,29,9,0,0,0,0,0,285,152,114,29,9,729,0,729
361031580011,36, New York,103, Suffolk County,313,128,101,0,27,3,3,0,0,3,310,125,101,0,24,764,15,749
361031580012,36, New York,103, Suffolk County,367,132,115,7,10,31,0,0,0,0,336,132,115,7,10,1007,104,903
361031580013,36, New York,103, Suffolk County,347,176,132,5,39,16,16,0,0,16,331,160,132,5,23,948,21,927
361031580091,36, New York,103, Suffolk County,439,220,204,13,3,17,17,17,0,0,422,203,187,13,3,1342,150,1192
361031580092,36, New York,103, Suffolk County,103,43,37,0,6,4,0,0,0,0,99,43,37,0,6,335,47,288
361031580101,36, New York,103, Suffolk County,178,79,79,0,0,0,0,0,0,0,178,79,79,0,0,539,9,530
361031580102,36, New York,103, Suffolk County,214,119,105,0,14,0,0,0,0,0,214,119,105,0,14,694,11,683
361031580103,36, New York,103, Suffolk County,462,214,183,0,31,0,0,0,0,0,462,214,183,0,31,1296,21,1275
361031580111,36, New York,103, Suffolk County,581,187,154,0,33,10,9,0,0,9,571,178,154,0,24,1775,99,1676
361031580112,36, New York,103, Suffolk County,545,177,156,21,0,8,0,0,0,0,537,177,156,21,0,1404,42,1362
361031580113,36, New York,103, Suffolk County,43,24,0,0,24,0,0,0,0,0,43,24,0,0,24,232,37,195
361031580121,36, New York,103, Suffolk County,259,89,89,0,0,0,0,0,0,0,259,89,89,0,0,781,18,763
361031580122,36, New York,103, Suffolk County,566,294,294,0,0,0,0,0,0,0,566,294,294,0,0,1768,260,1508
361031580123,36, New York,103, Suffolk County,244,144,144,0,0,0,0,0,0,0,244,144,144,0,0,589,35,554
361031580131,36, New York,103, Suffolk County,377,101,101,0,0,0,0,0,0,0,377,101,101,0,0,1031,15,1016
361031580132,36, New York,103, Suffolk County,329,140,85,0,55,8,8,0,0,8,321,132,85,0,47,801,18,783
361031580141,36, New York,103, Suffolk County,0,0,0,0,0,0,0,0,0,0,0,0,0,0,0,0,0,0
361031580151,36, New York,103, Suffolk County,0,0,0,0,0,0,0,0,0,0,0,0,0,0,0,0,0,0
361031580161,36, New York,103, Suffolk County,491,314,307,7,0,0,0,0,0,0,491,314,307,7,0,1108,5,1103
361031580162,36, New York,103, Suffolk County,164,67,67,0,0,0,0,0,0,0,164,67,67,0,0,447,21,426
361031580171,36, New York,103, Suffolk County,189,86,86,0,0,0,0,0,0,0,189,86,86,0,0,484,17,467
361031580172,36, New York,103, Suffolk County,628,281,146,11,124,7,0,0,0,0,621,281,146,11,124,1489,14,1475
361031580173,36, New York,103, Suffolk County,305,71,71,0,0,0,0,0,0,0,305,71,71,0,0,830,19,811
361031581021,36, New York,103, Suffolk County,643,246,220,0,26,0,0,0,0,0,643,246,220,0,26,2128,65,2063
361031581022,36, New York,103, Suffolk County,207,66,59,7,0,7,7,0,7,0,200,59,59,0,0,558,39,519
361031581023,36, New York,103, Suffolk County,382,262,228,0,34,11,0,0,0,0,371,262,228,0,34,1170,78,1092
361031581031,36, New York,103, Suffolk County,473,153,107,7,39,25,17,0,0,17,448,136,107,7,22,1264,48,1216
361031581032,36, New York,103, Suffolk County,317,73,73,0,0,0,0,0,0,0,317,73,73,0,0,819,0,819
361031581033,36, New York,103, Suffolk County,404,301,259,0,42,34,34,0,0,34,370,267,259,0,8,1262,100,1162
361031581071,36, New York,103, Suffolk County,233,53,53,0,0,0,0,0,0,0,233,53,53,0,0,786,42,744
361031581072,36, New York,103, Suffolk County,216,41,34,0,7,0,0,0,0,0,216,41,34,0,7,558,22,536
361031581073,36, New York,103, Suffolk County,129,13,13,0,0,0,0,0,0,0,129,13,13,0,0,523,36,487
361031581074,36, New York,103, Suffolk County,338,142,142,0,0,0,0,0,0,0,338,142,142,0,0,890,12,878
361031581081,36, New York,103, Suffolk County,245,146,146,0,0,0,0,0,0,0,245,146,146,0,0,1031,93,938
361031581082,36, New York,103, Suffolk County,390,169,161,0,8,5,5,5,0,0,385,164,156,0,8,1052,8,1044
361031581111,36, New York,103, Suffolk County,553,381,347,22,12,8,0,0,0,0,545,381,347,22,12,1535,32,1503
361031581112,36, New York,103, Suffolk County,300,135,112,5,18,5,5,0,5,0,295,130,112,0,18,838,30,808
361031581121,36, New York,103, Suffolk County,436,160,86,9,65,30,30,0,0,30,406,130,86,9,35,1473,88,1385
361031581122,36, New York,103, Suffolk County,606,305,195,65,45,33,14,14,0,0,573,291,181,65,45,1899,130,1769
361031581141,36, New York,103, Suffolk County,634,252,225,0,27,0,0,0,0,0,634,252,225,0,27,1777,7,1770
361031581142,36, New York,103, Suffolk County,218,109,96,13,0,8,0,0,0,0,210,109,96,13,0,611,56,555
361031581161,36, New York,103, Suffolk County,369,169,149,0,20,11,11,0,0,11,358,158,149,0,9,1045,33,1012
361031581162,36, New York,103, Suffolk County,157,51,38,13,0,13,13,0,13,0,144,38,38,0,0,441,53,388
361031581171,36, New York,103, Suffolk County,232,119,42,0,77,18,0,0,0,0,214,119,42,0,77,664,39,625
361031581172,36, New York,103, Suffolk County,529,122,97,25,0,25,25,0,25,0,504,97,97,0,0,1501,62,1439
361031581181,36, New York,103, Suffolk County,474,206,193,0,13,0,0,0,0,0,474,206,193,0,13,1499,10,1489
361031581182,36, New York,103, Suffolk County,388,162,151,0,11,0,0,0,0,0,388,162,151,0,11,1228,35,1193
361031581191,36, New York,103, Suffolk County,625,301,241,0,60,48,48,8,0,40,577,253,233,0,20,1854,235,1619
361031581192,36, New York,103, Suffolk County,419,194,150,35,9,42,9,0,0,9,377,185,150,35,0,1370,198,1172
361031581193,36, New York,103, Suffolk County,495,187,149,0,38,0,0,0,0,0,495,187,149,0,38,1408,0,1408
361031581201,36, New York,103, Suffolk County,447,138,124,0,14,23,9,0,0,9,424,129,124,0,5,1214,59,1155
361031581202,36, New York,103, Suffolk County,311,142,84,40,18,0,0,0,0,0,311,142,84,40,18,930,24,906
361031582051,36, New York,103, Suffolk County,178,111,111,0,0,0,0,0,0,0,178,111,111,0,0,432,17,415
361031582052,36, New York,103, Suffolk County,280,123,95,23,5,0,0,0,0,0,280,123,95,23,5,692,0,692
361031582061,36, New York,103, Suffolk County,376,157,125,0,32,0,0,0,0,0,376,157,125,0,32,1136,52,1084
361031582062,36, New York,103, Suffolk County,187,72,23,17,32,10,10,0,0,10,177,62,23,17,22,834,148,686
361031582063,36, New York,103, Suffolk County,240,88,42,0,46,0,0,0,0,0,240,88,42,0,46,662,55,607
361031582071,36, New York,103, Suffolk County,246,75,63,8,4,7,3,3,0,0,239,72,60,8,4,605,26,579
361031582072,36, New York,103, Suffolk County,605,205,179,10,16,0,0,0,0,0,605,205,179,10,16,1628,15,1613
361031582073,36, New York,103, Suffolk County,90,26,26,0,0,0,0,0,0,0,90,26,26,0,0,408,20,388
361031582074,36, New York,103, Suffolk County,335,138,138,0,0,8,8,8,0,0,327,130,130,0,0,1109,49,1060
361031582081,36, New York,103, Suffolk County,354,187,176,0,11,0,0,0,0,0,354,187,176,0,11,849,6,843
361031582082,36, New York,103, Suffolk County,515,202,194,8,0,26,26,26,0,0,489,176,168,8,0,1418,131,1287
361031582083,36, New York,103, Suffolk County,318,126,57,0,69,0,0,0,0,0,318,126,57,0,69,921,60,861
361031582091,36, New York,103, Suffolk County,435,384,297,16,71,60,60,44,16,0,375,324,253,0,71,964,0,964
361031582092,36, New York,103, Suffolk County,426,150,114,36,0,0,0,0,0,0,426,150,114,36,0,1647,94,1553
361031583041,36, New York,103, Suffolk County,485,130,130,0,0,8,8,8,0,0,477,122,122,0,0,1475,73,1402
361031583042,36, New York,103, Suffolk County,443,241,241,0,0,0,0,0,0,0,443,241,241,0,0,1399,28,1371
361031583043,36, New York,103, Suffolk County,382,126,126,0,0,0,0,0,0,0,382,126,126,0,0,1140,12,1128
361031583044,36, New York,103, Suffolk County,452,321,321,0,0,29,29,29,0,0,423,292,292,0,0,1290,69,1221
361031583061,36, New York,103, Suffolk County,552,213,213,0,0,17,0,0,0,0,535,213,213,0,0,1690,34,1656
361031583062,36, New York,103, Suffolk County,635,141,127,0,14,15,0,0,0,0,620,141,127,0,14,1552,46,1506
361031583063,36, New York,103, Suffolk County,480,189,189,0,0,0,0,0,0,0,480,189,189,0,0,1420,31,1389
361031583091,36, New York,103, Suffolk County,344,131,116,0,15,46,32,17,0,15,298,99,99,0,0,1126,95,1031
361031583092,36, New York,103, Suffolk County,301,87,47,12,28,14,0,0,0,0,287,87,47,12,28,809,42,767
361031583093,36, New York,103, Suffolk County,593,270,237,0,33,16,0,0,0,0,577,270,237,0,33,1841,100,1741
361031583101,36, New York,103, Suffolk County,427,214,151,46,17,33,33,0,33,0,394,181,151,13,17,1338,98,1240
361031583102,36, New York,103, Suffolk County,172,108,54,11,43,0,0,0,0,0,172,108,54,11,43,571,86,485
361031583103,36, New York,103, Suffolk County,601,153,82,0,71,49,49,11,0,38,552,104,71,0,33,1560,115,1445
361031583151,36, New York,103, Suffolk County,426,74,68,0,6,7,0,0,0,0,419,74,68,0,6,1146,33,1113
361031583152,36, New York,103, Suffolk County,365,92,9,13,70,0,0,0,0,0,365,92,9,13,70,1148,16,1132
361031583153,36, New York,103, Suffolk County,375,75,54,0,21,0,0,0,0,0,375,75,54,0,21,1181,0,1181
361031583171,36, New York,103, Suffolk County,406,245,163,82,0,0,0,0,0,0,406,245,163,82,0,1168,25,1143
361031583172,36, New York,103, Suffolk County,458,373,325,30,18,0,0,0,0,0,458,373,325,30,18,1143,0,1143
361031583173,36, New York,103, Suffolk County,140,43,43,0,0,0,0,0,0,0,140,43,43,0,0,683,57,626
361031583174,36, New York,103, Suffolk County,206,142,142,0,0,0,0,0,0,0,206,142,142,0,0,947,0,947
361031583181,36, New York,103, Suffolk County,441,168,131,23,14,0,0,0,0,0,441,168,131,23,14,1300,42,1258
361031583182,36, New York,103, Suffolk County,522,338,338,0,0,0,0,0,0,0,522,338,338,0,0,1438,78,1360
361031583183,36, New York,103, Suffolk County,379,139,121,9,9,0,0,0,0,0,379,139,121,9,9,1146,0,1146
361031583191,36, New York,103, Suffolk County,228,113,99,0,14,24,24,10,0,14,204,89,89,0,0,984,104,880
361031583192,36, New York,103, Suffolk County,732,307,252,26,29,9,0,0,0,0,723,307,252,26,29,2096,79,2017
361031583201,36, New York,103, Suffolk County,462,191,150,0,41,41,41,0,0,41,421,150,150,0,0,1514,159,1355
361031583202,36, New York,103, Suffolk County,229,89,50,12,27,39,21,0,0,21,190,68,50,12,6,1055,215,840
361031583203,36, New York,103, Suffolk County,347,78,78,0,0,0,0,0,0,0,347,78,78,0,0,925,63,862
361031583204,36, New York,103, Suffolk County,439,333,244,64,25,0,0,0,0,0,439,333,244,64,25,1362,0,1362
361031583221,36, New York,103, Suffolk County,627,223,207,8,8,5,0,0,0,0,622,223,207,8,8,1567,50,1517
361031583241,36, New York,103, Suffolk County,169,27,27,0,0,0,0,0,0,0,169,27,27,0,0,519,88,431
361031583242,36, New York,103, Suffolk County,432,204,134,9,61,7,0,0,0,0,425,204,134,9,61,1556,92,1464
361031583251,36, New York,103, Suffolk County,363,197,120,24,53,52,0,0,0,0,311,197,120,24,53,1243,322,921
361031583252,36, New York,103, Suffolk County,621,389,338,51,0,30,30,30,0,0,591,359,308,51,0,1754,171,1583
361031583253,36, New York,103, Suffolk County,402,138,138,0,0,0,0,0,0,0,402,138,138,0,0,1428,0,1428
361031583254,36, New York,103, Suffolk County,426,379,245,0,134,0,0,0,0,0,426,379,245,0,134,1177,28,1149
361031583261,36, New York,103, Suffolk County,262,127,63,0,64,0,0,0,0,0,262,127,63,0,64,891,42,849
361031583271,36, New York,103, Suffolk County,846,323,249,0,74,18,0,0,0,0,828,323,249,0,74,2444,103,2341
361031583272,36, New York,103, Suffolk County,282,155,133,0,22,0,0,0,0,0,282,155,133,0,22,755,0,755
361031583273,36, New York,103, Suffolk County,411,195,180,0,15,0,0,0,0,0,411,195,180,0,15,1340,26,1314
361031583281,36, New York,103, Suffolk County,366,182,167,15,0,0,0,0,0,0,366,182,167,15,0,1145,54,1091
361031583282,36, New York,103, Suffolk County,229,105,105,0,0,0,0,0,0,0,229,105,105,0,0,917,0,917
361031583283,36, New York,103, Suffolk County,712,390,281,93,16,15,15,15,0,0,697,375,266,93,16,1797,304,1493
361031583291,36, New York,103, Suffolk County,369,157,157,0,0,0,0,0,0,0,369,157,157,0,0,1118,28,1090
361031584011,36, New York,103, Suffolk County,322,209,141,25,43,40,27,0,0,27,282,182,141,25,16,922,121,801
361031584021,36, New York,103, Suffolk County,155,63,56,7,0,0,0,0,0,0,155,63,56,7,0,434,10,424
361031584022,36, New York,103, Suffolk County,404,111,100,11,0,10,0,0,0,0,394,111,100,11,0,1160,31,1129
361031584023,36, New York,103, Suffolk County,219,114,114,0,0,0,0,0,0,0,219,114,114,0,0,537,0,537
361031584024,36, New York,103, Suffolk County,410,298,243,0,55,0,0,0,0,0,410,298,243,0,55,1314,110,1204
361031584031,36, New York,103, Suffolk County,259,87,45,33,9,5,5,0,0,5,254,82,45,33,4,741,76,665
361031584032,36, New York,103, Suffolk County,344,152,141,0,11,22,11,0,0,11,322,141,141,0,0,975,141,834
361031584071,36, New York,103, Suffolk County,369,194,169,0,25,0,0,0,0,0,369,194,169,0,25,1238,2,1236
361031584072,36, New York,103, Suffolk County,569,419,359,0,60,0,0,0,0,0,569,419,359,0,60,1481,0,1481
361031584073,36, New York,103, Suffolk County,205,112,112,0,0,0,0,0,0,0,205,112,112,0,0,621,15,606
361031584074,36, New York,103, Suffolk County,156,92,31,0,61,31,31,31,0,0,125,61,0,0,61,607,107,500
361031584081,36, New York,103, Suffolk County,531,304,238,5,61,33,0,0,0,0,498,304,238,5,61,1446,109,1337
361031584082,36, New York,103, Suffolk County,399,215,135,55,25,0,0,0,0,0,399,215,135,55,25,1284,46,1238
361031584091,36, New York,103, Suffolk County,305,123,109,14,0,14,14,0,14,0,291,109,109,0,0,921,86,835
361031584092,36, New York,103, Suffolk County,378,129,118,0,11,0,0,0,0,0,378,129,118,0,11,1421,57,1364
361031584093,36, New York,103, Suffolk County,191,122,90,0,32,6,6,6,0,0,185,116,84,0,32,532,22,510
361031584101,36, New York,103, Suffolk County,405,38,38,0,0,7,0,0,0,0,398,38,38,0,0,1183,53,1130
361031584102,36, New York,103, Suffolk County,85,0,0,0,0,15,0,0,0,0,70,0,0,0,0,344,54,290
361031584103,36, New York,103, Suffolk County,179,27,27,0,0,0,0,0,0,0,179,27,27,0,0,1202,61,1141
361031584111,36, New York,103, Suffolk County,559,213,150,9,54,7,0,0,0,0,552,213,150,9,54,1765,32,1733
361031584112,36, New York,103, Suffolk County,191,145,145,0,0,0,0,0,0,0,191,145,145,0,0,547,8,539
361031584121,36, New York,103, Suffolk County,298,99,91,8,0,6,0,0,0,0,292,99,91,8,0,1098,12,1086
361031584122,36, New York,103, Suffolk County,330,185,185,0,0,0,0,0,0,0,330,185,185,0,0,990,11,979
361031585021,36, New York,103, Suffolk County,430,275,151,30,94,30,30,0,0,30,400,245,151,30,64,959,77,882
361031585022,36, New York,103, Suffolk County,346,195,183,0,12,0,0,0,0,0,346,195,183,0,12,804,15,789
361031585023,36, New York,103, Suffolk County,180,50,50,0,0,26,4,4,0,0,154,46,46,0,0,850,167,683
361031585051,36, New York,103, Suffolk County,518,257,249,0,8,18,9,9,0,0,500,248,240,0,8,1455,57,1398
361031585052,36, New York,103, Suffolk County,293,158,144,5,9,0,0,0,0,0,293,158,144,5,9,836,18,818
361031585053,36, New York,103, Suffolk County,103,73,66,0,7,12,0,0,0,0,91,73,66,0,7,486,210,276
361031585061,36, New York,103, Suffolk County,626,250,188,8,54,22,22,22,0,0,604,228,166,8,54,1771,126,1645
361031585062,36, New York,103, Suffolk County,287,203,125,0,78,5,5,0,0,5,282,198,125,0,73,776,13,763
361031585091,36, New York,103, Suffolk County,374,153,123,12,18,0,0,0,0,0,374,153,123,12,18,1151,24,1127
361031585092,36, New York,103, Suffolk County,385,206,169,10,27,30,30,30,0,0,355,176,139,10,27,919,84,835
361031585093,36, New York,103, Suffolk County,606,334,263,15,56,17,17,7,0,10,589,317,256,15,46,1618,40,1578
361031585101,36, New York,103, Suffolk County,261,61,61,0,0,0,0,0,0,0,261,61,61,0,0,819,0,819
361031585102,36, New York,103, Suffolk County,610,148,118,14,16,28,28,28,0,0,582,120,90,14,16,1976,35,1941
361031585103,36, New York,103, Suffolk County,508,142,117,13,12,0,0,0,0,0,508,142,117,13,12,1685,16,1669
361031585104,36, New York,103, Suffolk County,204,159,145,0,14,0,0,0,0,0,204,159,145,0,14,619,7,612
361031585105,36, New York,103, Suffolk County,159,113,99,0,14,14,14,0,0,14,145,99,99,0,0,456,49,407
361031585111,36, New York,103, Suffolk County,641,247,204,0,43,39,34,18,0,16,602,213,186,0,27,1929,90,1839
361031585112,36, New York,103, Suffolk County,757,332,237,33,62,14,0,0,0,0,743,332,237,33,62,1992,49,1943
361031585113,36, New York,103, Suffolk County,361,160,155,0,5,0,0,0,0,0,361,160,155,0,5,1075,10,1065
361031585121,36, New York,103, Suffolk County,533,175,133,42,0,0,0,0,0,0,533,175,133,42,0,1537,72,1465
361031585122,36, New York,103, Suffolk County,236,139,101,14,24,15,15,15,0,0,221,124,86,14,24,697,35,662
361031585131,36, New York,103, Suffolk County,180,39,18,0,21,14,14,0,0,14,166,25,18,0,7,426,19,407
361031585132,36, New York,103, Suffolk County,210,168,92,26,50,5,0,0,0,0,205,168,92,26,50,464,17,447
361031585133,36, New York,103, Suffolk County,372,178,162,0,16,0,0,0,0,0,372,178,162,0,16,1128,22,1106
361031585141,36, New York,103, Suffolk County,384,174,147,0,27,0,0,0,0,0,384,174,147,0,27,1085,0,1085
361031585142,36, New York,103, Suffolk County,508,223,147,24,52,9,9,9,0,0,499,214,138,24,52,1442,55,1387
361031585143,36, New York,103, Suffolk County,316,172,118,0,54,38,38,38,0,0,278,134,80,0,54,1020,82,938
361031585144,36, New York,103, Suffolk County,439,309,214,30,65,1,0,0,0,0,438,309,214,30,65,1253,32,1221
361031585145,36, New York,103, Suffolk County,350,240,183,42,15,0,0,0,0,0,350,240,183,42,15,1047,0,1047
361031586041,36, New York,103, Suffolk County,657,333,247,36,50,34,25,7,0,18,623,308,240,36,32,2072,134,1938
361031586042,36, New York,103, Suffolk County,170,56,49,0,7,0,0,0,0,0,170,56,49,0,7,652,12,640
361031586043,36, New York,103, Suffolk County,413,167,155,9,3,0,0,0,0,0,413,167,155,9,3,1285,0,1285
361031586051,36, New York,103, Suffolk County,360,172,141,8,23,0,0,0,0,0,360,172,141,8,23,1369,6,1363
361031586052,36, New York,103, Suffolk County,425,151,139,0,12,43,0,0,0,0,382,151,139,0,12,1088,83,1005
361031586053,36, New York,103, Suffolk County,444,250,240,0,10,0,0,0,0,0,444,250,240,0,10,1299,15,1284
361031586061,36, New York,103, Suffolk County,365,233,191,0,42,9,5,0,0,5,356,228,191,0,37,1069,20,1049
361031586062,36, New York,103, Suffolk County,225,90,90,0,0,12,0,0,0,0,213,90,90,0,0,694,60,634
361031586063,36, New York,103, Suffolk County,561,348,217,90,41,44,44,44,0,0,517,304,173,90,41,1717,125,1592
361031586071,36, New York,103, Suffolk County,169,78,36,42,0,0,0,0,0,0,169,78,36,42,0,474,31,443
361031586072,36, New York,103, Suffolk County,234,122,102,10,10,7,0,0,0,0,227,122,102,10,10,817,66,751
361031586073,36, New York,103, Suffolk County,440,167,128,0,39,31,0,0,0,0,409,167,128,0,39,1189,173,1016
361031586081,36, New York,103, Suffolk County,123,62,32,0,30,0,0,0,0,0,123,62,32,0,30,611,106,505
361031586082,36, New York,103, Suffolk County,265,141,125,0,16,43,43,36,0,7,222,98,89,0,9,935,155,780
361031586083,36, New York,103, Suffolk County,360,175,106,5,64,37,37,0,0,37,323,138,106,5,27,1108,91,1017
361031586091,36, New York,103, Suffolk County,132,47,20,0,27,0,0,0,0,0,132,47,20,0,27,528,29,499
361031586092,36, New York,103, Suffolk County,638,317,279,0,38,9,0,0,0,0,629,317,279,0,38,2537,55,2482
361031586093,36, New York,103, Suffolk County,211,95,56,39,0,7,1,1,0,0,204,94,55,39,0,770,56,714
361031587051,36, New York,103, Suffolk County,329,306,165,0,141,0,0,0,0,0,329,306,165,0,141,883,33,850
361031587052,36, New York,103, Suffolk County,356,197,168,0,29,12,12,0,0,12,344,185,168,0,17,820,59,761
361031587053,36, New York,103, Suffolk County,351,257,106,6,145,32,32,0,0,32,319,225,106,6,113,1164,165,999
361031587071,36, New York,103, Suffolk County,521,181,130,7,44,6,0,0,0,0,515,181,130,7,44,1574,64,1510
361031587081,36, New York,103, Suffolk County,286,94,6,0,88,31,31,0,0,31,255,63,6,0,57,1232,198,1034
361031587082,36, New York,103, Suffolk County,299,133,122,0,11,1,1,0,0,1,298,132,122,0,10,1083,24,1059
361031587083,36, New York,103, Suffolk County,138,77,12,51,14,14,14,0,0,14,124,63,12,51,0,461,30,431
361031587091,36, New York,103, Suffolk County,156,0,0,0,0,0,0,0,0,0,156,0,0,0,0,838,10,828
361031587092,36, New York,103, Suffolk County,509,221,161,0,60,13,0,0,0,0,496,221,161,0,60,1914,57,1857
361031587101,36, New York,103, Suffolk County,326,206,131,24,51,38,38,21,0,17,288,168,110,24,34,920,82,838
361031587102,36, New York,103, Suffolk County,368,237,162,0,75,0,0,0,0,0,368,237,162,0,75,1163,23,1140
361031587103,36, New York,103, Suffolk County,242,49,49,0,0,0,0,0,0,0,242,49,49,0,0,675,16,659
361031587104,36, New York,103, Suffolk County,0,0,0,0,0,0,0,0,0,0,0,0,0,0,0,0,0,0
361031587111,36, New York,103, Suffolk County,462,269,211,45,13,25,25,12,0,13,437,244,199,45,0,1209,35,1174
361031587112,36, New York,103, Suffolk County,379,159,71,0,88,0,0,0,0,0,379,159,71,0,88,1416,33,1383
361031587113,36, New York,103, Suffolk County,416,131,51,0,80,0,0,0,0,0,416,131,51,0,80,1545,7,1538
361031587114,36, New York,103, Suffolk County,115,0,0,0,0,0,0,0,0,0,115,0,0,0,0,499,49,450
361031587121,36, New York,103, Suffolk County,606,271,201,0,70,0,0,0,0,0,606,271,201,0,70,1889,60,1829
361031587122,36, New York,103, Suffolk County,234,24,24,0,0,0,0,0,0,0,234,24,24,0,0,846,79,767
361031587123,36, New York,103, Suffolk County,640,389,300,60,29,20,0,0,0,0,620,389,300,60,29,1528,127,1401
361031587124,36, New York,103, Suffolk County,141,49,38,11,0,0,0,0,0,0,141,49,38,11,0,721,65,656
361031587131,36, New York,103, Suffolk County,546,256,197,0,59,120,120,109,0,11,426,136,88,0,48,1868,520,1348
361031587132,36, New York,103, Suffolk County,229,28,28,0,0,0,0,0,0,0,229,28,28,0,0,718,32,686
361031587141,36, New York,103, Suffolk County,313,218,150,0,68,67,58,0,0,58,246,160,150,0,10,1067,160,907
361031587151,36, New York,103, Suffolk County,310,217,117,0,100,0,0,0,0,0,310,217,117,0,100,1328,181,1147
361031587152,36, New York,103, Suffolk County,784,186,125,0,61,91,21,21,0,0,693,165,104,0,61,2692,272,2420
361031588021,36, New York,103, Suffolk County,569,212,168,44,0,14,0,0,0,0,555,212,168,44,0,1733,158,1575
361031588022,36, New York,103, Suffolk County,239,69,60,9,0,0,0,0,0,0,239,69,60,9,0,520,0,520
361031588023,36, New York,103, Suffolk County,100,31,31,0,0,0,0,0,0,0,100,31,31,0,0,341,8,333
361031588024,36, New York,103, Suffolk County,421,185,185,0,0,56,0,0,0,0,365,185,185,0,0,1079,139,940
361031588031,36, New York,103, Suffolk County,435,61,61,0,0,0,0,0,0,0,435,61,61,0,0,1274,0,1274
361031588032,36, New York,103, Suffolk County,234,116,72,44,0,0,0,0,0,0,234,116,72,44,0,794,63,731
361031588033,36, New York,103, Suffolk County,222,109,87,0,22,0,0,0,0,0,222,109,87,0,22,685,59,626
361031588034,36, New York,103, Suffolk County,767,404,373,0,31,31,31,12,0,19,736,373,361,0,12,2062,130,1932
361031588051,36, New York,103, Suffolk County,260,158,126,14,18,18,18,0,0,18,242,140,126,14,0,845,40,805
361031588052,36, New York,103, Suffolk County,224,119,100,19,0,0,0,0,0,0,224,119,100,19,0,668,12,656
361031588053,36, New York,103, Suffolk County,310,175,150,0,25,0,0,0,0,0,310,175,150,0,25,1004,12,992
361031588061,36, New York,103, Suffolk County,362,204,193,0,11,5,0,0,0,0,357,204,193,0,11,952,10,942
361031588062,36, New York,103, Suffolk County,404,107,97,0,10,0,0,0,0,0,404,107,97,0,10,1017,12,1005
361031588063,36, New York,103, Suffolk County,327,193,150,0,43,0,0,0,0,0,327,193,150,0,43,866,12,854
361031589011,36, New York,103, Suffolk County,206,136,107,0,29,16,0,0,0,0,190,136,107,0,29,548,122,426
361031589012,36, New York,103, Suffolk County,259,62,30,0,32,0,0,0,0,0,259,62,30,0,32,899,30,869
361031589013,36, New York,103, Suffolk County,312,119,103,16,0,0,0,0,0,0,312,119,103,16,0,989,45,944
361031589021,36, New York,103, Suffolk County,415,230,115,75,40,32,0,0,0,0,383,230,115,75,40,1574,18,1556
361031589022,36, New York,103, Suffolk County,676,131,71,0,60,73,41,0,0,41,603,90,71,0,19,1613,205,1408
361031589023,36, New York,103, Suffolk County,75,19,19,0,0,0,0,0,0,0,75,19,19,0,0,166,0,166
361031590001,36, New York,103, Suffolk County,416,201,82,0,119,0,0,0,0,0,416,201,82,0,119,1179,36,1143
361031590002,36, New York,103, Suffolk County,367,185,104,0,81,9,9,0,0,9,358,176,104,0,72,1420,201,1219
361031590003,36, New York,103, Suffolk County,160,66,0,16,50,28,16,0,16,0,132,50,0,0,50,879,88,791
361031591031,36, New York,103, Suffolk County,298,131,22,23,86,60,60,22,0,38,238,71,0,23,48,797,116,681
361031591032,36, New York,103, Suffolk County,565,258,116,13,129,46,46,0,0,46,519,212,116,13,83,1330,83,1247
361031591033,36, New York,103, Suffolk County,228,138,91,0,47,71,35,0,0,35,157,103,91,0,12,546,269,277
361031591034,36, New York,103, Suffolk County,127,50,27,0,23,0,0,0,0,0,127,50,27,0,23,423,27,396
361031591061,36, New York,103, Suffolk County,455,140,74,7,59,26,26,18,0,8,429,114,56,7,51,1525,71,1454
361031591062,36, New York,103, Suffolk County,277,91,91,0,0,0,0,0,0,0,277,91,91,0,0,813,17,796
361031591063,36, New York,103, Suffolk County,328,176,106,62,8,47,7,7,0,0,281,169,99,62,8,827,116,711
361031591064,36, New York,103, Suffolk County,378,175,175,0,0,27,27,27,0,0,351,148,148,0,0,971,42,929
361031591071,36, New York,103, Suffolk County,387,144,144,0,0,45,45,45,0,0,342,99,99,0,0,997,163,834
361031591072,36, New York,103, Suffolk County,658,388,365,7,16,0,0,0,0,0,658,388,365,7,16,1902,57,1845
361031591081,36, New York,103, Suffolk County,747,337,254,0,83,0,0,0,0,0,747,337,254,0,83,1516,33,1483
361031591082,36, New York,103, Suffolk County,231,77,51,26,0,0,0,0,0,0,231,77,51,26,0,636,11,625
361031591083,36, New York,103, Suffolk County,324,108,108,0,0,0,0,0,0,0,324,108,108,0,0,1058,0,1058
361031591084,36, New York,103, Suffolk County,622,264,264,0,0,0,0,0,0,0,622,264,264,0,0,1913,18,1895
361031591091,36, New York,103, Suffolk County,457,345,245,5,95,5,5,0,5,0,452,340,245,0,95,1268,87,1181
361031591092,36, New York,103, Suffolk County,201,70,26,0,44,4,0,0,0,0,197,70,26,0,44,617,47,570
361031591101,36, New York,103, Suffolk County,315,123,123,0,0,13,13,13,0,0,302,110,110,0,0,1156,165,991
361031591102,36, New York,103, Suffolk County,346,112,107,5,0,0,0,0,0,0,346,112,107,5,0,1014,3,1011
361031591103,36, New York,103, Suffolk County,55,4,4,0,0,36,0,0,0,0,19,4,4,0,0,513,212,301
361031591111,36, New York,103, Suffolk County,402,165,156,0,9,22,0,0,0,0,380,165,156,0,9,1379,70,1309
361031591112,36, New York,103, Suffolk County,385,172,147,0,25,0,0,0,0,0,385,172,147,0,25,1144,16,1128
361031591121,36, New York,103, Suffolk County,436,238,148,11,79,0,0,0,0,0,436,238,148,11,79,1513,2,1511
361031591122,36, New York,103, Suffolk County,296,195,100,0,95,70,70,0,0,70,226,125,100,0,25,1147,246,901
361031592011,36, New York,103, Suffolk County,276,59,59,0,0,12,0,0,0,0,264,59,59,0,0,1195,26,1169
361031592012,36, New York,103, Suffolk County,530,238,215,23,0,37,37,37,0,0,493,201,178,23,0,1229,134,1095
361031592031,36, New York,103, Suffolk County,355,117,69,0,48,0,0,0,0,0,355,117,69,0,48,1137,0,1137
361031592032,36, New York,103, Suffolk County,368,150,150,0,0,14,0,0,0,0,354,150,150,0,0,931,45,886
361031592033,36, New York,103, Suffolk County,167,90,90,0,0,0,0,0,0,0,167,90,90,0,0,598,0,598
361031592034,36, New York,103, Suffolk County,299,110,110,0,0,0,0,0,0,0,299,110,110,0,0,1127,15,1112
361031592035,36, New York,103, Suffolk County,110,12,12,0,0,0,0,0,0,0,110,12,12,0,0,562,0,562
361031592041,36, New York,103, Suffolk County,108,0,0,0,0,0,0,0,0,0,108,0,0,0,0,457,90,367
361031592042,36, New York,103, Suffolk County,209,108,68,10,30,27,27,27,0,0,182,81,41,10,30,609,26,583
361031592043,36, New York,103, Suffolk County,223,86,62,0,24,30,9,0,0,9,193,77,62,0,15,644,85,559
361031592044,36, New York,103, Suffolk County,346,88,88,0,0,10,0,0,0,0,336,88,88,0,0,1146,42,1104
361031593001,36, New York,103, Suffolk County,144,42,26,16,0,0,0,0,0,0,144,42,26,16,0,465,30,435
361031593002,36, New York,103, Suffolk County,362,112,71,0,41,16,16,0,0,16,346,96,71,0,25,1090,34,1056
361031594061,36, New York,103, Suffolk County,395,149,79,13,57,47,47,0,0,47,348,102,79,13,10,1114,20,1094
361031594062,36, New York,103, Suffolk County,235,105,71,0,34,33,0,0,0,0,202,105,71,0,34,662,72,590
361031594063,36, New York,103, Suffolk County,197,113,104,0,9,9,9,0,0,9,188,104,104,0,0,625,9,616
361031594064,36, New York,103, Suffolk County,319,94,93,0,1,1,1,0,0,1,318,93,93,0,0,1033,58,975
361031594071,36, New York,103, Suffolk County,952,489,419,52,18,31,18,0,0,18,921,471,419,52,0,2467,65,2402
361031594072,36, New York,103, Suffolk County,581,493,416,32,45,29,29,0,0,29,552,464,416,32,16,1947,75,1872
361031594073,36, New York,103, Suffolk County,477,189,167,11,11,0,0,0,0,0,477,189,167,11,11,1307,13,1294
361031594081,36, New York,103, Suffolk County,292,150,106,44,0,0,0,0,0,0,292,150,106,44,0,1034,71,963
361031594082,36, New York,103, Suffolk County,445,197,120,22,55,72,43,0,0,43,373,154,120,22,12,1497,181,1316
361031594101,36, New York,103, Suffolk County,474,223,223,0,0,13,13,13,0,0,461,210,210,0,0,1234,66,1168
361031594102,36, New York,103, Suffolk County,690,259,227,0,32,72,72,72,0,0,618,187,155,0,32,2144,360,1784
361031594103,36, New York,103, Suffolk County,432,47,30,17,0,14,0,0,0,0,418,47,30,17,0,1006,42,964
361031594104,36, New York,103, Suffolk County,212,116,23,0,93,23,23,23,0,0,189,93,0,0,93,933,148,785
361031594105,36, New York,103, Suffolk County,101,0,0,0,0,0,0,0,0,0,101,0,0,0,0,249,0,249
361031594111,36, New York,103, Suffolk County,422,181,169,0,12,0,0,0,0,0,422,181,169,0,12,1272,40,1232
361031594112,36, New York,103, Suffolk County,376,209,115,14,80,19,15,15,0,0,357,194,100,14,80,1280,60,1220
361031594131,36, New York,103, Suffolk County,372,105,105,0,0,16,0,0,0,0,356,105,105,0,0,1029,65,964
361031594132,36, New York,103, Suffolk County,559,289,207,0,82,42,25,25,0,0,517,264,182,0,82,1517,152,1365
361031594133,36, New York,103, Suffolk County,345,84,84,0,0,0,0,0,0,0,345,84,84,0,0,1020,9,1011
361031594141,36, New York,103, Suffolk County,317,64,60,0,4,0,0,0,0,0,317,64,60,0,4,970,13,957
361031594142,36, New York,103, Suffolk County,375,188,89,76,23,72,36,0,20,16,303,152,89,56,7,1144,140,1004
361031594151,36, New York,103, Suffolk County,374,180,108,0,72,18,18,0,0,18,356,162,108,0,54,1119,195,924
361031594161,36, New York,103, Suffolk County,439,215,153,20,42,88,42,0,0,42,351,173,153,20,0,1049,132,917
361031594162,36, New York,103, Suffolk County,204,64,54,0,10,61,0,0,0,0,143,64,54,0,10,635,231,404
361031594163,36, New York,103, Suffolk County,403,224,86,0,138,36,0,0,0,0,367,224,86,0,138,952,112,840
361031594164,36, New York,103, Suffolk County,314,128,90,13,25,17,0,0,0,0,297,128,90,13,25,1270,288,982
361031595091,36, New York,103, Suffolk County,411,78,67,0,11,44,38,27,0,11,367,40,40,0,0,923,141,782
361031595092,36, New York,103, Suffolk County,285,110,0,51,59,40,14,0,0,14,245,96,0,51,45,1091,212,879
361031595093,36, New York,103, Suffolk County,171,101,79,0,22,22,22,22,0,0,149,79,57,0,22,509,73,436
361031595101,36, New York,103, Suffolk County,45,23,13,1,9,0,0,0,0,0,45,23,13,1,9,166,0,166
361031595102,36, New York,103, Suffolk County,6,0,0,0,0,2,0,0,0,0,4,0,0,0,0,20,4,16
361031595111,36, New York,103, Suffolk County,476,214,165,49,0,0,0,0,0,0,476,214,165,49,0,1049,22,1027
361031595112,36, New York,103, Suffolk County,630,345,156,91,98,123,123,6,85,32,507,222,150,6,66,1424,198,1226
361031595113,36, New York,103, Suffolk County,399,206,128,40,38,47,24,24,0,0,352,182,104,40,38,1154,182,972
361031595114,36, New York,103, Suffolk County,113,26,26,0,0,0,0,0,0,0,113,26,26,0,0,612,0,612
361031595121,36, New York,103, Suffolk County,576,257,162,52,43,65,6,0,6,0,511,251,162,46,43,1868,327,1541
361031595131,36, New York,103, Suffolk County,649,205,133,44,28,9,0,0,0,0,640,205,133,44,28,2047,49,1998
361031595132,36, New York,103, Suffolk County,606,164,134,12,18,23,23,23,0,0,583,141,111,12,18,1869,73,1796
361031595141,36, New York,103, Suffolk County,497,275,220,0,55,0,0,0,0,0,497,275,220,0,55,1579,53,1526
361031595142,36, New York,103, Suffolk County,77,54,39,0,15,0,0,0,0,0,77,54,39,0,15,430,33,397
361031595151,36, New York,103, Suffolk County,452,264,127,80,57,4,0,0,0,0,448,264,127,80,57,1277,85,1192
361031595152,36, New York,103, Suffolk County,172,96,31,0,65,58,58,0,0,58,114,38,31,0,7,420,58,362
361031595161,36, New York,103, Suffolk County,538,315,177,0,138,112,112,0,0,112,426,203,177,0,26,1469,163,1306
361031595162,36, New York,103, Suffolk County,631,130,130,0,0,0,0,0,0,0,631,130,130,0,0,1359,26,1333
361031595163,36, New York,103, Suffolk County,436,349,266,0,83,99,83,0,0,83,337,266,266,0,0,1031,219,812
361031595171,36, New York,103, Suffolk County,553,265,108,130,27,49,44,11,33,0,504,221,97,97,27,1019,204,815
361031595172,36, New York,103, Suffolk County,239,100,38,0,62,0,0,0,0,0,239,100,38,0,62,1036,95,941
361031595181,36, New York,103, Suffolk County,500,150,150,0,0,43,0,0,0,0,457,150,150,0,0,1521,179,1342
361031595182,36, New York,103, Suffolk County,584,251,136,26,89,77,50,0,0,50,507,201,136,26,39,1902,366,1536
361031596021,36, New York,103, Suffolk County,309,91,59,0,32,14,14,0,0,14,295,77,59,0,18,935,14,921
361031596022,36, New York,103, Suffolk County,812,380,343,19,18,6,0,0,0,0,806,380,343,19,18,2209,43,2166
361031596031,36, New York,103, Suffolk County,136,0,0,0,0,0,0,0,0,0,136,0,0,0,0,405,0,405
361031596032,36, New York,103, Suffolk County,284,47,47,0,0,47,0,0,0,0,237,47,47,0,0,575,73,502
361031596041,36, New York,103, Suffolk County,358,163,104,14,45,0,0,0,0,0,358,163,104,14,45,995,15,980
361031596042,36, New York,103, Suffolk County,221,196,95,0,101,0,0,0,0,0,221,196,95,0,101,551,0,551
361031596043,36, New York,103, Suffolk County,364,244,191,0,53,0,0,0,0,0,364,244,191,0,53,1024,32,992
361031596044,36, New York,103, Suffolk County,498,161,161,0,0,0,0,0,0,0,498,161,161,0,0,1464,26,1438
361031597001,36, New York,103, Suffolk County,545,107,96,0,11,4,0,0,0,0,541,107,96,0,11,1279,26,1253
361031597002,36, New York,103, Suffolk County,190,63,48,0,15,15,15,0,0,15,175,48,48,0,0,527,22,505
361031697011,36, New York,103, Suffolk County,527,191,113,0,78,24,0,0,0,0,503,191,113,0,78,1752,86,1666
361031697012,36, New York,103, Suffolk County,344,136,117,0,19,18,0,0,0,0,326,136,117,0,19,783,35,748
361031697013,36, New York,103, Suffolk County,511,133,119,0,14,0,0,0,0,0,511,133,119,0,14,1637,65,1572
361031697014,36, New York,103, Suffolk County,726,384,260,22,102,80,80,0,0,80,646,304,260,22,22,2165,80,2085
361031697031,36, New York,103, Suffolk County,206,33,22,0,11,12,5,0,0,5,194,28,22,0,6,602,20,582
361031697032,36, New York,103, Suffolk County,371,92,72,15,5,0,0,0,0,0,371,92,72,15,5,968,0,968
361031697051,36, New York,103, Suffolk County,354,150,138,0,12,0,0,0,0,0,354,150,138,0,12,819,22,797
361031697052,36, New York,103, Suffolk County,86,62,62,0,0,0,0,0,0,0,86,62,62,0,0,223,37,186
361031697053,36, New York,103, Suffolk County,104,51,0,44,7,0,0,0,0,0,104,51,0,44,7,291,43,248
361031697061,36, New York,103, Suffolk County,296,135,83,18,34,0,0,0,0,0,296,135,83,18,34,1119,63,1056
361031697062,36, New York,103, Suffolk County,499,0,0,0,0,123,0,0,0,0,376,0,0,0,0,1818,466,1352
361031697063,36, New York,103, Suffolk County,425,157,157,0,0,56,23,23,0,0,369,134,134,0,0,1382,84,1298
361031698001,36, New York,103, Suffolk County,223,38,38,0,0,23,0,0,0,0,200,38,38,0,0,652,74,578
361031698002,36, New York,103, Suffolk County,313,60,29,18,13,0,0,0,0,0,313,60,29,18,13,671,0,671
361031698003,36, New York,103, Suffolk County,640,389,321,0,68,98,98,30,0,68,542,291,291,0,0,1246,102,1144
361031698004,36, New York,103, Suffolk County,454,151,119,0,32,32,32,0,0,32,422,119,119,0,0,1413,101,1312
361031699031,36, New York,103, Suffolk County,347,47,47,0,0,0,0,0,0,0,347,47,47,0,0,912,44,868
361031699032,36, New York,103, Suffolk County,548,0,0,0,0,30,0,0,0,0,518,0,0,0,0,2093,207,1886
361031699033,36, New York,103, Suffolk County,377,187,143,44,0,0,0,0,0,0,377,187,143,44,0,730,0,730
361031699041,36, New York,103, Suffolk County,294,119,119,0,0,0,0,0,0,0,294,119,119,0,0,647,0,647
361031699042,36, New York,103, Suffolk County,59,0,0,0,0,35,0,0,0,0,24,0,0,0,0,361,118,243
361031699051,36, New York,103, Suffolk County,206,0,0,0,0,0,0,0,0,0,206,0,0,0,0,488,49,439
361031699052,36, New York,103, Suffolk County,378,209,209,0,0,0,0,0,0,0,378,209,209,0,0,938,16,922
361031699061,36, New York,103, Suffolk County,102,58,49,0,9,0,0,0,0,0,102,58,49,0,9,466,0,466
361031699062,36, New York,103, Suffolk County,361,118,118,0,0,0,0,0,0,0,361,118,118,0,0,992,88,904
361031699063,36, New York,103, Suffolk County,578,166,122,0,44,115,44,0,0,44,463,122,122,0,0,1560,210,1350
361031700031,36, New York,103, Suffolk County,337,125,125,0,0,0,0,0,0,0,337,125,125,0,0,1079,102,977
361031700032,36, New York,103, Suffolk County,263,74,15,0,59,29,29,0,0,29,234,45,15,0,30,714,43,671
361031700041,36, New York,103, Suffolk County,386,117,117,0,0,0,0,0,0,0,386,117,117,0,0,857,0,857
361031700042,36, New York,103, Suffolk County,414,60,60,0,0,0,0,0,0,0,414,60,60,0,0,856,0,856
361031700043,36, New York,103, Suffolk County,328,115,115,0,0,0,0,0,0,0,328,115,115,0,0,1144,29,1115
361031700051,36, New York,103, Suffolk County,253,59,46,13,0,0,0,0,0,0,253,59,46,13,0,818,102,716
361031700052,36, New York,103, Suffolk County,360,73,17,0,56,13,0,0,0,0,347,73,17,0,56,767,41,726
361031700053,36, New York,103, Suffolk County,164,36,14,4,18,4,4,0,4,0,160,32,14,0,18,384,17,367
361031700061,36, New York,103, Suffolk County,183,75,75,0,0,0,0,0,0,0,183,75,75,0,0,580,0,580
361031700062,36, New York,103, Suffolk County,222,36,36,0,0,0,0,0,0,0,222,36,36,0,0,683,15,668
361031701011,36, New York,103, Suffolk County,356,124,70,45,9,35,35,26,0,9,321,89,44,45,0,792,46,746
361031701012,36, New York,103, Suffolk County,336,80,43,0,37,14,0,0,0,0,322,80,43,0,37,975,65,910
361031702031,36, New York,103, Suffolk County,355,102,102,0,0,0,0,0,0,0,355,102,102,0,0,861,58,803
361031702032,36, New York,103, Suffolk County,182,115,48,15,52,0,0,0,0,0,182,115,48,15,52,458,15,443
361031702041,36, New York,103, Suffolk County,449,152,152,0,0,0,0,0,0,0,449,152,152,0,0,1049,103,946
361031702042,36, New York,103, Suffolk County,272,34,13,21,0,0,0,0,0,0,272,34,13,21,0,888,14,874
361031702043,36, New York,103, Suffolk County,525,230,230,0,0,0,0,0,0,0,525,230,230,0,0,1237,52,1185
361031702051,36, New York,103, Suffolk County,241,82,65,17,0,7,7,0,7,0,234,75,65,10,0,664,26,638
361031702052,36, New York,103, Suffolk County,176,27,27,0,0,10,0,0,0,0,166,27,27,0,0,679,80,599
361031702053,36, New York,103, Suffolk County,104,36,36,0,0,0,0,0,0,0,104,36,36,0,0,392,24,368
361031702061,36, New York,103, Suffolk County,13,4,4,0,0,0,0,0,0,0,13,4,4,0,0,38,0,38
361031702062,36, New York,103, Suffolk County,476,90,83,7,0,0,0,0,0,0,476,90,83,7,0,1412,25,1387
361031702063,36, New York,103, Suffolk County,347,0,0,0,0,6,0,0,0,0,341,0,0,0,0,1214,59,1155
361031803001,36, New York,103, Suffolk County,409,156,156,0,0,0,0,0,0,0,409,156,156,0,0,1340,0,1340
361031803002,36, New York,103, Suffolk County,285,147,147,0,0,0,0,0,0,0,285,147,147,0,0,449,8,441
361031803003,36, New York,103, Suffolk County,58,0,0,0,0,0,0,0,0,0,58,0,0,0,0,212,56,156
361031803004,36, New York,103, Suffolk County,179,0,0,0,0,47,0,0,0,0,132,0,0,0,0,628,160,468
361031904021,36, New York,103, Suffolk County,291,89,20,23,46,29,29,0,0,29,262,60,20,23,17,803,105,698
361031904022,36, New York,103, Suffolk County,473,166,139,27,0,17,17,17,0,0,456,149,122,27,0,1165,90,1075
361031904031,36, New York,103, Suffolk County,267,27,27,0,0,0,0,0,0,0,267,27,27,0,0,825,36,789
361031904032,36, New York,103, Suffolk County,390,237,185,19,33,35,21,21,0,0,355,216,164,19,33,842,80,762
361031904033,36, New York,103, Suffolk County,457,163,142,21,0,0,0,0,0,0,457,163,142,21,0,1247,135,1112
361031904041,36, New York,103, Suffolk County,317,63,63,0,0,36,0,0,0,0,281,63,63,0,0,1233,55,1178
361031904042,36, New York,103, Suffolk County,0,0,0,0,0,0,0,0,0,0,0,0,0,0,0,16,16,0
361031904043,36, New York,103, Suffolk County,352,180,54,0,126,13,0,0,0,0,339,180,54,0,126,844,4,840
361031904051,36, New York,103, Suffolk County,277,125,94,31,0,72,72,72,0,0,205,53,22,31,0,793,160,633
361031904052,36, New York,103, Suffolk County,507,307,129,47,131,102,102,0,0,102,405,205,129,47,29,1392,152,1240
361031904053,36, New York,103, Suffolk County,582,226,127,34,65,26,26,0,21,5,556,200,127,13,60,1268,16,1252
361031905021,36, New York,103, Suffolk County,193,114,102,12,0,0,0,0,0,0,193,114,102,12,0,562,12,550
361031905022,36, New York,103, Suffolk County,259,133,71,49,13,27,27,4,12,11,232,106,67,37,2,752,51,701
361031905023,36, New York,103, Suffolk County,301,26,18,6,2,2,2,0,0,2,299,24,18,6,0,1115,110,1005
361031905024,36, New York,103, Suffolk County,28,0,0,0,0,0,0,0,0,0,28,0,0,0,0,123,10,113
361031905031,36, New York,103, Suffolk County,270,104,90,0,14,0,0,0,0,0,270,104,90,0,14,682,10,672
361031905032,36, New York,103, Suffolk County,234,131,37,0,94,38,38,0,0,38,196,93,37,0,56,537,62,475
361031905033,36, New York,103, Suffolk County,333,97,97,0,0,0,0,0,0,0,333,97,97,0,0,852,34,818
361031905041,36, New York,103, Suffolk County,52,9,9,0,0,0,0,0,0,0,52,9,9,0,0,129,0,129
361031905042,36, New York,103, Suffolk County,456,135,135,0,0,0,0,0,0,0,456,135,135,0,0,1186,10,1176
361031905043,36, New York,103, Suffolk County,255,144,144,0,0,7,0,0,0,0,248,144,144,0,0,677,26,651
361031906031,36, New York,103, Suffolk County,410,225,116,36,73,42,42,0,0,42,368,183,116,36,31,965,40,925
361031906032,36, New York,103, Suffolk County,128,35,35,0,0,0,0,0,0,0,128,35,35,0,0,388,0,388
361031906033,36, New York,103, Suffolk County,367,164,155,9,0,0,0,0,0,0,367,164,155,9,0,899,0,899
361031906034,36, New York,103, Suffolk County,638,323,264,42,17,0,0,0,0,0,638,323,264,42,17,1851,151,1700
361031906041,36, New York,103, Suffolk County,722,369,258,17,94,105,70,0,0,70,617,299,258,17,24,1904,127,1777
361031906042,36, New York,103, Suffolk County,547,179,52,35,92,56,56,0,0,56,491,123,52,35,36,1308,15,1293
361031906043,36, New York,103, Suffolk County,267,178,178,0,0,0,0,0,0,0,267,178,178,0,0,702,22,680
361031906051,36, New York,103, Suffolk County,137,65,22,0,43,43,43,0,0,43,94,22,22,0,0,305,73,232
361031906052,36, New York,103, Suffolk County,72,11,11,0,0,0,0,0,0,0,72,11,11,0,0,127,0,127
361031906061,36, New York,103, Suffolk County,470,79,79,0,0,11,0,0,0,0,459,79,79,0,0,1275,50,1225
361031906062,36, New York,103, Suffolk County,228,93,93,0,0,91,80,80,0,0,137,13,13,0,0,709,270,439
361031906063,36, New York,103, Suffolk County,215,65,65,0,0,37,0,0,0,0,178,65,65,0,0,442,80,362
361031906064,36, New York,103, Suffolk County,242,106,61,45,0,0,0,0,0,0,242,106,61,45,0,768,13,755
361031907061,36, New York,103, Suffolk County,95,45,24,0,21,5,0,0,0,0,90,45,24,0,21,299,37,262
361031907062,36, New York,103, Suffolk County,143,121,19,0,102,59,59,0,0,59,84,62,19,0,43,407,130,277
361031907063,36, New York,103, Suffolk County,360,190,158,0,32,8,0,0,0,0,352,190,158,0,32,900,62,838
361031907064,36, New York,103, Suffolk County,495,69,59,0,10,10,10,0,0,10,485,59,59,0,0,1518,35,1483
361031907065,36, New York,103, Suffolk County,336,238,223,15,0,0,0,0,0,0,336,238,223,15,0,1647,13,1634
361031907081,36, New York,103, Suffolk County,291,75,57,13,5,7,0,0,0,0,284,75,57,13,5,754,39,715
361031907082,36, New York,103, Suffolk County,209,33,29,0,4,7,7,7,0,0,202,26,22,0,4,587,21,566
361031907083,36, New York,103, Suffolk County,105,36,27,9,0,0,0,0,0,0,105,36,27,9,0,297,9,288
361031907091,36, New York,103, Suffolk County,66,14,6,0,8,18,8,0,0,8,48,6,6,0,0,197,49,148
361031907092,36, New York,103, Suffolk County,215,40,24,0,16,0,0,0,0,0,215,40,24,0,16,542,0,542
361031907093,36, New York,103, Suffolk County,324,174,147,0,27,0,0,0,0,0,324,174,147,0,27,734,9,725
361031907101,36, New York,103, Suffolk County,177,0,0,0,0,0,0,0,0,0,177,0,0,0,0,571,65,506
361031907102,36, New York,103, Suffolk County,253,98,76,0,22,0,0,0,0,0,253,98,76,0,22,615,0,615
361031907111,36, New York,103, Suffolk County,576,211,181,0,30,0,0,0,0,0,576,211,181,0,30,1137,22,1115
361031907112,36, New York,103, Suffolk County,224,165,87,0,78,0,0,0,0,0,224,165,87,0,78,620,0,620
361031907113,36, New York,103, Suffolk County,424,253,218,0,35,62,62,27,0,35,362,191,191,0,0,950,105,845
361031907114,36, New York,103, Suffolk County,68,40,27,13,0,0,0,0,0,0,68,40,27,13,0,209,0,209
361031907121,36, New York,103, Suffolk County,56,0,0,0,0,0,0,0,0,0,56,0,0,0,0,189,7,182
361031907122,36, New York,103, Suffolk County,41,0,0,0,0,14,0,0,0,0,27,0,0,0,0,88,37,51
361031907123,36, New York,103, Suffolk County,226,19,10,9,0,0,0,0,0,0,226,19,10,9,0,557,49,508
361031907131,36, New York,103, Suffolk County,368,94,71,0,23,0,0,0,0,0,368,94,71,0,23,837,71,766
361031907132,36, New York,103, Suffolk County,318,102,102,0,0,0,0,0,0,0,318,102,102,0,0,843,28,815
361031907141,36, New York,103, Suffolk County,207,82,54,0,28,0,0,0,0,0,207,82,54,0,28,442,2,440
361031907142,36, New York,103, Suffolk County,94,31,0,12,19,12,12,0,12,0,82,19,0,0,19,260,39,221
361031907143,36, New York,103, Suffolk County,259,106,97,0,9,0,0,0,0,0,259,106,97,0,9,659,24,635
361031908011,36, New York,103, Suffolk County,305,58,47,0,11,0,0,0,0,0,305,58,47,0,11,1158,22,1136
361031908012,36, New York,103, Suffolk County,270,78,59,19,0,0,0,0,0,0,270,78,59,19,0,662,33,629
361031908021,36, New York,103, Suffolk County,272,86,86,0,0,19,0,0,0,0,253,86,86,0,0,772,25,747
361031908022,36, New York,103, Suffolk County,287,187,85,61,41,0,0,0,0,0,287,187,85,61,41,711,40,671
361032009011,36, New York,103, Suffolk County,238,88,67,14,7,49,10,10,0,0,189,78,57,14,7,568,103,465
361032009012,36, New York,103, Suffolk County,149,24,4,4,16,3,0,0,0,0,146,24,4,4,16,435,20,415
361032009031,36, New York,103, Suffolk County,347,141,129,12,0,4,0,0,0,0,343,141,129,12,0,1085,127,958
361032009032,36, New York,103, Suffolk County,158,60,49,0,11,11,11,0,0,11,147,49,49,0,0,505,49,456
361032009041,36, New York,103, Suffolk County,341,303,75,138,90,109,71,0,71,0,232,232,75,67,90,601,130,471
361032009042,36, New York,103, Suffolk County,316,81,62,0,19,0,0,0,0,0,316,81,62,0,19,852,0,852
361032009051,36, New York,103, Suffolk County,185,18,0,0,18,0,0,0,0,0,185,18,0,0,18,639,40,599
361032009052,36, New York,103, Suffolk County,231,52,31,21,0,0,0,0,0,0,231,52,31,21,0,728,6,722
361032009061,36, New York,103, Suffolk County,550,357,338,0,19,249,249,249,0,0,301,108,89,0,19,1203,352,851
361032009062,36, New York,103, Suffolk County,397,76,24,12,40,33,0,0,0,0,364,76,24,12,40,964,74,890
361032010051,36, New York,103, Suffolk County,437,267,143,0,124,6,6,6,0,0,431,261,137,0,124,1302,99,1203
361032010052,36, New York,103, Suffolk County,165,47,25,0,22,0,0,0,0,0,165,47,25,0,22,562,8,554
361032010061,36, New York,103, Suffolk County,164,15,9,0,6,0,0,0,0,0,164,15,9,0,6,502,7,495
361032010062,36, New York,103, Suffolk County,47,26,26,0,0,0,0,0,0,0,47,26,26,0,0,102,0,102
361032010063,36, New York,103, Suffolk County,54,0,0,0,0,0,0,0,0,0,54,0,0,0,0,144,0,144
361032010071,36, New York,103, Suffolk County,145,92,41,40,11,0,0,0,0,0,145,92,41,40,11,421,8,413
361032010072,36, New York,103, Suffolk County,203,44,44,0,0,0,0,0,0,0,203,44,44,0,0,509,31,478
361032010073,36, New York,103, Suffolk County,195,62,36,14,12,0,0,0,0,0,195,62,36,14,12,728,15,713
361032010081,36, New York,103, Suffolk County,155,52,23,0,29,0,0,0,0,0,155,52,23,0,29,435,26,409
361032010082,36, New York,103, Suffolk County,393,104,95,0,9,0,0,0,0,0,393,104,95,0,9,1340,8,1332
361032010091,36, New York,103, Suffolk County,588,312,66,51,195,160,160,0,0,160,428,152,66,51,35,1115,39,1076
361032010092,36, New York,103, Suffolk County,374,127,118,0,9,87,87,87,0,0,287,40,31,0,9,986,116,870
361032010093,36, New York,103, Suffolk County,358,0,0,0,0,0,0,0,0,0,358,0,0,0,0,1108,0,1108
361032010094,36, New York,103, Suffolk County,306,126,126,0,0,0,0,0,0,0,306,126,126,0,0,1036,0,1036
361032010101,36, New York,103, Suffolk County,534,206,206,0,0,0,0,0,0,0,534,206,206,0,0,1160,12,1148
361032010102,36, New York,103, Suffolk County,337,50,50,0,0,2,0,0,0,0,335,50,50,0,0,950,35,915
361032012001,36, New York,103, Suffolk County,0,0,0,0,0,0,0,0,0,0,0,0,0,0,0,135,87,48
361039901000,36, New York,103, Suffolk County,0,0,0,0,0,0,0,0,0,0,0,0,0,0,0,0,0,0
360690501011,36, New York,069, Ontario County,232,156,156,0,0,0,0,0,0,0,232,156,156,0,0,637,0,637
360690501012,36, New York,069, Ontario County,355,218,202,0,16,0,0,0,0,0,355,218,202,0,16,912,0,912
360690501013,36, New York,069, Ontario County,389,180,138,10,32,24,24,0,0,24,365,156,138,10,8,1073,24,1049
360690501031,36, New York,069, Ontario County,350,42,0,17,25,9,0,0,0,0,341,42,0,17,25,986,96,890
360690501032,36, New York,069, Ontario County,582,349,280,69,0,0,0,0,0,0,582,349,280,69,0,1900,114,1786
360690501041,36, New York,069, Ontario County,169,112,93,19,0,0,0,0,0,0,169,112,93,19,0,407,32,375
360690501042,36, New York,069, Ontario County,711,382,382,0,0,0,0,0,0,0,711,382,382,0,0,1479,15,1464
360690501043,36, New York,069, Ontario County,281,77,77,0,0,0,0,0,0,0,281,77,77,0,0,605,0,605
360690501051,36, New York,069, Ontario County,401,224,183,8,33,34,11,0,0,11,367,213,183,8,22,1056,96,960
360690501052,36, New York,069, Ontario County,216,77,11,0,66,0,0,0,0,0,216,77,11,0,66,469,0,469
360690501053,36, New York,069, Ontario County,356,160,125,8,27,0,0,0,0,0,356,160,125,8,27,947,28,919
360690501061,36, New York,069, Ontario County,483,106,72,9,25,20,0,0,0,0,463,106,72,9,25,1316,67,1249
360690502031,36, New York,069, Ontario County,234,167,87,64,16,7,0,0,0,0,227,167,87,64,16,848,52,796
360690502032,36, New York,069, Ontario County,425,319,223,0,96,6,6,0,0,6,419,313,223,0,90,1355,168,1187
360690502033,36, New York,069, Ontario County,254,75,46,0,29,14,0,0,0,0,240,75,46,0,29,956,89,867
360690502041,36, New York,069, Ontario County,479,169,153,0,16,26,16,0,0,16,453,153,153,0,0,1364,100,1264
360690502042,36, New York,069, Ontario County,273,92,46,20,26,26,26,0,0,26,247,66,46,20,0,628,26,602
360690502043,36, New York,069, Ontario County,301,59,35,0,24,19,0,0,0,0,282,59,35,0,24,786,36,750
360690502051,36, New York,069, Ontario County,473,238,152,40,46,42,42,42,0,0,431,196,110,40,46,1606,276,1330
360690502052,36, New York,069, Ontario County,708,384,192,97,95,0,0,0,0,0,708,384,192,97,95,1711,0,1711
360690502061,36, New York,069, Ontario County,596,310,144,0,166,49,41,0,0,41,547,269,144,0,125,1574,166,1408
360690503021,36, New York,069, Ontario County,481,145,130,5,10,4,0,0,0,0,477,145,130,5,10,1368,74,1294
360690503022,36, New York,069, Ontario County,305,100,76,0,24,9,5,0,0,5,296,95,76,0,19,885,37,848
360690503023,36, New York,069, Ontario County,314,171,104,37,30,18,18,0,0,18,296,153,104,37,12,952,104,848
360690503031,36, New York,069, Ontario County,326,175,125,11,39,13,10,0,0,10,313,165,125,11,29,1034,164,870
360690503032,36, New York,069, Ontario County,245,152,60,33,59,54,45,0,0,45,191,107,60,33,14,706,145,561
360690503041,36, New York,069, Ontario County,399,138,73,11,54,55,28,7,0,21,344,110,66,11,33,1387,288,1099
360690503042,36, New York,069, Ontario County,335,84,67,0,17,0,0,0,0,0,335,84,67,0,17,907,11,896
360690504011,36, New York,069, Ontario County,511,136,65,0,71,0,0,0,0,0,511,136,65,0,71,1139,0,1139
360690504012,36, New York,069, Ontario County,309,198,86,27,85,58,58,0,19,39,251,140,86,8,46,969,168,801
360690504013,36, New York,069, Ontario County,201,102,66,18,18,28,28,0,18,10,173,74,66,0,8,574,28,546
360690504021,36, New York,069, Ontario County,234,114,42,44,28,31,31,0,31,0,203,83,42,13,28,688,101,587
360690504022,36, New York,069, Ontario County,169,56,28,0,28,0,0,0,0,0,169,56,28,0,28,473,19,454
360690504023,36, New York,069, Ontario County,251,95,70,25,0,0,0,0,0,0,251,95,70,25,0,623,0,623
360690504024,36, New York,069, Ontario County,149,80,60,20,0,0,0,0,0,0,149,80,60,20,0,615,64,551
360690505011,36, New York,069, Ontario County,486,242,222,0,20,20,20,0,0,20,466,222,222,0,0,1329,101,1228
360690505012,36, New York,069, Ontario County,411,115,82,0,33,12,0,0,0,0,399,115,82,0,33,1150,63,1087
360690505013,36, New York,069, Ontario County,140,68,51,17,0,0,0,0,0,0,140,68,51,17,0,408,0,408
360690505021,36, New York,069, Ontario County,377,123,51,22,50,28,22,0,0,22,349,101,51,22,28,1052,77,975
360690505022,36, New York,069, Ontario County,390,179,156,5,18,21,16,16,0,0,369,163,140,5,18,1167,125,1042
360690506011,36, New York,069, Ontario County,484,180,153,0,27,0,0,0,0,0,484,180,153,0,27,1186,25,1161
360690506012,36, New York,069, Ontario County,471,178,142,12,24,25,25,25,0,0,446,153,117,12,24,1576,408,1168
360690506013,36, New York,069, Ontario County,901,442,338,0,104,0,0,0,0,0,901,442,338,0,104,2043,29,2014
360690506031,36, New York,069, Ontario County,438,255,202,26,27,33,12,0,0,12,405,243,202,26,15,1008,108,900
360690506032,36, New York,069, Ontario County,290,126,65,40,21,0,0,0,0,0,290,126,65,40,21,799,27,772
360690506041,36, New York,069, Ontario County,321,118,87,14,17,0,0,0,0,0,321,118,87,14,17,1262,127,1135
360690506042,36, New York,069, Ontario County,243,63,0,10,53,24,0,0,0,0,219,63,0,10,53,856,145,711
360690508001,36, New York,069, Ontario County,286,96,41,0,55,36,23,10,0,13,250,73,31,0,42,1277,110,1167
360690508002,36, New York,069, Ontario County,345,226,113,0,113,37,19,0,0,19,308,207,113,0,94,1137,153,984
360690509001,36, New York,069, Ontario County,365,104,104,0,0,0,0,0,0,0,365,104,104,0,0,1097,108,989
360690509002,36, New York,069, Ontario County,324,114,65,32,17,0,0,0,0,0,324,114,65,32,17,1026,72,954
360690510011,36, New York,069, Ontario County,40,17,6,0,11,10,0,0,0,0,30,17,6,0,11,280,13,267
360690510012,36, New York,069, Ontario County,366,217,143,15,59,0,0,0,0,0,366,217,143,15,59,1203,87,1116
360690511011,36, New York,069, Ontario County,217,74,51,0,23,0,0,0,0,0,217,74,51,0,23,632,44,588
360690511012,36, New York,069, Ontario County,197,83,53,10,20,11,11,0,0,11,186,72,53,10,9,872,49,823
360690511021,36, New York,069, Ontario County,151,0,0,0,0,0,0,0,0,0,151,0,0,0,0,606,44,562
360690511022,36, New York,069, Ontario County,114,95,79,12,4,0,0,0,0,0,114,95,79,12,4,510,32,478
360690512001,36, New York,069, Ontario County,432,190,89,58,43,0,0,0,0,0,432,190,89,58,43,1169,38,1131
360690512002,36, New York,069, Ontario County,210,44,13,31,0,0,0,0,0,0,210,44,13,31,0,741,75,666
360690512003,36, New York,069, Ontario County,359,188,96,35,57,0,0,0,0,0,359,188,96,35,57,1019,45,974
360690513011,36, New York,069, Ontario County,240,29,29,0,0,0,0,0,0,0,240,29,29,0,0,580,0,580
360690513012,36, New York,069, Ontario County,291,125,106,4,15,7,0,0,0,0,284,125,106,4,15,762,29,733
360690513021,36, New York,069, Ontario County,416,175,77,0,98,28,28,0,0,28,388,147,77,0,70,1128,133,995
360690513022,36, New York,069, Ontario County,254,33,23,0,10,18,0,0,0,0,236,33,23,0,10,834,41,793
360690514001,36, New York,069, Ontario County,264,107,78,0,29,15,0,0,0,0,249,107,78,0,29,730,79,651
360690514002,36, New York,069, Ontario County,195,59,35,0,24,0,0,0,0,0,195,59,35,0,24,521,31,490
360690514003,36, New York,069, Ontario County,217,102,81,6,15,10,10,4,6,0,207,92,77,0,15,808,37,771
360690515011,36, New York,069, Ontario County,246,128,128,0,0,0,0,0,0,0,246,128,128,0,0,674,59,615
360690515012,36, New York,069, Ontario County,292,41,41,0,0,14,0,0,0,0,278,41,41,0,0,994,75,919
360690515021,36, New York,069, Ontario County,387,190,71,45,74,89,59,5,32,22,298,131,66,13,52,1084,98,986
360690516001,36, New York,069, Ontario County,189,89,89,0,0,0,0,0,0,0,189,89,89,0,0,510,12,498
360690516002,36, New York,069, Ontario County,180,38,4,4,30,7,7,0,0,7,173,31,4,4,23,657,59,598
360690517001,36, New York,069, Ontario County,261,160,22,24,114,55,55,0,0,55,206,105,22,24,59,677,201,476
360690517002,36, New York,069, Ontario County,154,63,43,20,0,20,20,0,20,0,134,43,43,0,0,504,96,408
360690517003,36, New York,069, Ontario County,203,124,33,36,55,87,87,0,36,51,116,37,33,0,4,595,139,456
360690518011,36, New York,069, Ontario County,220,57,27,7,23,0,0,0,0,0,220,57,27,7,23,721,32,689
360690518012,36, New York,069, Ontario County,252,73,23,0,50,10,0,0,0,0,242,73,23,0,50,1276,205,1071
360690518013,36, New York,069, Ontario County,228,92,57,12,23,14,14,0,0,14,214,78,57,12,9,726,34,692
360690518014,36, New York,069, Ontario County,456,236,81,23,132,75,47,0,12,35,381,189,81,11,97,1459,418,1041
360690519001,36, New York,069, Ontario County,142,52,52,0,0,6,0,0,0,0,136,52,52,0,0,422,31,391
360690519002,36, New York,069, Ontario County,174,75,75,0,0,49,21,21,0,0,125,54,54,0,0,502,89,413
360690520011,36, New York,069, Ontario County,204,38,34,4,0,0,0,0,0,0,204,38,34,4,0,589,28,561
360690520012,36, New York,069, Ontario County,128,14,11,0,3,0,0,0,0,0,128,14,11,0,3,376,16,360
360690520013,36, New York,069, Ontario County,146,44,33,0,11,6,3,3,0,0,140,41,30,0,11,473,31,442
360690520021,36, New York,069, Ontario County,326,138,98,19,21,32,0,0,0,0,294,138,98,19,21,805,95,710
360690520022,36, New York,069, Ontario County,252,124,89,0,35,0,0,0,0,0,252,124,89,0,35,436,14,422
360690520031,36, New York,069, Ontario County,169,83,76,7,0,0,0,0,0,0,169,83,76,7,0,799,0,799
360690520032,36, New York,069, Ontario County,324,50,50,0,0,0,0,0,0,0,324,50,50,0,0,700,0,700
360690521011,36, New York,069, Ontario County,186,31,22,0,9,12,9,0,0,9,174,22,22,0,0,475,45,430
360690521012,36, New York,069, Ontario County,333,86,66,13,7,14,0,0,0,0,319,86,66,13,7,1048,88,960
360690521021,36, New York,069, Ontario County,340,70,57,0,13,9,9,4,0,5,331,61,53,0,8,914,33,881
360690521022,36, New York,069, Ontario County,316,103,83,15,5,7,7,7,0,0,309,96,76,15,5,794,51,743
360690522001,36, New York,069, Ontario County,204,68,39,4,25,9,5,3,0,2,195,63,36,4,23,616,50,566
360690522002,36, New York,069, Ontario County,119,55,22,4,29,19,16,0,0,16,100,39,22,4,13,485,96,389
360690522003,36, New York,069, Ontario County,357,134,81,10,43,76,56,15,6,35,281,78,66,4,8,915,161,754
361119501001,36, New York,111, Ulster County,395,115,115,0,0,0,0,0,0,0,395,115,115,0,0,1085,14,1071
361119501002,36, New York,111, Ulster County,216,64,64,0,0,0,0,0,0,0,216,64,64,0,0,608,39,569
361119501003,36, New York,111, Ulster County,396,201,39,162,0,0,0,0,0,0,396,201,39,162,0,917,4,913
361119501004,36, New York,111, Ulster County,254,20,20,0,0,0,0,0,0,0,254,20,20,0,0,632,0,632
361119501005,36, New York,111, Ulster County,181,25,25,0,0,0,0,0,0,0,181,25,25,0,0,374,9,365
361119502001,36, New York,111, Ulster County,246,110,110,0,0,0,0,0,0,0,246,110,110,0,0,1182,161,1021
361119502002,36, New York,111, Ulster County,287,148,106,19,23,3,3,3,0,0,284,145,103,19,23,1085,116,969
361119502003,36, New York,111, Ulster County,156,76,39,19,18,11,11,0,11,0,145,65,39,8,18,739,112,627
361119503001,36, New York,111, Ulster County,574,302,101,26,175,58,58,0,0,58,516,244,101,26,117,1479,167,1312
361119503002,36, New York,111, Ulster County,248,83,69,0,14,17,11,0,0,11,231,72,69,0,3,874,69,805
361119503003,36, New York,111, Ulster County,315,63,38,0,25,7,0,0,0,0,308,63,38,0,25,1330,211,1119
361119504001,36, New York,111, Ulster County,180,56,56,0,0,10,0,0,0,0,170,56,56,0,0,519,29,490
361119504002,36, New York,111, Ulster County,229,116,95,6,15,0,0,0,0,0,229,116,95,6,15,533,26,507
361119504003,36, New York,111, Ulster County,207,38,38,0,0,0,0,0,0,0,207,38,38,0,0,912,3,909
361119504004,36, New York,111, Ulster County,134,37,21,0,16,0,0,0,0,0,134,37,21,0,16,473,35,438
361119504005,36, New York,111, Ulster County,241,42,30,0,12,0,0,0,0,0,241,42,30,0,12,833,82,751
361119504006,36, New York,111, Ulster County,130,34,23,0,11,0,0,0,0,0,130,34,23,0,11,513,96,417
361119505001,36, New York,111, Ulster County,288,36,27,0,9,30,13,13,0,0,258,23,14,0,9,866,76,790
361119505002,36, New York,111, Ulster County,134,37,37,0,0,0,0,0,0,0,134,37,37,0,0,684,103,581
361119505003,36, New York,111, Ulster County,383,124,50,9,65,37,18,0,0,18,346,106,50,9,47,1118,156,962
361119506001,36, New York,111, Ulster County,294,99,53,8,38,20,9,9,0,0,274,90,44,8,38,856,105,751
361119506002,36, New York,111, Ulster County,269,100,91,0,9,12,0,0,0,0,257,100,91,0,9,765,63,702
361119506003,36, New York,111, Ulster County,243,61,13,0,48,11,0,0,0,0,232,61,13,0,48,872,174,698
361119509001,36, New York,111, Ulster County,140,48,36,0,12,14,10,0,0,10,126,38,36,0,2,487,120,367
361119509002,36, New York,111, Ulster County,187,35,28,2,5,7,7,0,2,5,180,28,28,0,0,599,75,524
361119510001,36, New York,111, Ulster County,164,24,0,17,7,17,17,0,17,0,147,7,0,0,7,450,35,415
361119510002,36, New York,111, Ulster County,457,114,31,83,0,23,11,0,11,0,434,103,31,72,0,1485,86,1399
361119510003,36, New York,111, Ulster County,398,209,178,0,31,0,0,0,0,0,398,209,178,0,31,1040,56,984
361119510004,36, New York,111, Ulster County,221,86,40,28,18,45,45,17,28,0,176,41,23,0,18,726,110,616
361119511001,36, New York,111, Ulster County,179,42,29,0,13,17,13,13,0,0,162,29,16,0,13,524,87,437
361119511002,36, New York,111, Ulster County,169,80,35,10,35,0,0,0,0,0,169,80,35,10,35,630,25,605
361119511003,36, New York,111, Ulster County,237,103,80,10,13,30,30,30,0,0,207,73,50,10,13,605,78,527
361119512001,36, New York,111, Ulster County,229,107,55,0,52,63,27,27,0,0,166,80,28,0,52,661,156,505
361119512002,36, New York,111, Ulster County,247,124,92,0,32,0,0,0,0,0,247,124,92,0,32,702,17,685
361119512003,36, New York,111, Ulster County,318,42,42,0,0,0,0,0,0,0,318,42,42,0,0,828,27,801
361119512004,36, New York,111, Ulster County,328,115,96,7,12,12,12,0,0,12,316,103,96,7,0,969,53,916
361119513001,36, New York,111, Ulster County,446,139,91,0,48,0,0,0,0,0,446,139,91,0,48,1364,111,1253
361119513002,36, New York,111, Ulster County,344,105,71,11,23,11,11,0,11,0,333,94,71,0,23,1046,73,973
361119513003,36, New York,111, Ulster County,189,78,41,23,14,19,8,0,0,8,170,70,41,23,6,582,42,540
361119514001,36, New York,111, Ulster County,278,173,89,14,70,88,88,64,14,10,190,85,25,0,60,942,279,663
361119514002,36, New York,111, Ulster County,313,157,91,0,66,31,31,0,0,31,282,126,91,0,35,1205,167,1038
361119514003,36, New York,111, Ulster County,246,95,48,34,13,12,12,5,7,0,234,83,43,27,13,806,63,743
361119515001,36, New York,111, Ulster County,100,56,56,0,0,0,0,0,0,0,100,56,56,0,0,271,7,264
361119515002,36, New York,111, Ulster County,256,113,78,25,10,32,32,22,0,10,224,81,56,25,0,699,74,625
361119515003,36, New York,111, Ulster County,240,78,45,4,29,10,7,5,0,2,230,71,40,4,27,815,44,771
361119515004,36, New York,111, Ulster County,298,159,58,0,101,21,21,10,0,11,277,138,48,0,90,955,80,875
361119516001,36, New York,111, Ulster County,254,67,52,9,6,14,14,14,0,0,240,53,38,9,6,599,6,593
361119516002,36, New York,111, Ulster County,405,103,77,0,26,10,10,10,0,0,395,93,67,0,26,1124,113,1011
361119517001,36, New York,111, Ulster County,194,149,94,20,35,0,0,0,0,0,194,149,94,20,35,609,0,609
361119517002,36, New York,111, Ulster County,293,139,58,0,81,81,81,0,0,81,212,58,58,0,0,1546,335,1211
361119517003,36, New York,111, Ulster County,27,14,0,0,14,14,14,0,0,14,13,0,0,0,0,298,155,143
361119517004,36, New York,111, Ulster County,95,54,54,0,0,0,0,0,0,0,95,54,54,0,0,377,63,314
361119517005,36, New York,111, Ulster County,128,36,36,0,0,0,0,0,0,0,128,36,36,0,0,767,123,644
361119518001,36, New York,111, Ulster County,349,237,54,6,177,134,134,0,0,134,215,103,54,6,43,1135,287,848
361119519001,36, New York,111, Ulster County,250,120,88,0,32,0,0,0,0,0,250,120,88,0,32,807,103,704
361119519002,36, New York,111, Ulster County,227,139,74,0,65,39,39,0,0,39,188,100,74,0,26,495,39,456
361119519003,36, New York,111, Ulster County,178,81,36,0,45,49,49,27,0,22,129,32,9,0,23,288,35,253
361119519004,36, New York,111, Ulster County,175,140,106,25,9,0,0,0,0,0,175,140,106,25,9,396,0,396
361119520001,36, New York,111, Ulster County,318,143,55,0,88,29,29,0,0,29,289,114,55,0,59,916,159,757
361119520002,36, New York,111, Ulster County,390,289,73,0,216,48,48,30,0,18,342,241,43,0,198,841,100,741
361119521001,36, New York,111, Ulster County,236,108,16,85,7,36,0,0,0,0,200,108,16,85,7,667,71,596
361119521002,36, New York,111, Ulster County,104,55,5,10,40,39,39,0,0,39,65,16,5,10,1,424,43,381
361119521003,36, New York,111, Ulster County,161,107,53,41,13,23,23,0,10,13,138,84,53,31,0,448,32,416
361119521004,36, New York,111, Ulster County,263,158,51,34,73,30,0,0,0,0,233,158,51,34,73,735,231,504
361119522001,36, New York,111, Ulster County,193,49,21,17,11,10,0,0,0,0,183,49,21,17,11,598,46,552
361119522002,36, New York,111, Ulster County,167,52,26,0,26,0,0,0,0,0,167,52,26,0,26,477,10,467
361119522003,36, New York,111, Ulster County,246,141,105,0,36,44,36,0,0,36,202,105,105,0,0,739,50,689
361119522004,36, New York,111, Ulster County,377,165,76,0,89,7,7,7,0,0,370,158,69,0,89,1044,89,955
361119523001,36, New York,111, Ulster County,167,58,29,14,15,0,0,0,0,0,167,58,29,14,15,575,42,533
361119523002,36, New York,111, Ulster County,183,54,42,5,7,7,7,0,0,7,176,47,42,5,0,785,67,718
361119524001,36, New York,111, Ulster County,147,62,44,0,18,0,0,0,0,0,147,62,44,0,18,1191,312,879
361119524002,36, New York,111, Ulster County,328,145,28,0,117,86,86,0,0,86,242,59,28,0,31,985,256,729
361119525001,36, New York,111, Ulster County,172,67,36,0,31,38,38,28,0,10,134,29,8,0,21,540,32,508
361119525002,36, New York,111, Ulster County,397,73,21,26,26,0,0,0,0,0,397,73,21,26,26,1215,34,1181
361119525003,36, New York,111, Ulster County,355,195,51,13,131,84,84,0,0,84,271,111,51,13,47,834,104,730
361119526001,36, New York,111, Ulster County,227,76,60,16,0,0,0,0,0,0,227,76,60,16,0,1047,202,845
361119526002,36, New York,111, Ulster County,167,51,28,0,23,0,0,0,0,0,167,51,28,0,23,1447,661,786
361119526003,36, New York,111, Ulster County,518,61,61,0,0,0,0,0,0,0,518,61,61,0,0,1186,41,1145
361119526004,36, New York,111, Ulster County,66,24,7,17,0,0,0,0,0,0,66,24,7,17,0,603,203,400
361119526005,36, New York,111, Ulster County,208,66,42,0,24,6,6,0,0,6,202,60,42,0,18,904,177,727
361119527001,36, New York,111, Ulster County,182,63,16,39,8,0,0,0,0,0,182,63,16,39,8,604,42,562
361119527002,36, New York,111, Ulster County,197,72,32,7,33,0,0,0,0,0,197,72,32,7,33,722,86,636
361119527003,36, New York,111, Ulster County,393,88,56,0,32,27,0,0,0,0,366,88,56,0,32,999,115,884
361119528001,36, New York,111, Ulster County,204,78,46,0,32,9,9,0,0,9,195,69,46,0,23,640,25,615
361119528002,36, New York,111, Ulster County,250,128,78,0,50,9,9,9,0,0,241,119,69,0,50,1028,125,903
361119528003,36, New York,111, Ulster County,170,64,64,0,0,17,17,17,0,0,153,47,47,0,0,532,41,491
361119529011,36, New York,111, Ulster County,213,33,33,0,0,38,0,0,0,0,175,33,33,0,0,604,96,508
361119529012,36, New York,111, Ulster County,243,84,9,15,60,0,0,0,0,0,243,84,9,15,60,583,20,563
361119529013,36, New York,111, Ulster County,338,153,70,34,49,49,49,0,0,49,289,104,70,34,0,1001,126,875
361119529021,36, New York,111, Ulster County,519,137,137,0,0,18,0,0,0,0,501,137,137,0,0,1304,120,1184
361119529022,36, New York,111, Ulster County,347,86,77,0,9,46,46,46,0,0,301,40,31,0,9,926,115,811
361119530001,36, New York,111, Ulster County,485,106,46,36,24,30,24,0,0,24,455,82,46,36,0,1299,70,1229
361119530002,36, New York,111, Ulster County,174,55,47,8,0,17,0,0,0,0,157,55,47,8,0,474,86,388
361119533001,36, New York,111, Ulster County,322,171,111,0,60,21,21,21,0,0,301,150,90,0,60,1192,207,985
361119533002,36, New York,111, Ulster County,315,104,80,16,8,0,0,0,0,0,315,104,80,16,8,849,23,826
361119533003,36, New York,111, Ulster County,429,178,113,30,35,30,6,0,0,6,399,172,113,30,29,1639,207,1432
361119534001,36, New York,111, Ulster County,302,153,101,52,0,0,0,0,0,0,302,153,101,52,0,786,138,648
361119534002,36, New York,111, Ulster County,129,65,12,0,53,97,47,0,0,47,32,18,12,0,6,576,195,381
361119534003,36, New York,111, Ulster County,241,50,12,38,0,0,0,0,0,0,241,50,12,38,0,1209,124,1085
361119534004,36, New York,111, Ulster County,188,99,43,25,31,29,29,14,15,0,159,70,29,10,31,1607,889,718
361119535001,36, New York,111, Ulster County,149,55,53,2,0,41,2,0,2,0,108,53,53,0,0,538,143,395
361119535002,36, New York,111, Ulster County,107,107,51,1,55,6,6,6,0,0,101,101,45,1,55,756,286,470
361119535003,36, New York,111, Ulster County,129,56,26,0,30,9,9,0,0,9,120,47,26,0,21,419,37,382
361119536001,36, New York,111, Ulster County,432,147,100,47,0,0,0,0,0,0,432,147,100,47,0,1077,3,1074
361119536002,36, New York,111, Ulster County,386,177,177,0,0,0,0,0,0,0,386,177,177,0,0,1453,187,1266
361119536003,36, New York,111, Ulster County,352,251,128,103,20,0,0,0,0,0,352,251,128,103,20,1134,20,1114
361119536004,36, New York,111, Ulster County,166,59,25,0,34,0,0,0,0,0,166,59,25,0,34,592,43,549
361119537001,36, New York,111, Ulster County,454,89,74,0,15,0,0,0,0,0,454,89,74,0,15,1481,0,1481
361119537002,36, New York,111, Ulster County,317,127,97,0,30,30,30,0,0,30,287,97,97,0,0,1022,143,879
361119537003,36, New York,111, Ulster County,130,10,10,0,0,0,0,0,0,0,130,10,10,0,0,430,24,406
361119537004,36, New York,111, Ulster County,333,251,223,11,17,24,24,24,0,0,309,227,199,11,17,926,104,822
361119538001,36, New York,111, Ulster County,456,163,105,11,47,47,47,0,0,47,409,116,105,11,0,1420,99,1321
361119538002,36, New York,111, Ulster County,190,99,71,9,19,0,0,0,0,0,190,99,71,9,19,686,10,676
361119538003,36, New York,111, Ulster County,385,78,68,10,0,14,0,0,0,0,371,78,68,10,0,1096,61,1035
361119539001,36, New York,111, Ulster County,524,229,103,57,69,20,20,20,0,0,504,209,83,57,69,1343,57,1286
361119539002,36, New York,111, Ulster County,548,196,129,15,52,50,50,9,0,41,498,146,120,15,11,1578,142,1436
361119539003,36, New York,111, Ulster County,291,82,68,0,14,14,14,0,0,14,277,68,68,0,0,804,41,763
361119540001,36, New York,111, Ulster County,422,132,132,0,0,0,0,0,0,0,422,132,132,0,0,1279,18,1261
361119540002,36, New York,111, Ulster County,376,0,0,0,0,0,0,0,0,0,376,0,0,0,0,1401,18,1383
361119540003,36, New York,111, Ulster County,556,326,173,95,58,7,7,7,0,0,549,319,166,95,58,1368,58,1310
361119541001,36, New York,111, Ulster County,317,145,102,26,17,11,0,0,0,0,306,145,102,26,17,1071,96,975
361119541002,36, New York,111, Ulster County,391,179,139,0,40,0,0,0,0,0,391,179,139,0,40,1414,126,1288
361119541003,36, New York,111, Ulster County,376,171,97,24,50,38,25,25,0,0,338,146,72,24,50,1015,59,956
361119541004,36, New York,111, Ulster County,219,134,94,0,40,28,17,0,0,17,191,117,94,0,23,736,92,644
361119542001,36, New York,111, Ulster County,183,93,66,27,0,0,0,0,0,0,183,93,66,27,0,662,63,599
361119542002,36, New York,111, Ulster County,189,78,60,16,2,0,0,0,0,0,189,78,60,16,2,651,24,627
361119542003,36, New York,111, Ulster County,159,44,34,0,10,0,0,0,0,0,159,44,34,0,10,3163,2705,458
361119542004,36, New York,111, Ulster County,114,35,23,0,12,0,0,0,0,0,114,35,23,0,12,444,62,382
361119544011,36, New York,111, Ulster County,431,103,65,38,0,0,0,0,0,0,431,103,65,38,0,1849,618,1231
361119544012,36, New York,111, Ulster County,376,127,122,5,0,0,0,0,0,0,376,127,122,5,0,1409,15,1394
361119544021,36, New York,111, Ulster County,511,231,176,0,55,55,0,0,0,0,456,231,176,0,55,1382,109,1273
361119544022,36, New York,111, Ulster County,560,307,307,0,0,44,44,44,0,0,516,263,263,0,0,1738,121,1617
361119544023,36, New York,111, Ulster County,296,79,46,0,33,17,0,0,0,0,279,79,46,0,33,954,85,869
361119545001,36, New York,111, Ulster County,265,113,68,0,45,114,13,13,0,0,151,100,55,0,45,676,167,509
361119545002,36, New York,111, Ulster County,68,21,21,0,0,19,0,0,0,0,49,21,21,0,0,363,93,270
361119545003,36, New York,111, Ulster County,187,63,41,10,12,8,0,0,0,0,179,63,41,10,12,586,25,561
361119545004,36, New York,111, Ulster County,145,36,0,36,0,0,0,0,0,0,145,36,0,36,0,384,0,384
361119546001,36, New York,111, Ulster County,232,107,67,40,0,20,0,0,0,0,212,107,67,40,0,766,86,680
361119546002,36, New York,111, Ulster County,163,30,20,5,5,3,3,0,0,3,160,27,20,5,2,598,60,538
361119547001,36, New York,111, Ulster County,210,72,51,21,0,21,0,0,0,0,189,72,51,21,0,992,353,639
361119547002,36, New York,111, Ulster County,168,65,38,7,20,14,14,7,0,7,154,51,31,7,13,559,72,487
361119548001,36, New York,111, Ulster County,495,208,177,0,31,82,42,11,0,31,413,166,166,0,0,1542,517,1025
361119548002,36, New York,111, Ulster County,264,88,21,0,67,17,17,0,0,17,247,71,21,0,50,1095,49,1046
361119548003,36, New York,111, Ulster County,488,252,175,0,77,72,72,51,0,21,416,180,124,0,56,1621,441,1180
361119549001,36, New York,111, Ulster County,512,233,133,23,77,6,6,0,0,6,506,227,133,23,71,1406,89,1317
361119550011,36, New York,111, Ulster County,328,156,91,0,65,105,77,21,0,56,223,79,70,0,9,776,221,555
361119550012,36, New York,111, Ulster County,400,71,40,14,17,0,0,0,0,0,400,71,40,14,17,1047,116,931
361119550021,36, New York,111, Ulster County,349,246,153,93,0,0,0,0,0,0,349,246,153,93,0,1019,157,862
361119550022,36, New York,111, Ulster County,439,249,221,0,28,28,28,0,0,28,411,221,221,0,0,1223,44,1179
361119553001,36, New York,111, Ulster County,221,64,42,0,22,57,22,0,0,22,164,42,42,0,0,1069,281,788
361119553002,36, New York,111, Ulster County,174,43,43,0,0,65,0,0,0,0,109,43,43,0,0,599,196,403
361119553003,36, New York,111, Ulster County,81,7,7,0,0,0,0,0,0,0,81,7,7,0,0,372,12,360
361119554001,36, New York,111, Ulster County,463,164,82,34,48,0,0,0,0,0,463,164,82,34,48,1388,90,1298
361119554002,36, New York,111, Ulster County,233,121,80,41,0,0,0,0,0,0,233,121,80,41,0,723,45,678
361119554003,36, New York,111, Ulster County,309,203,203,0,0,0,0,0,0,0,309,203,203,0,0,683,11,672
360810001011,36, New York,081, Queens County,719,336,280,0,56,1,0,0,0,0,718,336,280,0,56,2105,36,2069
360810001012,36, New York,081, Queens County,582,376,376,0,0,0,0,0,0,0,582,376,376,0,0,906,0,906
360810001021,36, New York,081, Queens County,520,280,263,0,17,0,0,0,0,0,520,280,263,0,17,1387,58,1329
360810001022,36, New York,081, Queens County,997,493,493,0,0,0,0,0,0,0,997,493,493,0,0,1896,13,1883
360810001031,36, New York,081, Queens County,0,0,0,0,0,0,0,0,0,0,0,0,0,0,0,0,0,0
360810001041,36, New York,081, Queens County,24,24,24,0,0,0,0,0,0,0,24,24,24,0,0,281,193,88
360810002001,36, New York,081, Queens County,198,63,39,16,8,29,16,0,16,0,169,47,39,0,8,634,42,592
360810002002,36, New York,081, Queens County,406,127,80,13,34,25,21,7,0,14,381,106,73,13,20,1170,125,1045
360810004001,36, New York,081, Queens County,380,153,109,0,44,3,3,3,0,0,377,150,106,0,44,1001,2,999
360810004002,36, New York,081, Queens County,415,271,194,0,77,59,59,59,0,0,356,212,135,0,77,793,76,717
360810004003,36, New York,081, Queens County,237,129,30,80,19,0,0,0,0,0,237,129,30,80,19,520,14,506
360810006001,36, New York,081, Queens County,268,213,198,0,15,25,13,13,0,0,243,200,185,0,15,530,63,467
360810006002,36, New York,081, Queens County,210,137,35,26,76,51,51,0,26,25,159,86,35,0,51,391,52,339
360810006003,36, New York,081, Queens County,354,156,86,33,37,63,33,0,33,0,291,123,86,0,37,859,190,669
360810007011,36, New York,081, Queens County,315,166,153,0,13,0,0,0,0,0,315,166,153,0,13,825,21,804
360810007012,36, New York,081, Queens County,365,142,104,26,12,8,0,0,0,0,357,142,104,26,12,1103,49,1054
360810007021,36, New York,081, Queens County,246,100,69,0,31,0,0,0,0,0,246,100,69,0,31,832,103,729
360810007022,36, New York,081, Queens County,175,47,47,0,0,0,0,0,0,0,175,47,47,0,0,587,0,587
360810007023,36, New York,081, Queens County,340,173,173,0,0,0,0,0,0,0,340,173,173,0,0,1038,61,977
360810008001,36, New York,081, Queens County,482,170,90,19,61,15,6,0,0,6,467,164,90,19,55,1238,91,1147
360810008002,36, New York,081, Queens County,302,165,84,13,68,25,25,25,0,0,277,140,59,13,68,890,62,828
360810010001,36, New York,081, Queens County,404,186,106,49,31,27,27,10,0,17,377,159,96,49,14,900,77,823
360810010002,36, New York,081, Queens County,595,423,274,37,112,63,52,20,21,11,532,371,254,16,101,1775,184,1591
360810012001,36, New York,081, Queens County,308,72,24,11,37,12,0,0,0,0,296,72,24,11,37,647,54,593
360810012002,36, New York,081, Queens County,95,45,36,9,0,0,0,0,0,0,95,45,36,9,0,401,0,401
360810012003,36, New York,081, Queens County,380,214,90,60,64,0,0,0,0,0,380,214,90,60,64,1279,55,1224
360810014001,36, New York,081, Queens County,437,233,84,94,55,22,22,0,22,0,415,211,84,72,55,1207,48,1159
360810014002,36, New York,081, Queens County,234,38,38,0,0,45,33,33,0,0,189,5,5,0,0,829,81,748
360810014003,36, New York,081, Queens County,147,77,28,0,49,0,0,0,0,0,147,77,28,0,49,642,0,642
360810016001,36, New York,081, Queens County,348,101,55,0,46,31,0,0,0,0,317,101,55,0,46,801,87,714
360810016002,36, New York,081, Queens County,264,81,30,0,51,26,14,0,0,14,238,67,30,0,37,824,69,755
360810018001,36, New York,081, Queens County,551,184,100,5,79,34,34,34,0,0,517,150,66,5,79,1440,139,1301
360810018002,36, New York,081, Queens County,187,72,67,5,0,14,6,6,0,0,173,66,61,5,0,494,61,433
360810019011,36, New York,081, Queens County,349,180,80,0,100,0,0,0,0,0,349,180,80,0,100,779,0,779
360810019021,36, New York,081, Queens County,1155,282,246,0,36,58,16,16,0,0,1097,266,230,0,36,3109,212,2897
360810019031,36, New York,081, Queens County,242,99,51,24,24,0,0,0,0,0,242,99,51,24,24,842,18,824
360810020001,36, New York,081, Queens County,351,147,85,31,31,31,31,2,0,29,320,116,83,31,2,1080,88,992
360810022001,36, New York,081, Queens County,252,160,112,30,18,33,13,0,0,13,219,147,112,30,5,620,76,544
360810022002,36, New York,081, Queens County,302,149,95,10,44,60,41,26,10,5,242,108,69,0,39,799,121,678
360810024001,36, New York,081, Queens County,239,163,163,0,0,39,24,24,0,0,200,139,139,0,0,665,103,562
360810024002,36, New York,081, Queens County,276,126,57,0,69,53,31,17,0,14,223,95,40,0,55,831,165,666
360810025001,36, New York,081, Queens County,227,132,0,0,132,90,72,0,0,72,137,60,0,0,60,623,192,431
360810025002,36, New York,081, Queens County,102,82,49,0,33,0,0,0,0,0,102,82,49,0,33,454,158,296
360810025003,36, New York,081, Queens County,214,104,0,12,92,98,64,0,0,64,116,40,0,12,28,620,319,301
360810025004,36, New York,081, Queens County,169,35,0,0,35,16,16,0,0,16,153,19,0,0,19,371,164,207
360810025005,36, New York,081, Queens County,164,84,19,23,42,117,48,19,0,29,47,36,0,23,13,638,230,408
360810025006,36, New York,081, Queens County,206,148,0,0,148,17,17,0,0,17,189,131,0,0,131,627,104,523
360810026001,36, New York,081, Queens County,320,62,62,0,0,21,13,13,0,0,299,49,49,0,0,694,80,614
360810026002,36, New York,081, Queens County,215,136,119,0,17,23,23,13,0,10,192,113,106,0,7,732,98,634
360810028001,36, New York,081, Queens County,403,162,127,35,0,10,10,10,0,0,393,152,117,35,0,1101,50,1051
360810028002,36, New York,081, Queens County,394,128,107,0,21,10,10,0,0,10,384,118,107,0,11,1334,63,1271
360810030001,36, New York,081, Queens County,336,143,84,16,43,13,5,0,0,5,323,138,84,16,38,1113,89,1024
360810031001,36, New York,081, Queens County,103,14,14,0,0,9,0,0,0,0,94,14,14,0,0,479,75,404
360810031002,36, New York,081, Queens County,159,25,25,0,0,9,9,9,0,0,150,16,16,0,0,544,102,442
360810032001,36, New York,081, Queens County,480,207,123,9,75,70,59,29,0,30,410,148,94,9,45,1120,181,939
360810033011,36, New York,081, Queens County,535,89,78,0,11,0,0,0,0,0,535,89,78,0,11,1973,82,1891
360810033021,36, New York,081, Queens County,91,34,34,0,0,18,18,18,0,0,73,16,16,0,0,290,57,233
360810033022,36, New York,081, Queens County,82,23,23,0,0,23,14,14,0,0,59,9,9,0,0,371,100,271
360810034001,36, New York,081, Queens County,196,45,17,0,28,36,17,0,0,17,160,28,17,0,11,603,129,474
360810034002,36, New York,081, Queens County,337,169,104,29,36,19,19,7,0,12,318,150,97,29,24,1119,85,1034
360810036001,36, New York,081, Queens County,512,331,243,0,88,20,20,0,0,20,492,311,243,0,68,1232,55,1177
360810036002,36, New York,081, Queens County,387,188,136,20,32,64,44,12,0,32,323,144,124,20,0,814,84,730
360810037001,36, New York,081, Queens County,0,0,0,0,0,0,0,0,0,0,0,0,0,0,0,0,0,0
360810038001,36, New York,081, Queens County,221,95,79,0,16,0,0,0,0,0,221,95,79,0,16,631,16,615
360810038002,36, New York,081, Queens County,352,195,100,52,43,48,3,1,0,2,304,192,99,52,41,820,181,639
360810039001,36, New York,081, Queens County,283,109,99,0,10,25,13,13,0,0,258,96,86,0,10,1007,233,774
360810040011,36, New York,081, Queens County,301,146,72,8,66,16,7,0,0,7,285,139,72,8,59,848,57,791
360810040012,36, New York,081, Queens County,244,109,83,3,23,44,44,38,0,6,200,65,45,3,17,557,113,444
360810040021,36, New York,081, Queens County,440,124,113,0,11,84,36,31,0,5,356,88,82,0,6,1153,169,984
360810042001,36, New York,081, Queens County,376,118,94,24,0,33,29,24,5,0,343,89,70,19,0,953,92,861
360810042002,36, New York,081, Queens County,174,62,62,0,0,19,17,17,0,0,155,45,45,0,0,490,56,434
360810042003,36, New York,081, Queens County,315,146,97,0,49,45,18,5,0,13,270,128,92,0,36,1139,64,1075
360810043001,36, New York,081, Queens County,444,252,23,29,200,113,90,23,0,67,331,162,0,29,133,1214,300,914
360810043002,36, New York,081, Queens County,37,37,0,7,30,30,30,0,0,30,7,7,0,7,0,83,83,0
360810044011,36, New York,081, Queens County,405,274,199,0,75,21,21,3,0,18,384,253,196,0,57,926,107,819
360810044012,36, New York,081, Queens County,477,328,294,12,22,180,173,173,0,0,297,155,121,12,22,1207,243,964
360810045001,36, New York,081, Queens County,127,42,42,0,0,7,0,0,0,0,120,42,42,0,0,550,102,448
360810045002,36, New York,081, Queens County,175,50,50,0,0,0,0,0,0,0,175,50,50,0,0,626,62,564
360810045003,36, New York,081, Queens County,325,63,54,0,9,0,0,0,0,0,325,63,54,0,9,1104,68,1036
360810047001,36, New York,081, Queens County,344,86,86,0,0,32,0,0,0,0,312,86,86,0,0,1136,51,1085
360810047002,36, New York,081, Queens County,640,309,76,57,176,155,135,27,0,108,485,174,49,57,68,1582,324,1258
360810050001,36, New York,081, Queens County,0,0,0,0,0,0,0,0,0,0,0,0,0,0,0,0,0,0
360810051001,36, New York,081, Queens County,397,168,123,0,45,20,0,0,0,0,377,168,123,0,45,1109,59,1050
360810051002,36, New York,081, Queens County,107,46,46,0,0,13,13,13,0,0,94,33,33,0,0,307,30,277
360810052001,36, New York,081, Queens County,274,87,87,0,0,22,0,0,0,0,252,87,87,0,0,979,90,889
360810052002,36, New York,081, Queens County,395,153,125,16,12,39,31,25,0,6,356,122,100,16,6,934,82,852
360810053001,36, New York,081, Queens County,166,76,76,0,0,12,12,12,0,0,154,64,64,0,0,561,32,529
360810053002,36, New York,081, Queens County,373,94,79,15,0,46,0,0,0,0,327,94,79,15,0,1149,151,998
360810053003,36, New York,081, Queens County,251,98,80,0,18,13,0,0,0,0,238,98,80,0,18,1133,38,1095
360810053004,36, New York,081, Queens County,291,88,70,0,18,15,0,0,0,0,276,88,70,0,18,886,169,717
360810054001,36, New York,081, Queens County,188,145,62,0,83,11,11,0,0,11,177,134,62,0,72,304,11,293
360810054002,36, New York,081, Queens County,429,113,71,0,42,62,27,27,0,0,367,86,44,0,42,1314,183,1131
360810054003,36, New York,081, Queens County,472,193,67,0,126,0,0,0,0,0,472,193,67,0,126,1342,51,1291
360810054004,36, New York,081, Queens County,338,135,94,41,0,13,13,13,0,0,325,122,81,41,0,1323,74,1249
360810055001,36, New York,081, Queens County,278,146,90,56,0,17,0,0,0,0,261,146,90,56,0,685,45,640
360810057001,36, New York,081, Queens County,358,95,68,0,27,19,19,0,0,19,339,76,68,0,8,1431,48,1383
360810057002,36, New York,081, Queens County,121,50,39,11,0,8,0,0,0,0,113,50,39,11,0,543,67,476
360810057003,36, New York,081, Queens County,288,126,92,17,17,73,40,40,0,0,215,86,52,17,17,836,87,749
360810058001,36, New York,081, Queens County,422,160,72,37,51,0,0,0,0,0,422,160,72,37,51,1112,43,1069
360810058002,36, New York,081, Queens County,291,184,124,39,21,16,16,0,0,16,275,168,124,39,5,976,50,926
360810058003,36, New York,081, Queens County,586,297,139,0,158,8,0,0,0,0,578,297,139,0,158,1674,71,1603
360810058004,36, New York,081, Queens County,164,55,38,0,17,0,0,0,0,0,164,55,38,0,17,429,21,408
360810059001,36, New York,081, Queens County,248,19,15,0,4,23,4,0,0,4,225,15,15,0,0,961,84,877
360810059002,36, New York,081, Queens County,220,122,97,25,0,16,0,0,0,0,204,122,97,25,0,934,161,773
360810059003,36, New York,081, Queens County,254,174,167,0,7,7,7,0,0,7,247,167,167,0,0,769,51,718
360810061001,36, New York,081, Queens County,192,111,86,25,0,0,0,0,0,0,192,111,86,25,0,683,0,683
360810061002,36, New York,081, Queens County,411,111,70,0,41,17,0,0,0,0,394,111,70,0,41,1346,29,1317
360810061003,36, New York,081, Queens County,353,135,135,0,0,0,0,0,0,0,353,135,135,0,0,1265,78,1187
360810061004,36, New York,081, Queens County,131,47,47,0,0,16,0,0,0,0,115,47,47,0,0,643,65,578
360810062011,36, New York,081, Queens County,799,296,257,0,39,29,0,0,0,0,770,296,257,0,39,2390,80,2310
360810062012,36, New York,081, Queens County,124,10,10,0,0,18,0,0,0,0,106,10,10,0,0,716,61,655
360810062013,36, New York,081, Queens County,497,226,147,0,79,0,0,0,0,0,497,226,147,0,79,1766,110,1656
360810062021,36, New York,081, Queens County,16,0,0,0,0,16,0,0,0,0,0,0,0,0,0,66,32,34
360810062022,36, New York,081, Queens County,163,54,31,0,23,0,0,0,0,0,163,54,31,0,23,547,99,448
360810062023,36, New York,081, Queens County,325,215,145,0,70,0,0,0,0,0,325,215,145,0,70,741,15,726
360810062024,36, New York,081, Queens County,162,74,55,19,0,0,0,0,0,0,162,74,55,19,0,528,19,509
360810062025,36, New York,081, Queens County,170,137,118,19,0,0,0,0,0,0,170,137,118,19,0,348,30,318
360810062026,36, New York,081, Queens County,279,151,135,0,16,0,0,0,0,0,279,151,135,0,16,868,216,652
360810062027,36, New York,081, Queens County,443,306,178,0,128,60,41,0,0,41,383,265,178,0,87,1410,131,1279
360810063001,36, New York,081, Queens County,68,25,13,0,12,0,0,0,0,0,68,25,13,0,12,445,13,432
360810063002,36, New York,081, Queens County,378,133,133,0,0,0,0,0,0,0,378,133,133,0,0,1419,27,1392
360810063003,36, New York,081, Queens County,377,42,0,0,42,42,42,0,0,42,335,0,0,0,0,999,35,964
360810063004,36, New York,081, Queens County,306,124,124,0,0,41,41,41,0,0,265,83,83,0,0,895,105,790
360810065011,36, New York,081, Queens County,230,83,71,0,12,25,25,13,0,12,205,58,58,0,0,905,97,808
360810065012,36, New York,081, Queens County,351,63,56,7,0,0,0,0,0,0,351,63,56,7,0,901,29,872
360810065013,36, New York,081, Queens County,102,21,21,0,0,0,0,0,0,0,102,21,21,0,0,513,34,479
360810065021,36, New York,081, Queens County,275,136,125,0,11,98,85,74,0,11,177,51,51,0,0,876,175,701
360810065022,36, New York,081, Queens County,89,0,0,0,0,0,0,0,0,0,89,0,0,0,0,713,112,601
360810065023,36, New York,081, Queens County,276,66,33,8,25,1,0,0,0,0,275,66,33,8,25,959,72,887
360810069001,36, New York,081, Queens County,374,44,15,0,29,18,18,0,0,18,356,26,15,0,11,1493,108,1385
360810069002,36, New York,081, Queens County,357,201,201,0,0,48,32,32,0,0,309,169,169,0,0,1311,153,1158
360810069003,36, New York,081, Queens County,143,54,31,0,23,0,0,0,0,0,143,54,31,0,23,498,51,447
360810071001,36, New York,081, Queens County,105,0,0,0,0,0,0,0,0,0,105,0,0,0,0,364,46,318
360810071002,36, New York,081, Queens County,97,42,42,0,0,0,0,0,0,0,97,42,42,0,0,306,18,288
360810071003,36, New York,081, Queens County,224,129,69,0,60,43,31,18,0,13,181,98,51,0,47,802,85,717
360810071004,36, New York,081, Queens County,154,27,27,0,0,29,0,0,0,0,125,27,27,0,0,830,74,756
360810073001,36, New York,081, Queens County,119,0,0,0,0,25,0,0,0,0,94,0,0,0,0,633,151,482
360810073002,36, New York,081, Queens County,240,22,22,0,0,0,0,0,0,0,240,22,22,0,0,989,63,926
360810073003,36, New York,081, Queens County,343,87,77,0,10,0,0,0,0,0,343,87,77,0,10,1095,104,991
360810075001,36, New York,081, Queens County,318,43,23,20,0,20,20,0,20,0,298,23,23,0,0,1024,236,788
360810075002,36, New York,081, Queens County,432,81,81,0,0,0,0,0,0,0,432,81,81,0,0,1485,56,1429
360810075003,36, New York,081, Queens County,238,124,124,0,0,0,0,0,0,0,238,124,124,0,0,839,22,817
360810077001,36, New York,081, Queens County,327,117,96,0,21,54,32,32,0,0,273,85,64,0,21,1269,110,1159
360810079001,36, New York,081, Queens County,430,232,171,0,61,54,37,18,0,19,376,195,153,0,42,1025,142,883
360810079002,36, New York,081, Queens County,199,54,38,9,7,20,20,13,0,7,179,34,25,9,0,524,73,451
360810081001,36, New York,081, Queens County,208,64,26,0,38,0,0,0,0,0,208,64,26,0,38,753,22,731
360810083001,36, New York,081, Queens County,105,44,14,0,30,0,0,0,0,0,105,44,14,0,30,436,0,436
360810083002,36, New York,081, Queens County,350,190,139,21,30,50,32,24,8,0,300,158,115,13,30,1086,143,943
360810085001,36, New York,081, Queens County,253,119,113,0,6,20,20,14,0,6,233,99,99,0,0,608,52,556
360810085002,36, New York,081, Queens County,19,19,19,0,0,0,0,0,0,0,19,19,19,0,0,84,84,0
360810086001,36, New York,081, Queens County,342,186,118,32,36,27,7,7,0,0,315,179,111,32,36,787,82,705
360810086002,36, New York,081, Queens County,316,130,112,18,0,14,12,0,12,0,302,118,112,6,0,1061,161,900
360810087001,36, New York,081, Queens County,229,76,9,0,67,38,14,9,0,5,191,62,0,0,62,602,132,470
360810087002,36, New York,081, Queens County,179,96,53,0,43,57,16,0,0,16,122,80,53,0,27,678,211,467
360810087003,36, New York,081, Queens County,276,163,23,17,123,173,127,18,0,109,103,36,5,17,14,836,492,344
360810088001,36, New York,081, Queens County,523,233,163,6,64,54,28,0,0,28,469,205,163,6,36,1194,121,1073
360810088002,36, New York,081, Queens County,411,225,136,33,56,24,24,0,0,24,387,201,136,33,32,1218,124,1094
360810091001,36, New York,081, Queens County,225,111,90,0,21,51,21,0,0,21,174,90,90,0,0,594,141,453
360810091002,36, New York,081, Queens County,229,127,112,0,15,0,0,0,0,0,229,127,112,0,15,761,15,746
360810094001,36, New York,081, Queens County,337,140,113,8,19,37,16,15,1,0,300,124,98,7,19,794,49,745
360810094002,36, New York,081, Queens County,288,169,124,40,5,48,21,21,0,0,240,148,103,40,5,819,184,635
360810095001,36, New York,081, Queens County,170,33,28,5,0,15,15,15,0,0,155,18,13,5,0,685,46,639
360810095002,36, New York,081, Queens County,295,125,119,0,6,5,5,5,0,0,290,120,114,0,6,907,17,890
360810096001,36, New York,081, Queens County,535,339,264,24,51,52,52,0,24,28,483,287,264,0,23,1368,129,1239
360810096002,36, New York,081, Queens County,386,219,171,27,21,26,9,9,0,0,360,210,162,27,21,968,130,838
360810097001,36, New York,081, Queens County,191,80,80,0,0,16,16,16,0,0,175,64,64,0,0,428,32,396
360810097002,36, New York,081, Queens County,363,176,155,0,21,11,0,0,0,0,352,176,155,0,21,996,62,934
360810097003,36, New York,081, Queens County,217,51,40,0,11,39,0,0,0,0,178,51,40,0,11,608,53,555
360810097004,36, New York,081, Queens County,209,91,91,0,0,0,0,0,0,0,209,91,91,0,0,1042,96,946
360810098001,36, New York,081, Queens County,302,82,51,0,31,79,21,16,0,5,223,61,35,0,26,654,127,527
360810098002,36, New York,081, Queens County,250,142,89,16,37,13,0,0,0,0,237,142,89,16,37,729,70,659
360810099001,36, New York,081, Queens County,0,0,0,0,0,0,0,0,0,0,0,0,0,0,0,0,0,0
360810100001,36, New York,081, Queens County,283,134,26,77,31,0,0,0,0,0,283,134,26,77,31,821,0,821
360810100002,36, New York,081, Queens County,396,98,67,8,23,1,0,0,0,0,395,98,67,8,23,1519,331,1188
360810101001,36, New York,081, Queens County,292,82,46,0,36,0,0,0,0,0,292,82,46,0,36,944,49,895
360810101002,36, New York,081, Queens County,275,108,78,0,30,0,0,0,0,0,275,108,78,0,30,1148,39,1109
360810102001,36, New York,081, Queens County,331,184,106,0,78,27,6,6,0,0,304,178,100,0,78,994,61,933
360810102002,36, New York,081, Queens County,409,142,67,40,35,61,46,29,0,17,348,96,38,40,18,940,180,760
360810103001,36, New York,081, Queens County,299,160,116,0,44,61,61,32,0,29,238,99,84,0,15,833,182,651
360810103002,36, New York,081, Queens County,212,92,92,0,0,10,10,10,0,0,202,82,82,0,0,758,19,739
360810103003,36, New York,081, Queens County,217,105,53,5,47,9,9,0,0,9,208,96,53,5,38,836,60,776
360810103004,36, New York,081, Queens County,195,9,9,0,0,0,0,0,0,0,195,9,9,0,0,615,16,599
360810104001,36, New York,081, Queens County,393,103,87,6,10,30,20,14,0,6,363,83,73,6,4,1077,102,975
360810104002,36, New York,081, Queens County,435,148,123,25,0,25,0,0,0,0,410,148,123,25,0,1300,32,1268
360810105001,36, New York,081, Queens County,328,119,75,17,27,88,75,48,0,27,240,44,27,17,0,875,196,679
360810105002,36, New York,081, Queens County,315,239,114,79,46,53,53,44,0,9,262,186,70,79,37,751,58,693
360810105003,36, New York,081, Queens County,373,246,189,11,46,10,0,0,0,0,363,246,189,11,46,1066,234,832
360810105004,36, New York,081, Queens County,258,109,77,0,32,19,9,9,0,0,239,100,68,0,32,630,88,542
360810106001,36, New York,081, Queens County,451,112,94,0,18,45,38,20,0,18,406,74,74,0,0,1039,108,931
360810106002,36, New York,081, Queens County,376,170,112,33,25,46,22,14,0,8,330,148,98,33,17,1112,81,1031
360810107010,36, New York,081, Queens County,0,0,0,0,0,0,0,0,0,0,0,0,0,0,0,0,0,0
360810107011,36, New York,081, Queens County,0,0,0,0,0,0,0,0,0,0,0,0,0,0,0,0,0,0
360810108001,36, New York,081, Queens County,387,109,24,29,56,63,18,0,18,0,324,91,24,11,56,1046,134,912
360810108002,36, New York,081, Queens County,324,134,127,7,0,0,0,0,0,0,324,134,127,7,0,869,0,869
360810110001,36, New York,081, Queens County,265,104,74,0,30,38,20,0,0,20,227,84,74,0,10,554,142,412
360810110002,36, New York,081, Queens County,397,220,187,9,24,44,17,17,0,0,353,203,170,9,24,1207,181,1026
360810111001,36, New York,081, Queens County,342,153,111,31,11,54,31,20,0,11,288,122,91,31,0,1018,122,896
360810111002,36, New York,081, Queens County,400,123,73,42,8,10,0,0,0,0,390,123,73,42,8,1008,46,962
360810112001,36, New York,081, Queens County,386,91,85,0,6,40,7,7,0,0,346,84,78,0,6,803,117,686
360810112002,36, New York,081, Queens County,287,125,63,37,25,34,22,18,0,4,253,103,45,37,21,705,59,646
360810113001,36, New York,081, Queens County,366,156,138,0,18,0,0,0,0,0,366,156,138,0,18,1390,74,1316
360810113002,36, New York,081, Queens County,267,65,51,0,14,9,0,0,0,0,258,65,51,0,14,1184,225,959
360810113003,36, New York,081, Queens County,175,79,66,13,0,8,0,0,0,0,167,79,66,13,0,665,67,598
360810114001,36, New York,081, Queens County,388,186,132,38,16,52,21,21,0,0,336,165,111,38,16,1235,181,1054
360810115001,36, New York,081, Queens County,367,166,166,0,0,31,31,31,0,0,336,135,135,0,0,1172,137,1035
360810115002,36, New York,081, Queens County,152,52,52,0,0,0,0,0,0,0,152,52,52,0,0,577,0,577
360810116001,36, New York,081, Queens County,210,91,48,20,23,10,10,10,0,0,200,81,38,20,23,517,0,517
360810116002,36, New York,081, Queens County,289,113,113,0,0,43,37,37,0,0,246,76,76,0,0,904,146,758
360810117001,36, New York,081, Queens County,172,27,27,0,0,10,0,0,0,0,162,27,27,0,0,698,19,679
360810117002,36, New York,081, Queens County,155,11,11,0,0,18,0,0,0,0,137,11,11,0,0,738,61,677
360810117003,36, New York,081, Queens County,173,26,26,0,0,42,11,11,0,0,131,15,15,0,0,648,104,544
360810117004,36, New York,081, Queens County,265,160,119,0,41,42,42,42,0,0,223,118,77,0,41,984,49,935
360810118001,36, New York,081, Queens County,581,218,128,36,54,21,21,0,21,0,560,197,128,15,54,950,95,855
360810118002,36, New York,081, Queens County,158,95,79,8,8,18,18,18,0,0,140,77,61,8,8,628,54,574
360810119001,36, New York,081, Queens County,110,45,5,12,28,15,0,0,0,0,95,45,5,12,28,306,56,250
360810119002,36, New York,081, Queens County,229,56,53,0,3,18,3,0,0,3,211,53,53,0,0,676,20,656
360810120001,36, New York,081, Queens County,274,205,173,11,21,33,33,33,0,0,241,172,140,11,21,817,52,765
360810120002,36, New York,081, Queens County,234,94,73,10,11,0,0,0,0,0,234,94,73,10,11,679,113,566
360810121001,36, New York,081, Queens County,348,104,52,11,41,17,0,0,0,0,331,104,52,11,41,1050,103,947
360810121002,36, New York,081, Queens County,113,43,40,3,0,0,0,0,0,0,113,43,40,3,0,583,75,508
360810122001,36, New York,081, Queens County,201,65,54,7,4,42,4,0,0,4,159,61,54,7,0,549,89,460
360810122002,36, New York,081, Queens County,406,205,160,24,21,22,8,8,0,0,384,197,152,24,21,1397,155,1242
360810123011,36, New York,081, Queens County,312,174,144,0,30,26,12,12,0,0,286,162,132,0,30,1022,47,975
360810123012,36, New York,081, Queens County,186,141,141,0,0,0,0,0,0,0,186,141,141,0,0,667,2,665
360810123013,36, New York,081, Queens County,150,81,81,0,0,0,0,0,0,0,150,81,81,0,0,514,9,505
360810124001,36, New York,081, Queens County,242,95,58,26,11,26,26,10,16,0,216,69,48,10,11,870,97,773
360810124002,36, New York,081, Queens County,529,289,229,0,60,1,1,0,0,1,528,288,229,0,59,1338,49,1289
360810125001,36, New York,081, Queens County,187,79,62,3,14,0,0,0,0,0,187,79,62,3,14,466,0,466
360810125002,36, New York,081, Queens County,165,38,38,0,0,2,2,2,0,0,163,36,36,0,0,562,14,548
360810126011,36, New York,081, Queens County,359,202,167,0,35,35,35,0,0,35,324,167,167,0,0,776,44,732
360810126012,36, New York,081, Queens County,261,158,137,21,0,0,0,0,0,0,261,158,137,21,0,616,41,575
360810126021,36, New York,081, Queens County,309,119,64,0,55,0,0,0,0,0,309,119,64,0,55,830,4,826
360810126022,36, New York,081, Queens County,290,91,26,37,28,56,0,0,0,0,234,91,26,37,28,837,189,648
360810128001,36, New York,081, Queens County,268,105,86,10,9,51,0,0,0,0,217,105,86,10,9,801,131,670
360810128002,36, New York,081, Queens County,334,112,36,0,76,0,0,0,0,0,334,112,36,0,76,960,19,941
360810130001,36, New York,081, Queens County,169,39,39,0,0,7,7,7,0,0,162,32,32,0,0,608,62,546
360810130002,36, New York,081, Queens County,255,113,80,0,33,0,0,0,0,0,255,113,80,0,33,620,10,610
360810132001,36, New York,081, Queens County,253,112,95,17,0,48,17,0,17,0,205,95,95,0,0,691,95,596
360810132002,36, New York,081, Queens County,167,80,44,0,36,14,14,0,0,14,153,66,44,0,22,653,65,588
360810134001,36, New York,081, Queens County,457,131,12,79,40,35,0,0,0,0,422,131,12,79,40,1702,340,1362
360810134002,36, New York,081, Queens County,397,109,109,0,0,34,0,0,0,0,363,109,109,0,0,1184,121,1063
360810134003,36, New York,081, Queens County,166,89,40,0,49,0,0,0,0,0,166,89,40,0,49,778,134,644
360810134004,36, New York,081, Queens County,79,0,0,0,0,0,0,0,0,0,79,0,0,0,0,355,0,355
360810135001,36, New York,081, Queens County,269,106,95,0,11,11,0,0,0,0,258,106,95,0,11,810,77,733
360810136001,36, New York,081, Queens County,210,82,66,12,4,7,0,0,0,0,203,82,66,12,4,729,27,702
360810136002,36, New York,081, Queens County,244,151,68,0,83,20,7,7,0,0,224,144,61,0,83,585,37,548
360810137001,36, New York,081, Queens County,532,155,135,0,20,7,7,7,0,0,525,148,128,0,20,1499,37,1462
360810138001,36, New York,081, Queens County,536,281,201,0,80,61,17,0,0,17,475,264,201,0,63,1497,153,1344
360810138002,36, New York,081, Queens County,432,242,208,34,0,24,15,7,8,0,408,227,201,26,0,1193,112,1081
360810140001,36, New York,081, Queens County,373,190,136,0,54,0,0,0,0,0,373,190,136,0,54,1074,8,1066
360810140002,36, New York,081, Queens County,424,195,134,61,0,75,11,11,0,0,349,184,123,61,0,1361,133,1228
360810141001,36, New York,081, Queens County,137,60,42,0,18,10,5,0,0,5,127,55,42,0,13,506,29,477
360810141002,36, New York,081, Queens County,287,53,22,22,9,15,9,0,0,9,272,44,22,22,0,760,25,735
360810142011,36, New York,081, Queens County,542,153,72,25,56,44,44,10,0,34,498,109,62,25,22,1080,166,914
360810142012,36, New York,081, Queens County,650,385,313,71,1,67,51,51,0,0,583,334,262,71,1,995,126,869
360810142021,36, New York,081, Queens County,360,164,101,13,50,58,23,0,0,23,302,141,101,13,27,1000,189,811
360810142022,36, New York,081, Queens County,188,97,63,11,23,0,0,0,0,0,188,97,63,11,23,582,165,417
360810143001,36, New York,081, Queens County,279,101,62,0,39,11,11,11,0,0,268,90,51,0,39,864,52,812
360810143002,36, New York,081, Queens County,564,263,201,33,29,69,30,1,0,29,495,233,200,33,0,1688,246,1442
360810144001,36, New York,081, Queens County,396,181,110,0,71,26,20,0,0,20,370,161,110,0,51,993,58,935
360810145001,36, New York,081, Queens County,262,92,86,0,6,37,0,0,0,0,225,92,86,0,6,691,138,553
360810145002,36, New York,081, Queens County,257,57,41,13,3,10,0,0,0,0,247,57,41,13,3,740,21,719
360810147001,36, New York,081, Queens County,292,97,97,0,0,9,9,9,0,0,283,88,88,0,0,837,137,700
360810147002,36, New York,081, Queens County,238,107,86,0,21,0,0,0,0,0,238,107,86,0,21,515,7,508
360810147003,36, New York,081, Queens County,197,80,80,0,0,0,0,0,0,0,197,80,80,0,0,719,12,707
360810148001,36, New York,081, Queens County,355,124,107,5,12,30,12,12,0,0,325,112,95,5,12,1055,96,959
360810149001,36, New York,081, Queens County,346,83,54,0,29,16,0,0,0,0,330,83,54,0,29,1029,114,915
360810149002,36, New York,081, Queens County,183,106,106,0,0,15,15,15,0,0,168,91,91,0,0,564,45,519
360810150001,36, New York,081, Queens County,261,94,50,36,8,29,8,0,0,8,232,86,50,36,0,492,102,390
360810150002,36, New York,081, Queens County,252,77,33,7,37,0,0,0,0,0,252,77,33,7,37,717,42,675
360810151001,36, New York,081, Queens County,236,23,23,0,0,0,0,0,0,0,236,23,23,0,0,899,64,835
360810151002,36, New York,081, Queens County,389,122,112,10,0,14,5,5,0,0,375,117,107,10,0,1138,110,1028
360810152001,36, New York,081, Queens County,333,238,200,14,24,17,14,0,0,14,316,224,200,14,10,768,51,717
360810152002,36, New York,081, Queens County,270,146,98,0,48,35,35,0,0,35,235,111,98,0,13,581,66,515
360810153001,36, New York,081, Queens County,147,66,66,0,0,15,0,0,0,0,132,66,66,0,0,641,83,558
360810153002,36, New York,081, Queens County,180,16,10,0,6,6,6,0,0,6,174,10,10,0,0,734,126,608
360810154001,36, New York,081, Queens County,197,93,72,6,15,6,6,6,0,0,191,87,66,6,15,589,33,556
360810154002,36, New York,081, Queens County,179,90,90,0,0,18,18,18,0,0,161,72,72,0,0,506,23,483
360810155001,36, New York,081, Queens County,179,62,53,0,9,13,13,13,0,0,166,49,40,0,9,856,35,821
360810155002,36, New York,081, Queens County,125,35,26,0,9,0,0,0,0,0,125,35,26,0,9,707,8,699
360810156001,36, New York,081, Queens County,322,52,35,0,17,25,25,25,0,0,297,27,10,0,17,825,47,778
360810156002,36, New York,081, Queens County,335,127,111,0,16,27,4,0,0,4,308,123,111,0,12,1151,72,1079
360810157001,36, New York,081, Queens County,287,97,58,17,22,34,8,0,0,8,253,89,58,17,14,862,114,748
360810158011,36, New York,081, Queens County,260,114,90,0,24,25,24,0,0,24,235,90,90,0,0,819,43,776
360810158012,36, New York,081, Queens County,234,102,67,12,23,22,22,22,0,0,212,80,45,12,23,1109,100,1009
360810158013,36, New York,081, Queens County,270,152,109,11,32,0,0,0,0,0,270,152,109,11,32,588,7,581
360810158021,36, New York,081, Queens County,236,134,65,15,54,18,18,0,0,18,218,116,65,15,36,819,12,807
360810158022,36, New York,081, Queens County,417,216,196,0,20,0,0,0,0,0,417,216,196,0,20,1540,57,1483
360810158023,36, New York,081, Queens County,273,92,53,0,39,1,1,0,0,1,272,91,53,0,38,631,20,611
360810159001,36, New York,081, Queens County,113,63,36,0,27,0,0,0,0,0,113,63,36,0,27,477,0,477
360810159002,36, New York,081, Queens County,262,171,67,104,0,43,43,43,0,0,219,128,24,104,0,765,166,599
360810159003,36, New York,081, Queens County,86,0,0,0,0,17,0,0,0,0,69,0,0,0,0,250,0,250
360810159004,36, New York,081, Queens County,136,22,0,22,0,0,0,0,0,0,136,22,0,22,0,798,43,755
360810161001,36, New York,081, Queens County,300,124,106,11,7,0,0,0,0,0,300,124,106,11,7,649,31,618
360810161002,36, New York,081, Queens County,224,120,90,13,17,29,23,5,13,5,195,97,85,0,12,671,45,626
360810163001,36, New York,081, Queens County,136,66,66,0,0,8,0,0,0,0,128,66,66,0,0,344,20,324
360810163002,36, New York,081, Queens County,126,113,29,0,84,23,23,0,0,23,103,90,29,0,61,441,69,372
360810163003,36, New York,081, Queens County,865,278,11,0,267,188,131,0,0,131,677,147,11,0,136,1952,389,1563
360810164001,36, New York,081, Queens County,355,118,94,24,0,26,26,12,14,0,329,92,82,10,0,1210,44,1166
360810164002,36, New York,081, Queens County,456,140,124,10,6,42,27,27,0,0,414,113,97,10,6,1516,94,1422
360810166001,36, New York,081, Queens County,532,214,206,0,8,23,0,0,0,0,509,214,206,0,8,1294,79,1215
360810166002,36, New York,081, Queens County,520,196,23,0,173,49,27,0,0,27,471,169,23,0,146,1653,169,1484
360810168001,36, New York,081, Queens County,403,166,106,21,39,56,32,0,0,32,347,134,106,21,7,1157,314,843
360810168002,36, New York,081, Queens County,310,123,63,36,24,41,16,0,16,0,269,107,63,20,24,1069,119,950
360810169001,36, New York,081, Queens County,399,200,165,22,13,0,0,0,0,0,399,200,165,22,13,1069,0,1069
360810169002,36, New York,081, Queens County,289,124,110,0,14,14,14,0,0,14,275,110,110,0,0,888,15,873
360810169003,36, New York,081, Queens County,168,38,25,13,0,11,0,0,0,0,157,38,25,13,0,551,36,515
360810169004,36, New York,081, Queens County,427,168,148,0,20,43,43,43,0,0,384,125,105,0,20,1031,150,881
360810170001,36, New York,081, Queens County,335,173,163,6,4,16,0,0,0,0,319,173,163,6,4,1095,76,1019
360810170002,36, New York,081, Queens County,259,95,80,0,15,70,28,13,0,15,189,67,67,0,0,693,140,553
360810171011,36, New York,081, Queens County,0,0,0,0,0,0,0,0,0,0,0,0,0,0,0,0,0,0
360810171021,36, New York,081, Queens County,0,0,0,0,0,0,0,0,0,0,0,0,0,0,0,39,39,0
360810172001,36, New York,081, Queens County,222,90,74,0,16,0,0,0,0,0,222,90,74,0,16,735,0,735
360810172002,36, New York,081, Queens County,144,30,22,0,8,10,10,6,0,4,134,20,16,0,4,665,141,524
360810174001,36, New York,081, Queens County,250,81,41,0,40,7,0,0,0,0,243,81,41,0,40,805,59,746
360810174002,36, New York,081, Queens County,388,186,143,25,18,23,16,0,16,0,365,170,143,9,18,905,56,849
360810176001,36, New York,081, Queens County,182,81,39,13,29,15,13,0,13,0,167,68,39,0,29,671,70,601
360810176002,36, New York,081, Queens County,308,141,77,11,53,48,48,11,0,37,260,93,66,11,16,769,93,676
360810178001,36, New York,081, Queens County,251,64,36,0,28,14,0,0,0,0,237,64,36,0,28,766,42,724
360810178002,36, New York,081, Queens County,298,175,140,0,35,10,10,10,0,0,288,165,130,0,35,695,22,673
360810179011,36, New York,081, Queens County,236,76,39,11,26,56,0,0,0,0,180,76,39,11,26,580,59,521
360810179021,36, New York,081, Queens County,0,0,0,0,0,0,0,0,0,0,0,0,0,0,0,38,29,9
360810180001,36, New York,081, Queens County,344,156,122,0,34,56,40,12,0,28,288,116,110,0,6,890,71,819
360810181011,36, New York,081, Queens County,400,152,137,0,15,39,27,27,0,0,361,125,110,0,15,623,0,623
360810181012,36, New York,081, Queens County,210,0,0,0,0,14,0,0,0,0,196,0,0,0,0,755,44,711
360810181013,36, New York,081, Queens County,305,71,60,11,0,8,0,0,0,0,297,71,60,11,0,598,62,536
360810181021,36, New York,081, Queens County,225,67,33,20,14,21,14,0,0,14,204,53,33,20,0,638,44,594
360810181022,36, New York,081, Queens County,267,135,90,0,45,0,0,0,0,0,267,135,90,0,45,746,32,714
360810181023,36, New York,081, Queens County,353,80,59,8,13,7,0,0,0,0,346,80,59,8,13,962,21,941
360810182001,36, New York,081, Queens County,284,167,91,28,48,37,34,15,0,19,247,133,76,28,29,926,47,879
360810182002,36, New York,081, Queens County,373,172,111,15,46,24,24,0,0,24,349,148,111,15,22,883,117,766
360810183001,36, New York,081, Queens County,143,70,70,0,0,0,0,0,0,0,143,70,70,0,0,454,0,454
360810183002,36, New York,081, Queens County,153,20,6,14,0,23,1,1,0,0,130,19,5,14,0,555,81,474
360810183003,36, New York,081, Queens County,278,163,139,0,24,72,18,18,0,0,206,145,121,0,24,875,167,708
360810183004,36, New York,081, Queens County,261,144,103,4,37,0,0,0,0,0,261,144,103,4,37,607,0,607
360810183005,36, New York,081, Queens County,167,53,0,51,2,9,0,0,0,0,158,53,0,51,2,404,36,368
360810184011,36, New York,081, Queens County,544,251,125,15,111,103,67,3,15,49,441,184,122,0,62,1346,282,1064
360810184021,36, New York,081, Queens County,260,179,75,18,86,30,30,0,0,30,230,149,75,18,56,1008,209,799
360810184022,36, New York,081, Queens County,311,135,53,25,57,22,0,0,0,0,289,135,53,25,57,1262,82,1180
360810185011,36, New York,081, Queens County,224,70,59,0,11,11,0,0,0,0,213,70,59,0,11,677,93,584
360810185012,36, New York,081, Queens County,368,94,69,12,13,13,13,0,0,13,355,81,69,12,0,1050,46,1004
360810185013,36, New York,081, Queens County,293,146,74,42,30,43,30,0,0,30,250,116,74,42,0,684,103,581
360810185021,36, New York,081, Queens County,79,25,25,0,0,0,0,0,0,0,79,25,25,0,0,403,53,350
360810185022,36, New York,081, Queens County,329,112,101,11,0,11,0,0,0,0,318,112,101,11,0,1029,27,1002
360810185023,36, New York,081, Queens County,227,111,111,0,0,12,0,0,0,0,215,111,111,0,0,722,91,631
360810186001,36, New York,081, Queens County,446,196,68,31,97,42,42,23,0,19,404,154,45,31,78,1160,158,1002
360810187001,36, New York,081, Queens County,237,144,102,0,42,51,42,0,0,42,186,102,102,0,0,386,108,278
360810187002,36, New York,081, Queens County,193,106,106,0,0,0,0,0,0,0,193,106,106,0,0,623,0,623
360810187003,36, New York,081, Queens County,134,45,8,0,37,13,13,0,0,13,121,32,8,0,24,580,85,495
360810188001,36, New York,081, Queens County,285,146,70,14,62,13,12,0,0,12,272,134,70,14,50,891,68,823
360810189001,36, New York,081, Queens County,460,314,293,0,21,12,12,12,0,0,448,302,281,0,21,842,40,802
360810189002,36, New York,081, Queens County,163,76,76,0,0,0,0,0,0,0,163,76,76,0,0,621,119,502
360810189003,36, New York,081, Queens County,160,76,76,0,0,12,12,12,0,0,148,64,64,0,0,436,35,401
360810190001,36, New York,081, Queens County,309,161,111,27,23,47,47,31,1,15,262,114,80,26,8,839,96,743
360810190002,36, New York,081, Queens County,371,109,83,21,5,0,0,0,0,0,371,109,83,21,5,876,9,867
360810192001,36, New York,081, Queens County,209,130,64,6,60,4,0,0,0,0,205,130,64,6,60,661,32,629
360810192002,36, New York,081, Queens County,300,135,78,0,57,6,5,0,0,5,294,130,78,0,52,856,24,832
360810194001,36, New York,081, Queens County,256,72,49,0,23,44,23,0,0,23,212,49,49,0,0,628,126,502
360810194002,36, New York,081, Queens County,463,250,133,19,98,12,12,0,0,12,451,238,133,19,86,1282,59,1223
360810196001,36, New York,081, Queens County,550,284,125,0,159,132,108,0,0,108,418,176,125,0,51,1485,195,1290
360810196002,36, New York,081, Queens County,169,80,59,0,21,31,0,0,0,0,138,80,59,0,21,502,52,450
360810198001,36, New York,081, Queens County,253,149,87,39,23,16,0,0,0,0,237,149,87,39,23,657,43,614
360810198002,36, New York,081, Queens County,285,85,39,15,31,29,15,0,0,15,256,70,39,15,16,569,0,569
360810198003,36, New York,081, Queens County,194,110,91,19,0,0,0,0,0,0,194,110,91,19,0,408,27,381
360810199011,36, New York,081, Queens County,63,6,6,0,0,6,6,6,0,0,57,0,0,0,0,197,39,158
360810199012,36, New York,081, Queens County,0,0,0,0,0,0,0,0,0,0,0,0,0,0,0,3,3,0
360810199021,36, New York,081, Queens County,0,0,0,0,0,0,0,0,0,0,0,0,0,0,0,50,33,17
360810199022,36, New York,081, Queens County,0,0,0,0,0,0,0,0,0,0,0,0,0,0,0,7,0,7
360810199031,36, New York,081, Queens County,0,0,0,0,0,0,0,0,0,0,0,0,0,0,0,0,0,0
360810202001,36, New York,081, Queens County,286,182,140,0,42,14,14,14,0,0,272,168,126,0,42,902,21,881
360810204001,36, New York,081, Queens County,235,133,122,0,11,19,19,19,0,0,216,114,103,0,11,607,42,565
360810204002,36, New York,081, Queens County,200,86,33,53,0,8,8,8,0,0,192,78,25,53,0,714,117,597
360810205001,36, New York,081, Queens County,74,50,10,8,32,10,10,10,0,0,64,40,0,8,32,133,4,129
360810205002,36, New York,081, Queens County,287,131,90,13,28,5,5,5,0,0,282,126,85,13,28,566,39,527
360810206001,36, New York,081, Queens County,329,161,116,0,45,31,19,0,0,19,298,142,116,0,26,768,85,683
360810208001,36, New York,081, Queens County,428,249,233,16,0,0,0,0,0,0,428,249,233,16,0,879,15,864
360810208002,36, New York,081, Queens County,352,208,58,12,138,36,36,0,4,32,316,172,58,8,106,1069,135,934
360810212001,36, New York,081, Queens County,136,55,30,6,19,32,32,21,0,11,104,23,9,6,8,209,46,163
360810212002,36, New York,081, Queens County,399,233,167,23,43,67,67,38,10,19,332,166,129,13,24,1244,258,986
360810214001,36, New York,081, Queens County,405,198,163,17,18,23,0,0,0,0,382,198,163,17,18,1278,136,1142
360810214002,36, New York,081, Queens County,355,90,90,0,0,0,0,0,0,0,355,90,90,0,0,1067,99,968
360810214003,36, New York,081, Queens County,598,424,175,40,209,162,162,0,0,162,436,262,175,40,47,866,128,738
360810216011,36, New York,081, Queens County,635,255,216,12,27,20,3,3,0,0,615,252,213,12,27,2039,83,1956
360810216012,36, New York,081, Queens County,0,0,0,0,0,0,0,0,0,0,0,0,0,0,0,0,0,0
360810216013,36, New York,081, Queens County,0,0,0,0,0,0,0,0,0,0,0,0,0,0,0,0,0,0
360810216021,36, New York,081, Queens County,427,214,150,7,57,54,54,54,0,0,373,160,96,7,57,922,133,789
360810216031,36, New York,081, Queens County,0,0,0,0,0,0,0,0,0,0,0,0,0,0,0,0,0,0
360810216032,36, New York,081, Queens County,0,0,0,0,0,0,0,0,0,0,0,0,0,0,0,0,0,0
360810219001,36, New York,081, Queens County,0,0,0,0,0,0,0,0,0,0,0,0,0,0,0,0,0,0
360810220011,36, New York,081, Queens County,163,75,75,0,0,16,1,1,0,0,147,74,74,0,0,603,16,587
360810220012,36, New York,081, Queens County,550,301,155,54,92,48,48,48,0,0,502,253,107,54,92,1613,298,1315
360810220013,36, New York,081, Queens County,397,121,88,0,33,18,0,0,0,0,379,121,88,0,33,859,78,781
360810220014,36, New York,081, Queens County,353,201,91,57,53,58,30,0,0,30,295,171,91,57,23,1269,119,1150
360810220021,36, New York,081, Queens County,287,92,92,0,0,0,0,0,0,0,287,92,92,0,0,992,0,992
360810220022,36, New York,081, Queens County,355,177,122,42,13,23,13,0,0,13,332,164,122,42,0,846,203,643
360810220023,36, New York,081, Queens County,428,265,252,0,13,70,53,53,0,0,358,212,199,0,13,1401,223,1178
360810220024,36, New York,081, Queens County,561,179,179,0,0,0,0,0,0,0,561,179,179,0,0,1509,101,1408
360810229001,36, New York,081, Queens County,0,0,0,0,0,0,0,0,0,0,0,0,0,0,0,0,0,0
360810230001,36, New York,081, Queens County,167,80,75,5,0,0,0,0,0,0,167,80,75,5,0,557,11,546
360810230002,36, New York,081, Queens County,221,113,92,21,0,28,28,7,21,0,193,85,85,0,0,698,41,657
360810232001,36, New York,081, Queens County,336,61,31,30,0,0,0,0,0,0,336,61,31,30,0,818,30,788
360810232002,36, New York,081, Queens County,392,165,89,0,76,15,0,0,0,0,377,165,89,0,76,983,36,947
360810232003,36, New York,081, Queens County,356,142,134,0,8,34,4,4,0,0,322,138,130,0,8,1601,311,1290
360810235011,36, New York,081, Queens County,513,266,171,35,60,0,0,0,0,0,513,266,171,35,60,807,0,807
360810235012,36, New York,081, Queens County,368,220,204,13,3,84,84,68,13,3,284,136,136,0,0,1028,217,811
360810235021,36, New York,081, Queens County,437,143,86,0,57,75,41,16,0,25,362,102,70,0,32,1125,160,965
360810235022,36, New York,081, Queens County,171,132,63,0,69,15,0,0,0,0,156,132,63,0,69,381,53,328
360810236001,36, New York,081, Queens County,192,91,87,0,4,59,34,34,0,0,133,57,53,0,4,645,137,508
360810236002,36, New York,081, Queens County,383,159,124,11,24,28,7,0,0,7,355,152,124,11,17,1255,129,1126
360810238001,36, New York,081, Queens County,173,119,103,16,0,29,0,0,0,0,144,119,103,16,0,399,90,309
360810238002,36, New York,081, Queens County,383,245,182,33,30,51,42,20,0,22,332,203,162,33,8,803,43,760
360810238003,36, New York,081, Queens County,549,289,247,8,34,148,119,119,0,0,401,170,128,8,34,1023,185,838
360810238004,36, New York,081, Queens County,107,29,29,0,0,13,13,13,0,0,94,16,16,0,0,455,109,346
360810240001,36, New York,081, Queens County,431,191,162,0,29,0,0,0,0,0,431,191,162,0,29,997,44,953
360810240002,36, New York,081, Queens County,582,349,155,51,143,118,82,52,0,30,464,267,103,51,113,1379,339,1040
360810240003,36, New York,081, Queens County,425,193,91,69,33,86,52,10,28,14,339,141,81,41,19,1044,172,872
360810243001,36, New York,081, Queens County,271,14,14,0,0,0,0,0,0,0,271,14,14,0,0,412,0,412
360810243002,36, New York,081, Queens County,275,100,100,0,0,0,0,0,0,0,275,100,100,0,0,804,44,760
360810243003,36, New York,081, Queens County,334,143,119,0,24,43,0,0,0,0,291,143,119,0,24,656,64,592
360810243004,36, New York,081, Queens County,575,267,216,9,42,13,12,12,0,0,562,255,204,9,42,1269,40,1229
360810245001,36, New York,081, Queens County,542,186,141,0,45,0,0,0,0,0,542,186,141,0,45,1574,9,1565
360810245002,36, New York,081, Queens County,200,16,16,0,0,0,0,0,0,0,200,16,16,0,0,939,82,857
360810245003,36, New York,081, Queens County,151,98,59,0,39,53,9,0,0,9,98,89,59,0,30,211,9,202
360810245004,36, New York,081, Queens County,116,46,8,30,8,0,0,0,0,0,116,46,8,30,8,292,34,258
360810246001,36, New York,081, Queens County,0,0,0,0,0,0,0,0,0,0,0,0,0,0,0,0,0,0
360810247001,36, New York,081, Queens County,269,136,102,28,6,34,29,5,18,6,235,107,97,10,0,735,120,615
360810249001,36, New York,081, Queens County,625,207,155,30,22,51,51,51,0,0,574,156,104,30,22,936,122,814
360810249002,36, New York,081, Queens County,234,76,22,15,39,59,0,0,0,0,175,76,22,15,39,491,82,409
360810249003,36, New York,081, Queens County,337,272,103,0,169,0,0,0,0,0,337,272,103,0,169,804,40,764
360810251001,36, New York,081, Queens County,561,176,176,0,0,10,0,0,0,0,551,176,176,0,0,1454,60,1394
360810251002,36, New York,081, Queens County,112,92,0,43,49,0,0,0,0,0,112,92,0,43,49,263,54,209
360810251003,36, New York,081, Queens County,549,257,123,20,114,55,39,39,0,0,494,218,84,20,114,980,181,799
360810251004,36, New York,081, Queens County,282,10,0,0,10,24,10,0,0,10,258,0,0,0,0,632,40,592
360810253011,36, New York,081, Queens County,151,37,37,0,0,0,0,0,0,0,151,37,37,0,0,596,44,552
360810253012,36, New York,081, Queens County,347,182,136,16,30,54,16,16,0,0,293,166,120,16,30,557,163,394
360810253013,36, New York,081, Queens County,278,19,16,3,0,24,1,1,0,0,254,18,15,3,0,749,75,674
360810253014,36, New York,081, Queens County,148,109,39,22,48,32,32,25,0,7,116,77,14,22,41,444,52,392
360810253021,36, New York,081, Queens County,647,272,105,84,83,47,47,47,0,0,600,225,58,84,83,1041,72,969
360810253022,36, New York,081, Queens County,191,39,14,17,8,9,0,0,0,0,182,39,14,17,8,457,25,432
360810254011,36, New York,081, Queens County,523,251,201,0,50,23,20,20,0,0,500,231,181,0,50,1457,29,1428
360810254012,36, New York,081, Queens County,213,91,91,0,0,0,0,0,0,0,213,91,91,0,0,660,22,638
360810254021,36, New York,081, Queens County,331,155,115,0,40,0,0,0,0,0,331,155,115,0,40,996,233,763
360810254022,36, New York,081, Queens County,462,341,114,114,113,114,114,0,47,67,348,227,114,67,46,1161,272,889
360810254023,36, New York,081, Queens County,683,420,0,0,420,138,58,0,0,58,545,362,0,0,362,1683,486,1197
360810255001,36, New York,081, Queens County,436,217,190,20,7,39,39,32,0,7,397,178,158,20,0,745,141,604
360810257001,36, New York,081, Queens County,400,161,137,0,24,70,38,24,0,14,330,123,113,0,10,803,69,734
360810258001,36, New York,081, Queens County,247,67,32,0,35,11,0,0,0,0,236,67,32,0,35,802,42,760
360810258002,36, New York,081, Queens County,235,162,77,24,61,41,24,24,0,0,194,138,53,24,61,851,138,713
360810259001,36, New York,081, Queens County,577,160,160,0,0,21,0,0,0,0,556,160,160,0,0,1011,47,964
360810259002,36, New York,081, Queens County,197,93,9,35,49,21,0,0,0,0,176,93,9,35,49,436,33,403
360810260001,36, New York,081, Queens County,207,162,17,0,145,29,22,0,0,22,178,140,17,0,123,617,67,550
360810260002,36, New York,081, Queens County,348,215,126,19,70,5,5,0,0,5,343,210,126,19,65,1041,21,1020
360810261001,36, New York,081, Queens County,284,182,101,14,67,0,0,0,0,0,284,182,101,14,67,814,0,814
360810261002,36, New York,081, Queens County,330,124,118,0,6,39,10,10,0,0,291,114,108,0,6,283,83,200
360810261003,36, New York,081, Queens County,593,259,233,0,26,11,0,0,0,0,582,259,233,0,26,843,91,752
360810261004,36, New York,081, Queens County,297,171,79,21,71,42,42,21,0,21,255,129,58,21,50,508,60,448
360810262001,36, New York,081, Queens County,362,244,174,19,51,76,64,47,0,17,286,180,127,19,34,1015,147,868
360810263001,36, New York,081, Queens County,155,59,32,0,27,1,0,0,0,0,154,59,32,0,27,419,22,397
360810263002,36, New York,081, Queens County,608,435,406,0,29,0,0,0,0,0,608,435,406,0,29,1140,32,1108
360810263003,36, New York,081, Queens County,558,226,226,0,0,0,0,0,0,0,558,226,226,0,0,915,0,915
360810264001,36, New York,081, Queens County,309,85,40,14,31,7,7,0,0,7,302,78,40,14,24,1018,139,879
360810264002,36, New York,081, Queens County,236,166,110,6,50,4,0,0,0,0,232,166,110,6,50,821,191,630
360810265011,36, New York,081, Queens County,344,214,80,67,67,73,67,10,0,57,271,147,70,67,10,522,198,324
360810265012,36, New York,081, Queens County,356,195,110,21,64,36,20,9,0,11,320,175,101,21,53,718,93,625
360810265021,36, New York,081, Queens County,313,256,143,44,69,17,17,0,17,0,296,239,143,27,69,484,40,444
360810266001,36, New York,081, Queens County,321,63,45,0,18,59,18,0,0,18,262,45,45,0,0,1296,425,871
360810267001,36, New York,081, Queens County,477,243,229,0,14,1,1,1,0,0,476,242,228,0,14,1100,42,1058
360810267002,36, New York,081, Queens County,449,220,150,0,70,59,59,0,0,59,390,161,150,0,11,602,80,522
360810267003,36, New York,081, Queens County,488,128,128,0,0,69,54,54,0,0,419,74,74,0,0,975,218,757
360810269011,36, New York,081, Queens County,363,223,128,0,95,48,26,26,0,0,315,197,102,0,95,458,60,398
360810269012,36, New York,081, Queens County,201,85,55,0,30,7,7,0,0,7,194,78,55,0,23,462,47,415
360810269013,36, New York,081, Queens County,304,171,166,0,5,0,0,0,0,0,304,171,166,0,5,610,0,610
360810269014,36, New York,081, Queens County,164,142,47,59,36,59,59,0,59,0,105,83,47,0,36,373,18,355
360810269021,36, New York,081, Queens County,465,254,154,3,97,81,71,26,3,42,384,183,128,0,55,953,155,798
360810269022,36, New York,081, Queens County,388,116,86,0,30,18,18,9,0,9,370,98,77,0,21,742,150,592
360810270001,36, New York,081, Queens County,461,223,138,54,31,2,2,2,0,0,459,221,136,54,31,1443,63,1380
360810271011,36, New York,081, Queens County,199,110,110,0,0,0,0,0,0,0,199,110,110,0,0,590,35,555
360810271012,36, New York,081, Queens County,309,202,57,0,145,11,0,0,0,0,298,202,57,0,145,420,22,398
360810271013,36, New York,081, Queens County,505,267,176,22,69,6,6,6,0,0,499,261,170,22,69,1660,244,1416
360810271021,36, New York,081, Queens County,439,180,166,0,14,32,32,32,0,0,407,148,134,0,14,884,126,758
360810271022,36, New York,081, Queens County,205,49,49,0,0,0,0,0,0,0,205,49,49,0,0,302,0,302
360810272001,36, New York,081, Queens County,147,36,20,0,16,0,0,0,0,0,147,36,20,0,16,502,0,502
360810272002,36, New York,081, Queens County,318,94,53,0,41,37,37,17,0,20,281,57,36,0,21,749,37,712
360810273011,36, New York,081, Queens County,433,112,79,0,33,0,0,0,0,0,433,112,79,0,33,593,81,512
360810273012,36, New York,081, Queens County,323,191,39,13,139,139,139,0,0,139,184,52,39,13,0,164,36,128
360810273021,36, New York,081, Queens County,214,98,0,16,82,0,0,0,0,0,214,98,0,16,82,652,0,652
360810273022,36, New York,081, Queens County,393,238,120,8,110,56,9,0,0,9,337,229,120,8,101,533,65,468
360810273023,36, New York,081, Queens County,505,219,111,20,88,147,99,46,0,53,358,120,65,20,35,653,150,503
360810274001,36, New York,081, Queens County,483,242,163,0,79,115,54,15,0,39,368,188,148,0,40,1302,192,1110
360810275001,36, New York,081, Queens County,535,186,163,0,23,67,67,67,0,0,468,119,96,0,23,993,62,931
360810275002,36, New York,081, Queens County,517,165,96,30,39,149,107,68,0,39,368,58,28,30,0,1238,289,949
360810275003,36, New York,081, Queens County,451,266,201,0,65,110,59,59,0,0,341,207,142,0,65,919,289,630
360810276001,36, New York,081, Queens County,336,186,73,62,51,28,28,0,28,0,308,158,73,34,51,961,59,902
360810277011,36, New York,081, Queens County,287,74,74,0,0,0,0,0,0,0,287,74,74,0,0,895,82,813
360810277012,36, New York,081, Queens County,550,283,184,0,99,80,59,0,0,59,470,224,184,0,40,1278,140,1138
360810277021,36, New York,081, Queens County,525,127,127,0,0,0,0,0,0,0,525,127,127,0,0,1200,0,1200
360810277022,36, New York,081, Queens County,263,148,131,0,17,17,17,0,0,17,246,131,131,0,0,447,43,404
360810277023,36, New York,081, Queens County,241,92,92,0,0,6,6,6,0,0,235,86,86,0,0,604,86,518
360810278001,36, New York,081, Queens County,216,41,24,0,17,21,9,0,0,9,195,32,24,0,8,550,51,499
360810278002,36, New York,081, Queens County,477,237,31,0,206,155,112,0,0,112,322,125,31,0,94,1161,327,834
360810279001,36, New York,081, Queens County,423,96,96,0,0,0,0,0,0,0,423,96,96,0,0,1038,0,1038
360810279002,36, New York,081, Queens County,805,451,227,148,76,17,0,0,0,0,788,451,227,148,76,895,69,826
360810279003,36, New York,081, Queens County,326,112,31,50,31,0,0,0,0,0,326,112,31,50,31,572,90,482
360810279004,36, New York,081, Queens County,142,47,22,0,25,54,0,0,0,0,88,47,22,0,25,461,195,266
360810280001,36, New York,081, Queens County,313,119,66,22,31,21,0,0,0,0,292,119,66,22,31,1111,92,1019
360810281001,36, New York,081, Queens County,358,207,207,0,0,42,42,42,0,0,316,165,165,0,0,720,42,678
360810281002,36, New York,081, Queens County,519,236,97,0,139,35,35,0,0,35,484,201,97,0,104,1418,83,1335
360810281003,36, New York,081, Queens County,398,106,106,0,0,41,0,0,0,0,357,106,106,0,0,1179,59,1120
360810281004,36, New York,081, Queens County,321,34,0,0,34,14,14,0,0,14,307,20,0,0,20,774,62,712
360810282001,36, New York,081, Queens County,499,351,186,15,150,28,28,24,0,4,471,323,162,15,146,1310,92,1218
360810283001,36, New York,081, Queens County,170,162,83,0,79,0,0,0,0,0,170,162,83,0,79,495,37,458
360810283002,36, New York,081, Queens County,362,181,108,0,73,14,14,0,0,14,348,167,108,0,59,1149,175,974
360810283003,36, New York,081, Queens County,282,132,22,53,57,15,0,0,0,0,267,132,22,53,57,592,129,463
360810283004,36, New York,081, Queens County,302,77,54,0,23,0,0,0,0,0,302,77,54,0,23,894,135,759
360810283005,36, New York,081, Queens County,522,138,18,0,120,71,71,0,0,71,451,67,18,0,49,1172,71,1101
360810284001,36, New York,081, Queens County,519,316,179,30,107,0,0,0,0,0,519,316,179,30,107,1711,11,1700
360810284002,36, New York,081, Queens County,401,179,127,21,31,0,0,0,0,0,401,179,127,21,31,1073,47,1026
360810285001,36, New York,081, Queens County,334,156,98,0,58,20,0,0,0,0,314,156,98,0,58,671,21,650
360810285002,36, New York,081, Queens County,285,92,92,0,0,0,0,0,0,0,285,92,92,0,0,861,26,835
360810285003,36, New York,081, Queens County,524,184,184,0,0,96,0,0,0,0,428,184,184,0,0,1502,229,1273
360810285004,36, New York,081, Queens County,149,50,50,0,0,23,14,14,0,0,126,36,36,0,0,313,90,223
360810287001,36, New York,081, Queens County,345,230,119,0,111,0,0,0,0,0,345,230,119,0,111,798,34,764
360810287002,36, New York,081, Queens County,132,43,31,0,12,0,0,0,0,0,132,43,31,0,12,561,14,547
360810287003,36, New York,081, Queens County,538,110,110,0,0,0,0,0,0,0,538,110,110,0,0,1821,208,1613
360810287004,36, New York,081, Queens County,507,358,306,0,52,252,252,200,0,52,255,106,106,0,0,1290,511,779
360810288011,36, New York,081, Queens County,233,165,51,13,101,32,32,0,0,32,201,133,51,13,69,904,65,839
360810288012,36, New York,081, Queens County,271,185,126,0,59,0,0,0,0,0,271,185,126,0,59,1035,7,1028
360810288021,36, New York,081, Queens County,204,81,62,19,0,0,0,0,0,0,204,81,62,19,0,523,93,430
360810288022,36, New York,081, Queens County,267,104,15,12,77,24,24,0,12,12,243,80,15,0,65,951,101,850
360810288031,36, New York,081, Queens County,0,0,0,0,0,0,0,0,0,0,0,0,0,0,0,0,0,0
360810289001,36, New York,081, Queens County,161,39,38,0,1,23,23,23,0,0,138,16,15,0,1,324,47,277
360810289002,36, New York,081, Queens County,215,38,21,0,17,0,0,0,0,0,215,38,21,0,17,712,71,641
360810289003,36, New York,081, Queens County,850,472,345,0,127,91,33,0,0,33,759,439,345,0,94,2050,163,1887
360810291001,36, New York,081, Queens County,661,410,351,21,38,81,56,18,0,38,580,354,333,21,0,830,87,743
360810291002,36, New York,081, Queens County,444,172,152,20,0,68,44,44,0,0,376,128,108,20,0,786,122,664
360810291003,36, New York,081, Queens County,274,88,64,0,24,15,0,0,0,0,259,88,64,0,24,914,36,878
360810291004,36, New York,081, Queens County,229,95,62,0,33,19,0,0,0,0,210,95,62,0,33,312,49,263
360810293001,36, New York,081, Queens County,266,174,92,18,64,10,0,0,0,0,256,174,92,18,64,415,19,396
360810294001,36, New York,081, Queens County,523,411,335,0,76,0,0,0,0,0,523,411,335,0,76,1215,95,1120
360810294002,36, New York,081, Queens County,211,194,150,0,44,0,0,0,0,0,211,194,150,0,44,591,0,591
360810294003,36, New York,081, Queens County,325,194,134,0,60,23,0,0,0,0,302,194,134,0,60,1081,67,1014
360810294004,36, New York,081, Queens County,147,107,107,0,0,0,0,0,0,0,147,107,107,0,0,638,72,566
360810294005,36, New York,081, Queens County,287,184,161,0,23,0,0,0,0,0,287,184,161,0,23,923,65,858
360810294006,36, New York,081, Queens County,179,79,59,0,20,0,0,0,0,0,179,79,59,0,20,766,229,537
360810295001,36, New York,081, Queens County,509,145,138,0,7,10,0,0,0,0,499,145,138,0,7,1532,109,1423
360810295002,36, New York,081, Queens County,380,223,158,0,65,24,24,7,0,17,356,199,151,0,48,1016,116,900
360810297001,36, New York,081, Queens County,237,91,77,14,0,0,0,0,0,0,237,91,77,14,0,519,8,511
360810297002,36, New York,081, Queens County,305,169,78,56,35,22,18,14,0,4,283,151,64,56,31,657,55,602
360810299001,36, New York,081, Queens County,0,0,0,0,0,0,0,0,0,0,0,0,0,0,0,0,0,0
360810306001,36, New York,081, Queens County,0,0,0,0,0,0,0,0,0,0,0,0,0,0,0,216,166,50
360810306002,36, New York,081, Queens County,86,20,10,0,10,0,0,0,0,0,86,20,10,0,10,202,0,202
360810306003,36, New York,081, Queens County,323,169,115,24,30,1,0,0,0,0,322,169,115,24,30,992,16,976
360810306004,36, New York,081, Queens County,238,85,62,0,23,12,12,12,0,0,226,73,50,0,23,937,82,855
360810306005,36, New York,081, Queens County,389,282,123,31,128,0,0,0,0,0,389,282,123,31,128,990,29,961
360810309031,36, New York,081, Queens County,260,51,51,0,0,22,0,0,0,0,238,51,51,0,0,759,55,704
360810309032,36, New York,081, Queens County,251,75,75,0,0,14,14,14,0,0,237,61,61,0,0,787,36,751
360810309033,36, New York,081, Queens County,256,87,52,19,16,12,0,0,0,0,244,87,52,19,16,720,23,697
360810309034,36, New York,081, Queens County,394,138,117,0,21,16,0,0,0,0,378,138,117,0,21,1161,30,1131
360810309041,36, New York,081, Queens County,233,127,110,7,10,27,10,3,7,0,206,117,107,0,10,668,101,567
360810309042,36, New York,081, Queens County,467,83,67,0,16,35,0,0,0,0,432,83,67,0,16,1291,188,1103
360810309051,36, New York,081, Queens County,151,43,43,0,0,31,31,31,0,0,120,12,12,0,0,280,0,280
360810309052,36, New York,081, Queens County,628,322,245,0,77,23,23,23,0,0,605,299,222,0,77,1381,63,1318
360810309061,36, New York,081, Queens County,257,54,27,0,27,12,12,0,0,12,245,42,27,0,15,770,44,726
360810309062,36, New York,081, Queens County,329,64,32,0,32,80,15,15,0,0,249,49,17,0,32,835,163,672
360810309063,36, New York,081, Queens County,262,76,31,0,45,0,0,0,0,0,262,76,31,0,45,641,100,541
360810317001,36, New York,081, Queens County,0,0,0,0,0,0,0,0,0,0,0,0,0,0,0,0,0,0
360810317002,36, New York,081, Queens County,380,156,140,0,16,62,0,0,0,0,318,156,140,0,16,1583,129,1454
360810317003,36, New York,081, Queens County,195,19,15,0,4,19,0,0,0,0,176,19,15,0,4,699,54,645
360810317004,36, New York,081, Queens County,194,77,45,0,32,54,32,0,0,32,140,45,45,0,0,721,119,602
360810317005,36, New York,081, Queens County,281,125,115,10,0,0,0,0,0,0,281,125,115,10,0,867,133,734
360810320001,36, New York,081, Queens County,323,102,56,0,46,0,0,0,0,0,323,102,56,0,46,1010,49,961
360810320002,36, New York,081, Queens County,1,1,1,0,0,1,1,1,0,0,0,0,0,0,0,662,506,156
360810320003,36, New York,081, Queens County,189,58,19,0,39,55,0,0,0,0,134,58,19,0,39,969,176,793
360810320004,36, New York,081, Queens County,364,276,114,0,162,34,34,0,0,34,330,242,114,0,128,941,122,819
360810327001,36, New York,081, Queens County,465,186,169,0,17,49,18,18,0,0,416,168,151,0,17,1241,193,1048
360810327002,36, New York,081, Queens County,258,177,116,61,0,29,21,21,0,0,229,156,95,61,0,462,42,420
360810328001,36, New York,081, Queens County,328,183,36,56,91,26,11,0,0,11,302,172,36,56,80,890,67,823
360810328002,36, New York,081, Queens County,193,124,72,13,39,11,0,0,0,0,182,124,72,13,39,440,20,420
360810328003,36, New York,081, Queens County,215,90,51,18,21,15,0,0,0,0,200,90,51,18,21,511,33,478
360810329001,36, New York,081, Queens County,300,74,74,0,0,0,0,0,0,0,300,74,74,0,0,763,139,624
360810329002,36, New York,081, Queens County,268,159,149,0,10,54,52,42,0,10,214,107,107,0,0,774,76,698
360810329003,36, New York,081, Queens County,237,114,111,0,3,9,0,0,0,0,228,114,111,0,3,530,32,498
360810330001,36, New York,081, Queens County,446,186,84,27,75,41,19,0,0,19,405,167,84,27,56,1252,44,1208
360810330002,36, New York,081, Queens County,345,188,86,35,67,35,35,35,0,0,310,153,51,35,67,1108,67,1041
360810330003,36, New York,081, Queens County,423,138,110,10,18,0,0,0,0,0,423,138,110,10,18,1151,52,1099
360810330004,36, New York,081, Queens County,259,141,99,0,42,32,32,0,0,32,227,109,99,0,10,812,32,780
360810330005,36, New York,081, Queens County,215,70,47,0,23,44,0,0,0,0,171,70,47,0,23,574,101,473
360810331000,36, New York,081, Queens County,0,0,0,0,0,0,0,0,0,0,0,0,0,0,0,0,0,0
360810331001,36, New York,081, Queens County,0,0,0,0,0,0,0,0,0,0,0,0,0,0,0,0,0,0
360810334011,36, New York,081, Queens County,387,214,113,0,101,76,76,53,0,23,311,138,60,0,78,1062,147,915
360810334012,36, New York,081, Queens County,653,484,136,34,314,54,47,31,16,0,599,437,105,18,314,1679,127,1552
360810334031,36, New York,081, Queens County,335,89,27,0,62,62,62,0,0,62,273,27,27,0,0,1351,127,1224
360810334032,36, New York,081, Queens County,601,438,74,0,364,23,23,0,0,23,578,415,74,0,341,1905,173,1732
360810334041,36, New York,081, Queens County,1122,641,162,0,479,183,0,0,0,0,939,641,162,0,479,2318,405,1913
360810334042,36, New York,081, Queens County,677,265,59,0,206,45,45,0,0,45,632,220,59,0,161,2060,426,1634
360810334051,36, New York,081, Queens County,711,373,260,0,113,0,0,0,0,0,711,373,260,0,113,2185,134,2051
360810334052,36, New York,081, Queens County,231,73,20,53,0,0,0,0,0,0,231,73,20,53,0,571,0,571
360810337001,36, New York,081, Queens County,329,80,67,0,13,8,0,0,0,0,321,80,67,0,13,713,30,683
360810337002,36, New York,081, Queens County,256,145,80,55,10,27,27,0,27,0,229,118,80,28,10,559,28,531
360810339001,36, New York,081, Queens County,347,94,22,37,35,139,72,0,37,35,208,22,22,0,0,721,223,498
360810339002,36, New York,081, Queens County,273,90,90,0,0,89,50,50,0,0,184,40,40,0,0,735,189,546
360810339003,36, New York,081, Queens County,194,98,56,35,7,0,0,0,0,0,194,98,56,35,7,425,11,414
360810347001,36, New York,081, Queens County,250,48,34,0,14,11,11,11,0,0,239,37,23,0,14,777,40,737
360810347002,36, New York,081, Queens County,352,215,122,38,55,66,66,19,0,47,286,149,103,38,8,888,151,737
360810351001,36, New York,081, Queens County,147,73,50,23,0,9,9,9,0,0,138,64,41,23,0,396,49,347
360810351002,36, New York,081, Queens County,537,100,71,11,18,33,13,13,0,0,504,87,58,11,18,1487,81,1406
360810351003,36, New York,081, Queens County,297,216,97,0,119,78,78,0,0,78,219,138,97,0,41,489,21,468
360810352001,36, New York,081, Queens County,323,110,91,0,19,37,7,0,0,7,286,103,91,0,12,1028,179,849
360810352002,36, New York,081, Queens County,282,183,157,0,26,0,0,0,0,0,282,183,157,0,26,1155,67,1088
360810353001,36, New York,081, Queens County,210,124,62,55,7,9,9,0,9,0,201,115,62,46,7,651,80,571
360810353002,36, New York,081, Queens County,150,57,23,6,28,14,9,0,0,9,136,48,23,6,19,561,69,492
360810357001,36, New York,081, Queens County,343,35,21,14,0,0,0,0,0,0,343,35,21,14,0,1345,162,1183
360810357002,36, New York,081, Queens County,194,110,86,0,24,0,0,0,0,0,194,110,86,0,24,634,24,610
360810357003,36, New York,081, Queens County,207,104,67,0,37,18,18,18,0,0,189,86,49,0,37,796,165,631
360810358001,36, New York,081, Queens County,257,135,26,0,109,0,0,0,0,0,257,135,26,0,109,827,0,827
360810358002,36, New York,081, Queens County,329,92,25,0,67,14,0,0,0,0,315,92,25,0,67,1007,89,918
360810358003,36, New York,081, Queens County,240,139,76,15,48,15,15,0,15,0,225,124,76,0,48,702,71,631
360810358004,36, New York,081, Queens County,118,40,19,0,21,10,0,0,0,0,108,40,19,0,21,316,10,306
360810361001,36, New York,081, Queens County,274,77,27,15,35,0,0,0,0,0,274,77,27,15,35,672,2,670
360810361002,36, New York,081, Queens County,227,102,90,0,12,9,3,3,0,0,218,99,87,0,12,654,64,590
360810363001,36, New York,081, Queens County,203,61,61,0,0,16,16,16,0,0,187,45,45,0,0,588,32,556
360810363002,36, New York,081, Queens County,202,101,79,0,22,18,18,0,0,18,184,83,79,0,4,394,19,375
360810365001,36, New York,081, Queens County,214,142,89,0,53,79,56,3,0,53,135,86,86,0,0,291,44,247
360810365002,36, New York,081, Queens County,386,147,67,27,53,20,15,5,0,10,366,132,62,27,43,733,37,696
360810366001,36, New York,081, Queens County,313,154,79,0,75,0,0,0,0,0,313,154,79,0,75,1056,114,942
360810366002,36, New York,081, Queens County,361,135,57,35,43,16,16,0,0,16,345,119,57,35,27,1186,62,1124
360810367001,36, New York,081, Queens County,175,76,76,0,0,72,0,0,0,0,103,76,76,0,0,365,147,218
360810367002,36, New York,081, Queens County,396,147,58,22,67,57,32,16,0,16,339,115,42,22,51,1030,135,895
360810368001,36, New York,081, Queens County,305,149,70,0,79,31,3,3,0,0,274,146,67,0,79,987,100,887
360810368002,36, New York,081, Queens County,238,116,61,17,38,7,0,0,0,0,231,116,61,17,38,832,68,764
360810371001,36, New York,081, Queens County,242,134,79,21,34,12,7,7,0,0,230,127,72,21,34,960,127,833
360810373001,36, New York,081, Queens County,211,112,89,15,8,0,0,0,0,0,211,112,89,15,8,649,74,575
360810373002,36, New York,081, Queens County,245,166,127,11,28,44,38,27,11,0,201,128,100,0,28,481,53,428
360810375011,36, New York,081, Queens County,269,174,128,26,20,64,64,39,17,8,205,110,89,9,12,426,87,339
360810375021,36, New York,081, Queens County,275,136,86,19,31,46,38,13,0,25,229,98,73,19,6,631,68,563
360810375022,36, New York,081, Queens County,247,135,17,8,110,11,11,0,0,11,236,124,17,8,99,638,15,623
360810376001,36, New York,081, Queens County,205,104,28,0,76,15,15,0,0,15,190,89,28,0,61,648,30,618
360810376002,36, New York,081, Queens County,363,201,57,0,144,46,46,20,0,26,317,155,37,0,118,1198,129,1069
360810376003,36, New York,081, Queens County,165,80,57,0,23,0,0,0,0,0,165,80,57,0,23,451,29,422
360810376004,36, New York,081, Queens County,336,72,15,57,0,22,0,0,0,0,314,72,15,57,0,1032,101,931
360810376005,36, New York,081, Queens County,377,184,40,13,131,13,13,0,13,0,364,171,40,0,131,1137,25,1112
360810377001,36, New York,081, Queens County,344,225,70,123,32,42,35,9,15,11,302,190,61,108,21,514,64,450
360810377002,36, New York,081, Queens County,322,223,149,34,40,16,16,0,0,16,306,207,149,34,24,470,7,463
360810379001,36, New York,081, Queens County,445,335,151,63,121,59,39,0,0,39,386,296,151,63,82,673,45,628
360810379002,36, New York,081, Queens County,674,367,266,23,78,68,68,68,0,0,606,299,198,23,78,1071,23,1048
360810379003,36, New York,081, Queens County,352,216,97,76,43,108,82,0,60,22,244,134,97,16,21,472,0,472
360810381001,36, New York,081, Queens County,416,222,129,17,76,27,27,27,0,0,389,195,102,17,76,906,132,774
360810381002,36, New York,081, Queens County,596,283,213,0,70,70,70,0,0,70,526,213,213,0,0,673,47,626
360810381003,36, New York,081, Queens County,468,261,183,0,78,43,43,0,0,43,425,218,183,0,35,714,97,617
360810383010,36, New York,081, Queens County,0,0,0,0,0,0,0,0,0,0,0,0,0,0,0,0,0,0
360810383011,36, New York,081, Queens County,0,0,0,0,0,0,0,0,0,0,0,0,0,0,0,0,0,0
360810383020,36, New York,081, Queens County,0,0,0,0,0,0,0,0,0,0,0,0,0,0,0,0,0,0
360810383021,36, New York,081, Queens County,0,0,0,0,0,0,0,0,0,0,0,0,0,0,0,0,0,0
360810384001,36, New York,081, Queens County,260,90,47,0,43,7,0,0,0,0,253,90,47,0,43,945,125,820
360810384002,36, New York,081, Queens County,352,116,16,78,22,20,0,0,0,0,332,116,16,78,22,1012,103,909
360810394001,36, New York,081, Queens County,290,130,53,0,77,6,0,0,0,0,284,130,53,0,77,1181,255,926
360810394002,36, New York,081, Queens County,227,119,33,8,78,71,56,0,2,54,156,63,33,6,24,575,135,440
360810394003,36, New York,081, Queens County,230,107,29,0,78,31,31,0,0,31,199,76,29,0,47,668,68,600
360810398001,36, New York,081, Queens County,237,75,56,3,16,0,0,0,0,0,237,75,56,3,16,910,40,870
360810398002,36, New York,081, Queens County,122,46,34,0,12,12,12,0,0,12,110,34,34,0,0,333,20,313
360810399011,36, New York,081, Queens County,258,181,170,0,11,0,0,0,0,0,258,181,170,0,11,362,19,343
360810399012,36, New York,081, Queens County,192,118,35,83,0,0,0,0,0,0,192,118,35,83,0,477,0,477
360810399021,36, New York,081, Queens County,309,201,91,75,35,54,33,33,0,0,255,168,58,75,35,904,368,536
360810400001,36, New York,081, Queens County,201,55,21,4,30,0,0,0,0,0,201,55,21,4,30,644,45,599
360810400002,36, New York,081, Queens County,201,104,38,27,39,11,11,0,11,0,190,93,38,16,39,561,16,545
360810401011,36, New York,081, Queens County,414,160,85,64,11,87,52,27,14,11,327,108,58,50,0,717,147,570
360810401012,36, New York,081, Queens County,204,56,56,0,0,0,0,0,0,0,204,56,56,0,0,690,0,690
360810401021,36, New York,081, Queens County,561,413,226,36,151,78,78,27,0,51,483,335,199,36,100,1026,191,835
360810401022,36, New York,081, Queens County,326,145,35,33,77,55,26,0,0,26,271,119,35,33,51,655,117,538
360810402001,36, New York,081, Queens County,174,97,43,11,43,11,11,0,11,0,163,86,43,0,43,568,26,542
360810402002,36, New York,081, Queens County,249,77,23,20,34,18,18,0,18,0,231,59,23,2,34,713,75,638
360810403011,36, New York,081, Queens County,241,227,77,121,29,22,8,8,0,0,219,219,69,121,29,385,29,356
360810403012,36, New York,081, Queens County,444,268,23,210,35,82,17,17,0,0,362,251,6,210,35,725,138,587
360810403021,36, New York,081, Queens County,967,490,306,39,145,133,133,58,7,68,834,357,248,32,77,1427,188,1239
360810404001,36, New York,081, Queens County,148,41,32,9,0,20,0,0,0,0,128,41,32,9,0,429,60,369
360810404002,36, New York,081, Queens County,299,99,29,24,46,30,30,4,0,26,269,69,25,24,20,751,152,599
360810404003,36, New York,081, Queens County,219,61,15,0,46,13,0,0,0,0,206,61,15,0,46,970,54,916
360810404004,36, New York,081, Queens County,313,152,30,6,116,9,0,0,0,0,304,152,30,6,116,1056,35,1021
360810405011,36, New York,081, Queens County,91,43,26,17,0,0,0,0,0,0,91,43,26,17,0,117,17,100
360810405021,36, New York,081, Queens County,368,191,93,42,56,21,21,0,0,21,347,170,93,42,35,793,56,737
360810407011,36, New York,081, Queens County,508,323,108,32,183,97,97,0,32,65,411,226,108,0,118,655,53,602
360810407012,36, New York,081, Queens County,185,135,11,97,27,0,0,0,0,0,185,135,11,97,27,179,27,152
360810407021,36, New York,081, Queens County,359,138,86,26,26,30,30,30,0,0,329,108,56,26,26,490,30,460
360810407022,36, New York,081, Queens County,219,93,64,16,13,0,0,0,0,0,219,93,64,16,13,335,0,335
360810407023,36, New York,081, Queens County,245,104,79,0,25,66,66,41,0,25,179,38,38,0,0,178,0,178
360810409011,36, New York,081, Queens County,210,111,58,53,0,46,25,25,0,0,164,86,33,53,0,115,12,103
360810409012,36, New York,081, Queens County,211,68,37,0,31,0,0,0,0,0,211,68,37,0,31,458,5,453
360810409021,36, New York,081, Queens County,295,201,80,33,88,10,10,0,0,10,285,191,80,33,78,304,8,296
360810409022,36, New York,081, Queens County,302,137,74,18,45,45,20,0,0,20,257,117,74,18,25,606,121,485
360810411001,36, New York,081, Queens County,323,191,82,0,109,49,37,21,0,16,274,154,61,0,93,1006,253,753
360810411002,36, New York,081, Queens County,548,284,228,0,56,70,70,46,0,24,478,214,182,0,32,761,102,659
360810413001,36, New York,081, Queens County,168,64,37,5,22,42,42,37,5,0,126,22,0,0,22,225,43,182
360810413002,36, New York,081, Queens County,455,185,129,56,0,36,35,35,0,0,419,150,94,56,0,535,21,514
360810413003,36, New York,081, Queens County,194,102,37,28,37,48,48,11,0,37,146,54,26,28,0,466,134,332
360810414001,36, New York,081, Queens County,808,441,175,76,190,69,64,0,37,27,739,377,175,39,163,1852,265,1587
360810414002,36, New York,081, Queens County,186,75,39,12,24,36,36,0,12,24,150,39,39,0,0,385,15,370
360810414003,36, New York,081, Queens County,312,228,133,60,35,75,46,28,0,18,237,182,105,60,17,954,281,673
360810415001,36, New York,081, Queens County,562,197,89,25,83,99,86,0,25,61,463,111,89,0,22,819,155,664
360810415002,36, New York,081, Queens County,503,159,111,0,48,0,0,0,0,0,503,159,111,0,48,1221,80,1141
360810424001,36, New York,081, Queens County,215,63,17,9,37,0,0,0,0,0,215,63,17,9,37,647,6,641
360810424002,36, New York,081, Queens County,301,140,52,6,82,14,0,0,0,0,287,140,52,6,82,639,40,599
360810424003,36, New York,081, Queens County,112,37,17,0,20,0,0,0,0,0,112,37,17,0,20,621,91,530
360810426001,36, New York,081, Queens County,0,0,0,0,0,0,0,0,0,0,0,0,0,0,0,156,138,18
360810427001,36, New York,081, Queens County,525,327,89,0,238,215,215,13,0,202,310,112,76,0,36,745,246,499
360810427002,36, New York,081, Queens County,630,242,182,1,59,41,28,28,0,0,589,214,154,1,59,1442,149,1293
360810432001,36, New York,081, Queens County,294,156,70,0,86,28,28,13,0,15,266,128,57,0,71,903,44,859
360810434001,36, New York,081, Queens County,384,172,80,18,74,29,7,7,0,0,355,165,73,18,74,1154,93,1061
360810437011,36, New York,081, Queens County,303,176,90,43,43,80,80,0,39,41,223,96,90,4,2,492,37,455
360810437012,36, New York,081, Queens County,370,160,100,0,60,20,10,0,0,10,350,150,100,0,50,930,97,833
360810437021,36, New York,081, Queens County,785,219,167,0,52,49,30,0,0,30,736,189,167,0,22,1803,84,1719
360810437022,36, New York,081, Queens County,590,357,293,0,64,89,29,0,0,29,501,328,293,0,35,959,165,794
360810437023,36, New York,081, Queens County,368,234,168,50,16,20,0,0,0,0,348,234,168,50,16,627,96,531
360810439001,36, New York,081, Queens County,439,181,49,103,29,44,44,0,44,0,395,137,49,59,29,862,68,794
360810439002,36, New York,081, Queens County,241,171,107,16,48,73,73,57,16,0,168,98,50,0,48,431,173,258
360810440001,36, New York,081, Queens County,280,257,122,26,109,63,53,11,0,42,217,204,111,26,67,792,118,674
360810440002,36, New York,081, Queens County,161,30,0,0,30,0,0,0,0,0,161,30,0,0,30,509,112,397
360810440003,36, New York,081, Queens County,368,198,165,0,33,0,0,0,0,0,368,198,165,0,33,1089,42,1047
360810443011,36, New York,081, Queens County,348,213,142,45,26,12,12,12,0,0,336,201,130,45,26,861,204,657
360810443012,36, New York,081, Queens County,383,177,62,0,115,97,84,0,0,84,286,93,62,0,31,1023,314,709
360810443021,36, New York,081, Queens County,185,106,80,26,0,6,6,0,6,0,179,100,80,20,0,593,73,520
360810443022,36, New York,081, Queens County,158,31,31,0,0,12,0,0,0,0,146,31,31,0,0,280,58,222
360810443023,36, New York,081, Queens County,636,390,288,34,68,123,64,64,0,0,513,326,224,34,68,1373,162,1211
360810444001,36, New York,081, Queens County,210,130,74,9,47,36,36,12,0,24,174,94,62,9,23,872,219,653
360810444002,36, New York,081, Queens County,337,137,89,4,44,58,12,0,0,12,279,125,89,4,32,849,312,537
360810444003,36, New York,081, Queens County,175,87,87,0,0,9,9,9,0,0,166,78,78,0,0,437,30,407
360810446011,36, New York,081, Queens County,496,156,28,22,106,31,0,0,0,0,465,156,28,22,106,1364,196,1168
360810446012,36, New York,081, Queens County,340,305,255,23,27,63,62,45,0,17,277,243,210,23,10,674,108,566
360810446021,36, New York,081, Queens County,505,280,153,39,88,97,85,53,0,32,408,195,100,39,56,1143,242,901
360810446022,36, New York,081, Queens County,489,208,153,0,55,100,97,76,0,21,389,111,77,0,34,897,416,481
360810446023,36, New York,081, Queens County,239,89,71,0,18,32,32,32,0,0,207,57,39,0,18,522,126,396
360810448001,36, New York,081, Queens County,320,118,93,18,7,24,6,6,0,0,296,112,87,18,7,850,83,767
360810448002,36, New York,081, Queens County,204,103,92,0,11,46,46,41,0,5,158,57,51,0,6,521,94,427
360810450001,36, New York,081, Queens County,142,68,63,0,5,0,0,0,0,0,142,68,63,0,5,430,27,403
360810450002,36, New York,081, Queens County,526,394,378,4,12,27,0,0,0,0,499,394,378,4,12,947,83,864
360810452001,36, New York,081, Queens County,192,80,80,0,0,20,0,0,0,0,172,80,80,0,0,610,82,528
360810454001,36, New York,081, Queens County,372,183,141,0,42,55,21,21,0,0,317,162,120,0,42,919,78,841
360810454002,36, New York,081, Queens County,959,407,234,0,173,97,34,34,0,0,862,373,200,0,173,1794,410,1384
360810455001,36, New York,081, Queens County,871,328,328,0,0,83,0,0,0,0,788,328,328,0,0,2029,143,1886
360810455002,36, New York,081, Queens County,842,336,168,78,90,290,182,92,0,90,552,154,76,78,0,1575,495,1080
360810455003,36, New York,081, Queens County,393,163,46,0,117,19,19,0,0,19,374,144,46,0,98,1430,88,1342
360810455004,36, New York,081, Queens County,352,183,140,0,43,63,63,63,0,0,289,120,77,0,43,1124,193,931
360810455005,36, New York,081, Queens County,675,373,343,0,30,113,52,52,0,0,562,321,291,0,30,1390,202,1188
360810455006,36, New York,081, Queens County,0,0,0,0,0,0,0,0,0,0,0,0,0,0,0,0,0,0
360810456001,36, New York,081, Queens County,359,169,165,0,4,22,9,5,0,4,337,160,160,0,0,795,63,732
360810457001,36, New York,081, Queens County,432,197,87,12,98,0,0,0,0,0,432,197,87,12,98,853,72,781
360810457002,36, New York,081, Queens County,500,210,106,51,53,51,43,0,43,0,449,167,106,8,53,930,69,861
360810458001,36, New York,081, Queens County,567,361,344,0,17,23,8,8,0,0,544,353,336,0,17,1359,82,1277
360810459001,36, New York,081, Queens County,419,268,251,0,17,5,0,0,0,0,414,268,251,0,17,994,98,896
360810459002,36, New York,081, Queens County,292,213,164,0,49,21,15,15,0,0,271,198,149,0,49,411,30,381
360810460001,36, New York,081, Queens County,397,198,101,46,51,0,0,0,0,0,397,198,101,46,51,1198,102,1096
360810460002,36, New York,081, Queens County,426,227,187,0,40,0,0,0,0,0,426,227,187,0,40,1062,40,1022
360810460003,36, New York,081, Queens County,613,229,103,33,93,135,88,18,33,37,478,141,85,0,56,1639,247,1392
360810461001,36, New York,081, Queens County,314,162,131,18,13,20,13,13,0,0,294,149,118,18,13,504,98,406
360810461002,36, New York,081, Queens County,194,54,26,28,0,3,3,0,3,0,191,51,26,25,0,408,37,371
360810462001,36, New York,081, Queens County,495,128,38,24,66,0,0,0,0,0,495,128,38,24,66,1307,176,1131
360810462002,36, New York,081, Queens County,530,237,157,0,80,34,25,0,0,25,496,212,157,0,55,1282,55,1227
360810462003,36, New York,081, Queens County,470,320,315,0,5,5,5,0,0,5,465,315,315,0,0,1068,0,1068
360810463001,36, New York,081, Queens County,400,287,204,18,65,0,0,0,0,0,400,287,204,18,65,479,17,462
360810463002,36, New York,081, Queens County,431,245,170,39,36,94,31,8,0,23,337,214,162,39,13,821,125,696
360810464001,36, New York,081, Queens County,444,222,184,31,7,11,3,3,0,0,433,219,181,31,7,1136,92,1044
360810465001,36, New York,081, Queens County,308,217,130,0,87,24,0,0,0,0,284,217,130,0,87,692,66,626
360810465002,36, New York,081, Queens County,549,338,173,16,149,103,71,0,0,71,446,267,173,16,78,844,89,755
360810466001,36, New York,081, Queens County,494,350,228,9,113,120,120,60,0,60,374,230,168,9,53,1280,183,1097
360810466002,36, New York,081, Queens County,481,239,137,55,47,29,29,29,0,0,452,210,108,55,47,1128,120,1008
360810467001,36, New York,081, Queens County,277,138,103,0,35,0,0,0,0,0,277,138,103,0,35,719,60,659
360810467002,36, New York,081, Queens County,506,286,222,0,64,77,64,0,0,64,429,222,222,0,0,907,236,671
360810467003,36, New York,081, Queens County,447,296,247,0,49,0,0,0,0,0,447,296,247,0,49,962,0,962
360810467004,36, New York,081, Queens County,224,116,84,0,32,0,0,0,0,0,224,116,84,0,32,379,0,379
360810468001,36, New York,081, Queens County,378,222,95,27,100,44,44,0,20,24,334,178,95,7,76,780,91,689
360810468002,36, New York,081, Queens County,470,183,132,12,39,39,39,0,0,39,431,144,132,12,0,1503,55,1448
360810469011,36, New York,081, Queens County,137,99,99,0,0,0,0,0,0,0,137,99,99,0,0,332,10,322
360810469012,36, New York,081, Queens County,349,163,163,0,0,11,7,7,0,0,338,156,156,0,0,1570,220,1350
360810469013,36, New York,081, Queens County,439,258,217,28,13,39,6,6,0,0,400,252,211,28,13,622,88,534
360810469021,36, New York,081, Queens County,603,245,167,27,51,66,48,10,23,15,537,197,157,4,36,1094,102,992
360810469022,36, New York,081, Queens County,346,95,80,15,0,62,54,39,15,0,284,41,41,0,0,566,29,537
360810470001,36, New York,081, Queens County,304,143,106,21,16,30,30,30,0,0,274,113,76,21,16,1050,57,993
360810470002,36, New York,081, Queens County,568,308,127,0,181,242,187,6,0,181,326,121,121,0,0,1222,313,909
360810471001,36, New York,081, Queens County,666,258,184,8,66,23,0,0,0,0,643,258,184,8,66,1202,77,1125
360810471002,36, New York,081, Queens County,478,226,139,50,37,60,47,21,0,26,418,179,118,50,11,971,43,928
360810472001,36, New York,081, Queens County,206,52,52,0,0,0,0,0,0,0,206,52,52,0,0,589,0,589
360810472002,36, New York,081, Queens County,568,175,175,0,0,32,23,23,0,0,536,152,152,0,0,1227,78,1149
360810472003,36, New York,081, Queens County,261,101,78,0,23,9,0,0,0,0,252,101,78,0,23,756,35,721
360810473001,36, New York,081, Queens County,261,162,162,0,0,0,0,0,0,0,261,162,162,0,0,610,91,519
360810473002,36, New York,081, Queens County,368,151,126,25,0,0,0,0,0,0,368,151,126,25,0,703,52,651
360810473003,36, New York,081, Queens County,356,213,184,0,29,11,0,0,0,0,345,213,184,0,29,756,60,696
360810475001,36, New York,081, Queens County,586,255,162,1,92,56,47,23,0,24,530,208,139,1,68,964,51,913
360810475002,36, New York,081, Queens County,728,234,225,0,9,64,41,32,0,9,664,193,193,0,0,1495,85,1410
360810476001,36, New York,081, Queens County,193,19,19,0,0,22,0,0,0,0,171,19,19,0,0,629,65,564
360810476002,36, New York,081, Queens County,201,52,52,0,0,0,0,0,0,0,201,52,52,0,0,563,16,547
360810478011,36, New York,081, Queens County,354,48,48,0,0,43,0,0,0,0,311,48,48,0,0,1440,246,1194
360810478012,36, New York,081, Queens County,469,143,130,13,0,97,13,0,13,0,372,130,130,0,0,1350,439,911
360810478021,36, New York,081, Queens County,332,112,84,0,28,26,0,0,0,0,306,112,84,0,28,758,58,700
360810479001,36, New York,081, Queens County,821,385,315,22,48,59,58,45,0,13,762,327,270,22,35,1198,62,1136
360810479002,36, New York,081, Queens County,135,94,46,26,22,0,0,0,0,0,135,94,46,26,22,376,99,277
360810479003,36, New York,081, Queens County,505,224,184,14,26,77,76,76,0,0,428,148,108,14,26,854,32,822
360810480001,36, New York,081, Queens County,425,86,81,0,5,0,0,0,0,0,425,86,81,0,5,1192,27,1165
360810480002,36, New York,081, Queens County,160,59,59,0,0,24,24,24,0,0,136,35,35,0,0,490,4,486
360810481001,36, New York,081, Queens County,281,162,16,0,146,80,61,0,0,61,201,101,16,0,85,374,67,307
360810481002,36, New York,081, Queens County,536,228,114,60,54,35,9,0,0,9,501,219,114,60,45,971,77,894
360810481003,36, New York,081, Queens County,259,65,34,0,31,147,0,0,0,0,112,65,34,0,31,304,38,266
360810481004,36, New York,081, Queens County,439,112,112,0,0,0,0,0,0,0,439,112,112,0,0,1299,67,1232
360810482001,36, New York,081, Queens County,328,81,49,15,17,19,12,12,0,0,309,69,37,15,17,974,117,857
360810483011,36, New York,081, Queens County,621,314,148,43,123,123,118,22,0,96,498,196,126,43,27,985,71,914
360810483021,36, New York,081, Queens County,388,259,152,81,26,28,23,0,23,0,360,236,152,58,26,831,103,728
360810484001,36, New York,081, Queens County,328,88,61,12,15,0,0,0,0,0,328,88,61,12,15,1151,22,1129
360810484002,36, New York,081, Queens County,170,142,78,28,36,29,29,0,0,29,141,113,78,28,7,422,25,397
360810484003,36, New York,081, Queens County,308,124,94,13,17,7,7,0,0,7,301,117,94,13,10,808,22,786
360810484004,36, New York,081, Queens County,318,134,83,40,11,55,0,0,0,0,263,134,83,40,11,1093,148,945
360810485001,36, New York,081, Queens County,115,81,81,0,0,7,7,7,0,0,108,74,74,0,0,224,49,175
360810485002,36, New York,081, Queens County,389,196,90,39,67,51,50,0,39,11,338,146,90,0,56,1063,29,1034
360810485003,36, New York,081, Queens County,543,168,167,0,1,10,1,0,0,1,533,167,167,0,0,1346,87,1259
360810489001,36, New York,081, Queens County,157,98,34,0,64,29,22,0,0,22,128,76,34,0,42,296,55,241
360810489002,36, New York,081, Queens County,278,62,44,0,18,29,8,8,0,0,249,54,36,0,18,258,46,212
360810492011,36, New York,081, Queens County,494,280,58,59,163,0,0,0,0,0,494,280,58,59,163,1114,66,1048
360810492012,36, New York,081, Queens County,289,126,77,24,25,13,13,0,0,13,276,113,77,24,12,893,91,802
360810492021,36, New York,081, Queens County,499,209,197,0,12,1,1,1,0,0,498,208,196,0,12,1709,59,1650
360810493011,36, New York,081, Queens County,283,111,84,0,27,1,1,1,0,0,282,110,83,0,27,714,54,660
360810493012,36, New York,081, Queens County,300,151,151,0,0,79,62,62,0,0,221,89,89,0,0,595,81,514
360810493021,36, New York,081, Queens County,199,120,32,74,14,11,11,11,0,0,188,109,21,74,14,497,87,410
360810493022,36, New York,081, Queens County,290,174,123,5,46,41,32,0,0,32,249,142,123,5,14,995,107,888
360810495001,36, New York,081, Queens County,377,161,106,26,29,26,26,0,10,16,351,135,106,16,13,1012,83,929
360810496001,36, New York,081, Queens County,361,126,107,0,19,17,11,11,0,0,344,115,96,0,19,1229,41,1188
360810496002,36, New York,081, Queens County,310,20,19,1,0,1,1,0,1,0,309,19,19,0,0,818,18,800
360810496003,36, New York,081, Queens County,119,17,5,0,12,30,12,0,0,12,89,5,5,0,0,387,99,288
360810497001,36, New York,081, Queens County,455,220,125,0,95,0,0,0,0,0,455,220,125,0,95,1034,73,961
360810497002,36, New York,081, Queens County,251,147,134,13,0,7,7,7,0,0,244,140,127,13,0,715,62,653
360810499001,36, New York,081, Queens County,0,0,0,0,0,0,0,0,0,0,0,0,0,0,0,0,0,0
360810499002,36, New York,081, Queens County,397,159,142,11,6,41,6,0,0,6,356,153,142,11,0,1133,122,1011
360810499003,36, New York,081, Queens County,404,204,127,70,7,0,0,0,0,0,404,204,127,70,7,1150,103,1047
360810499004,36, New York,081, Queens County,345,157,128,0,29,22,22,22,0,0,323,135,106,0,29,827,43,784
360810500001,36, New York,081, Queens County,243,74,66,0,8,0,0,0,0,0,243,74,66,0,8,913,20,893
360810500002,36, New York,081, Queens County,781,425,132,98,195,23,10,0,0,10,758,415,132,98,185,2006,141,1865
360810502011,36, New York,081, Queens County,385,84,60,11,13,22,22,16,0,6,363,62,44,11,7,1087,50,1037
360810502021,36, New York,081, Queens County,328,134,74,17,43,43,32,0,0,32,285,102,74,17,11,942,107,835
360810504001,36, New York,081, Queens County,293,166,114,16,36,28,0,0,0,0,265,166,114,16,36,696,70,626
360810504002,36, New York,081, Queens County,170,95,32,17,46,17,17,0,17,0,153,78,32,0,46,442,38,404
360810505001,36, New York,081, Queens County,460,242,188,43,11,21,3,0,0,3,439,239,188,43,8,1181,81,1100
360810506001,36, New York,081, Queens County,131,10,10,0,0,0,0,0,0,0,131,10,10,0,0,465,3,462
360810506002,36, New York,081, Queens County,228,71,48,0,23,33,18,18,0,0,195,53,30,0,23,614,41,573
360810507001,36, New York,081, Queens County,478,253,218,14,21,32,32,32,0,0,446,221,186,14,21,1091,128,963
360810507002,36, New York,081, Queens County,440,105,87,14,4,5,4,0,0,4,435,101,87,14,0,1166,17,1149
360810508001,36, New York,081, Queens County,199,74,25,0,49,29,29,14,0,15,170,45,11,0,34,709,111,598
360810508002,36, New York,081, Queens County,189,61,56,5,0,5,5,0,5,0,184,56,56,0,0,621,53,568
360810510001,36, New York,081, Queens County,226,138,97,0,41,17,12,0,0,12,209,126,97,0,29,734,86,648
360810510002,36, New York,081, Queens County,139,64,7,0,57,18,18,0,0,18,121,46,7,0,39,507,55,452
360810511001,36, New York,081, Queens County,365,105,96,0,9,11,7,7,0,0,354,98,89,0,9,1167,42,1125
360810511002,36, New York,081, Queens County,289,114,54,36,24,39,24,0,0,24,250,90,54,36,0,704,57,647
360810512001,36, New York,081, Queens County,251,98,58,23,17,16,16,16,0,0,235,82,42,23,17,935,65,870
360810512002,36, New York,081, Queens County,228,52,6,26,20,8,0,0,0,0,220,52,6,26,20,675,33,642
360810512003,36, New York,081, Queens County,115,53,40,0,13,0,0,0,0,0,115,53,40,0,13,496,36,460
360810513001,36, New York,081, Queens County,296,150,127,0,23,34,14,0,0,14,262,136,127,0,9,1029,185,844
360810513002,36, New York,081, Queens County,271,129,81,39,9,25,25,0,16,9,246,104,81,23,0,627,34,593
360810515001,36, New York,081, Queens County,306,191,142,0,49,0,0,0,0,0,306,191,142,0,49,707,9,698
360810515002,36, New York,081, Queens County,404,242,182,0,60,19,7,0,0,7,385,235,182,0,53,866,67,799
360810515003,36, New York,081, Queens County,197,102,82,0,20,0,0,0,0,0,197,102,82,0,20,516,0,516
360810516001,36, New York,081, Queens County,250,130,64,6,60,27,6,0,6,0,223,124,64,0,60,547,116,431
360810516002,36, New York,081, Queens County,231,81,68,0,13,0,0,0,0,0,231,81,68,0,13,668,23,645
360810517001,36, New York,081, Queens County,161,71,49,0,22,0,0,0,0,0,161,71,49,0,22,561,50,511
360810517002,36, New York,081, Queens County,312,104,57,11,36,9,4,0,4,0,303,100,57,7,36,820,52,768
360810518001,36, New York,081, Queens County,180,19,2,0,17,0,0,0,0,0,180,19,2,0,17,557,47,510
360810518002,36, New York,081, Queens County,331,207,59,0,148,43,43,0,0,43,288,164,59,0,105,1129,89,1040
360810520001,36, New York,081, Queens County,321,118,53,4,61,12,0,0,0,0,309,118,53,4,61,1023,56,967
360810521001,36, New York,081, Queens County,172,87,55,0,32,0,0,0,0,0,172,87,55,0,32,418,0,418
360810521002,36, New York,081, Queens County,350,122,51,0,71,35,28,6,0,22,315,94,45,0,49,1029,80,949
360810522001,36, New York,081, Queens County,404,208,133,27,48,68,56,17,27,12,336,152,116,0,36,1178,139,1039
360810524001,36, New York,081, Queens County,183,63,26,0,37,0,0,0,0,0,183,63,26,0,37,709,53,656
360810524002,36, New York,081, Queens County,256,172,86,12,74,28,24,16,0,8,228,148,70,12,66,812,145,667
360810525001,36, New York,081, Queens County,407,145,138,0,7,20,14,7,0,7,387,131,131,0,0,1003,41,962
360810525002,36, New York,081, Queens County,185,89,75,0,14,26,20,20,0,0,159,69,55,0,14,533,67,466
360810526001,36, New York,081, Queens County,240,69,34,16,19,9,9,9,0,0,231,60,25,16,19,778,72,706
360810526002,36, New York,081, Queens County,200,81,55,15,11,0,0,0,0,0,200,81,55,15,11,1026,0,1026
360810528001,36, New York,081, Queens County,322,118,75,0,43,21,0,0,0,0,301,118,75,0,43,1087,92,995
360810530001,36, New York,081, Queens County,224,71,16,0,55,0,0,0,0,0,224,71,16,0,55,696,15,681
360810530002,36, New York,081, Queens County,350,148,89,11,48,20,11,0,11,0,330,137,89,0,48,1251,98,1153
360810531001,36, New York,081, Queens County,588,258,141,64,53,10,10,0,10,0,578,248,141,54,53,1505,39,1466
360810531002,36, New York,081, Queens County,214,52,36,0,16,16,16,0,0,16,198,36,36,0,0,524,49,475
360810531003,36, New York,081, Queens County,136,28,15,13,0,15,15,15,0,0,121,13,0,13,0,212,41,171
360810532001,36, New York,081, Queens County,264,169,102,12,55,5,5,0,5,0,259,164,102,7,55,736,72,664
360810532002,36, New York,081, Queens County,269,118,86,0,32,14,14,14,0,0,255,104,72,0,32,740,53,687
360810534011,36, New York,081, Queens County,228,51,33,0,18,0,0,0,0,0,228,51,33,0,18,731,14,717
360810534012,36, New York,081, Queens County,224,125,94,4,27,0,0,0,0,0,224,125,94,4,27,691,19,672
360810535011,36, New York,081, Queens County,341,113,81,16,16,25,25,25,0,0,316,88,56,16,16,875,92,783
360810535021,36, New York,081, Queens County,0,0,0,0,0,0,0,0,0,0,0,0,0,0,0,0,0,0
360810536011,36, New York,081, Queens County,264,103,66,7,30,0,0,0,0,0,264,103,66,7,30,1116,278,838
360810536012,36, New York,081, Queens County,130,35,17,0,18,0,0,0,0,0,130,35,17,0,18,411,7,404
360810538001,36, New York,081, Queens County,186,77,49,21,7,15,10,10,0,0,171,67,39,21,7,552,42,510
360810538002,36, New York,081, Queens County,197,80,11,19,50,20,14,0,0,14,177,66,11,19,36,641,65,576
360810539011,36, New York,081, Queens County,178,49,35,0,14,0,0,0,0,0,178,49,35,0,14,546,62,484
360810539012,36, New York,081, Queens County,429,231,178,34,19,46,19,19,0,0,383,212,159,34,19,1907,178,1729
360810539013,36, New York,081, Queens County,189,104,30,0,74,0,0,0,0,0,189,104,30,0,74,794,51,743
360810539021,36, New York,081, Queens County,32,24,24,0,0,0,0,0,0,0,32,24,24,0,0,97,0,97
360810540001,36, New York,081, Queens County,353,45,31,14,0,25,0,0,0,0,328,45,31,14,0,1315,189,1126
360810540002,36, New York,081, Queens County,263,103,62,0,41,29,29,0,0,29,234,74,62,0,12,672,142,530
360810540003,36, New York,081, Queens County,264,145,49,29,67,49,33,0,0,33,215,112,49,29,34,773,154,619
360810542001,36, New York,081, Queens County,257,71,46,0,25,1,0,0,0,0,256,71,46,0,25,717,51,666
360810542002,36, New York,081, Queens County,294,182,155,8,19,0,0,0,0,0,294,182,155,8,19,852,0,852
360810542003,36, New York,081, Queens County,454,196,108,29,59,91,80,21,0,59,363,116,87,29,0,1000,139,861
360810542004,36, New York,081, Queens County,407,22,22,0,0,33,0,0,0,0,374,22,22,0,0,1023,78,945
360810545001,36, New York,081, Queens County,283,65,30,0,35,13,13,0,0,13,270,52,30,0,22,907,92,815
360810545002,36, New York,081, Queens County,238,154,88,66,0,10,10,10,0,0,228,144,78,66,0,472,38,434
360810545003,36, New York,081, Queens County,360,165,109,45,11,10,0,0,0,0,350,165,109,45,11,845,86,759
360810547001,36, New York,081, Queens County,383,210,142,0,68,0,0,0,0,0,383,210,142,0,68,1233,43,1190
360810547002,36, New York,081, Queens County,250,93,56,0,37,0,0,0,0,0,250,93,56,0,37,859,56,803
360810547003,36, New York,081, Queens County,329,80,33,0,47,39,39,0,0,39,290,41,33,0,8,855,190,665
360810548001,36, New York,081, Queens County,272,123,99,6,18,0,0,0,0,0,272,123,99,6,18,624,24,600
360810548002,36, New York,081, Queens County,359,131,111,3,17,33,24,16,0,8,326,107,95,3,9,998,58,940
360810549001,36, New York,081, Queens County,258,130,43,0,87,81,68,0,0,68,177,62,43,0,19,678,85,593
360810549002,36, New York,081, Queens County,360,228,180,0,48,54,24,0,0,24,306,204,180,0,24,635,30,605
360810549003,36, New York,081, Queens County,246,114,81,0,33,19,9,0,0,9,227,105,81,0,24,725,75,650
360810549004,36, New York,081, Queens County,199,52,21,0,31,1,0,0,0,0,198,52,21,0,31,595,39,556
360810551001,36, New York,081, Queens County,111,81,81,0,0,0,0,0,0,0,111,81,81,0,0,391,40,351
360810551002,36, New York,081, Queens County,203,105,64,0,41,0,0,0,0,0,203,105,64,0,41,662,140,522
360810551003,36, New York,081, Queens County,287,117,95,0,22,4,4,4,0,0,283,113,91,0,22,685,79,606
360810551004,36, New York,081, Queens County,248,155,126,0,29,67,30,30,0,0,181,125,96,0,29,866,274,592
360810552001,36, New York,081, Queens County,407,176,63,47,66,32,32,23,0,9,375,144,40,47,57,936,126,810
360810552002,36, New York,081, Queens County,291,63,63,0,0,0,0,0,0,0,291,63,63,0,0,965,0,965
360810553001,36, New York,081, Queens County,343,158,84,0,74,24,13,0,0,13,319,145,84,0,61,799,143,656
360810553002,36, New York,081, Queens County,301,129,79,0,50,29,29,23,0,6,272,100,56,0,44,815,149,666
360810554001,36, New York,081, Queens County,293,111,102,0,9,12,0,0,0,0,281,111,102,0,9,868,183,685
360810554002,36, New York,081, Queens County,308,113,70,18,25,10,5,5,0,0,298,108,65,18,25,775,23,752
360810555001,36, New York,081, Queens County,134,65,27,25,13,13,13,13,0,0,121,52,14,25,13,509,36,473
360810555002,36, New York,081, Queens County,292,181,117,0,64,26,26,5,0,21,266,155,112,0,43,843,105,738
360810556001,36, New York,081, Queens County,351,206,185,4,17,8,8,0,0,8,343,198,185,4,9,1006,28,978
360810556002,36, New York,081, Queens County,292,115,66,5,44,53,28,0,5,23,239,87,66,0,21,723,50,673
360810557001,36, New York,081, Queens County,379,179,140,29,10,0,0,0,0,0,379,179,140,29,10,1093,56,1037
360810557002,36, New York,081, Queens County,223,87,83,0,4,14,14,14,0,0,209,73,69,0,4,880,90,790
360810557003,36, New York,081, Queens County,199,59,19,31,9,10,10,0,10,0,189,49,19,21,9,734,72,662
360810558001,36, New York,081, Queens County,284,94,67,0,27,26,26,5,0,21,258,68,62,0,6,734,30,704
360810558002,36, New York,081, Queens County,217,60,48,12,0,18,0,0,0,0,199,60,48,12,0,691,34,657
360810559001,36, New York,081, Queens County,238,99,37,0,62,53,24,3,0,21,185,75,34,0,41,703,119,584
360810560001,36, New York,081, Queens County,199,77,47,0,30,18,14,8,0,6,181,63,39,0,24,490,36,454
360810560002,36, New York,081, Queens County,180,67,64,0,3,0,0,0,0,0,180,67,64,0,3,384,0,384
360810561001,36, New York,081, Queens County,7,0,0,0,0,0,0,0,0,0,7,0,0,0,0,11,0,11
360810562001,36, New York,081, Queens County,311,106,89,0,17,2,2,2,0,0,309,104,87,0,17,1084,14,1070
360810564001,36, New York,081, Queens County,296,91,77,0,14,20,12,12,0,0,276,79,65,0,14,1037,63,974
360810565001,36, New York,081, Queens County,368,152,102,14,36,3,0,0,0,0,365,152,102,14,36,1167,62,1105
360810566001,36, New York,081, Queens County,263,62,57,0,5,91,0,0,0,0,172,62,57,0,5,703,218,485
360810566002,36, New York,081, Queens County,119,29,29,0,0,27,0,0,0,0,92,29,29,0,0,311,63,248
360810567001,36, New York,081, Queens County,216,88,57,19,12,0,0,0,0,0,216,88,57,19,12,597,0,597
360810567002,36, New York,081, Queens County,278,47,47,0,0,0,0,0,0,0,278,47,47,0,0,769,9,760
360810567003,36, New York,081, Queens County,408,258,104,72,82,58,58,0,0,58,350,200,104,72,24,717,24,693
360810567004,36, New York,081, Queens County,297,146,122,0,24,0,0,0,0,0,297,146,122,0,24,917,22,895
360810568001,36, New York,081, Queens County,628,157,138,7,12,40,0,0,0,0,588,157,138,7,12,1652,228,1424
360810568002,36, New York,081, Queens County,254,29,14,0,15,0,0,0,0,0,254,29,14,0,15,839,7,832
360810568003,36, New York,081, Queens County,154,67,58,0,9,0,0,0,0,0,154,67,58,0,9,430,11,419
360810568004,36, New York,081, Queens County,252,74,74,0,0,0,0,0,0,0,252,74,74,0,0,801,38,763
360810577001,36, New York,081, Queens County,229,128,128,0,0,31,31,31,0,0,198,97,97,0,0,553,35,518
360810577002,36, New York,081, Queens County,359,202,114,29,59,26,26,0,0,26,333,176,114,29,33,901,282,619
360810577003,36, New York,081, Queens County,430,88,44,0,44,7,0,0,0,0,423,88,44,0,44,1153,15,1138
360810579001,36, New York,081, Queens County,201,67,27,9,31,25,25,16,0,9,176,42,11,9,22,618,33,585
360810579002,36, New York,081, Queens County,167,61,21,7,33,4,4,0,0,4,163,57,21,7,29,445,35,410
360810580001,36, New York,081, Queens County,186,115,41,34,40,12,0,0,0,0,174,115,41,34,40,660,154,506
360810580002,36, New York,081, Queens County,224,66,36,20,10,0,0,0,0,0,224,66,36,20,10,958,0,958
360810580003,36, New York,081, Queens County,334,179,145,0,34,0,0,0,0,0,334,179,145,0,34,974,2,972
360810580004,36, New York,081, Queens County,134,65,0,33,32,0,0,0,0,0,134,65,0,33,32,343,0,343
360810581001,36, New York,081, Queens County,252,123,104,19,0,13,13,13,0,0,239,110,91,19,0,748,86,662
360810581002,36, New York,081, Queens County,531,261,91,0,170,0,0,0,0,0,531,261,91,0,170,1433,95,1338
360810582001,36, New York,081, Queens County,480,273,181,0,92,0,0,0,0,0,480,273,181,0,92,1471,37,1434
360810582002,36, New York,081, Queens County,638,241,99,142,0,41,41,17,24,0,597,200,82,118,0,1330,136,1194
360810582003,36, New York,081, Queens County,246,84,44,15,25,0,0,0,0,0,246,84,44,15,25,713,0,713
360810583001,36, New York,081, Queens County,383,168,84,7,77,0,0,0,0,0,383,168,84,7,77,920,27,893
360810583002,36, New York,081, Queens County,405,173,74,37,62,37,37,0,37,0,368,136,74,0,62,926,78,848
360810583003,36, New York,081, Queens County,182,68,42,0,26,26,26,0,0,26,156,42,42,0,0,723,35,688
360810585001,36, New York,081, Queens County,342,134,94,0,40,69,62,22,0,40,273,72,72,0,0,1153,65,1088
360810585002,36, New York,081, Queens County,295,135,95,22,18,9,9,0,0,9,286,126,95,22,9,1101,47,1054
360810585003,36, New York,081, Queens County,417,135,116,19,0,46,0,0,0,0,371,135,116,19,0,961,193,768
360810587001,36, New York,081, Queens County,361,148,83,11,54,0,0,0,0,0,361,148,83,11,54,930,21,909
360810587002,36, New York,081, Queens County,163,39,39,0,0,8,8,8,0,0,155,31,31,0,0,304,16,288
360810587003,36, New York,081, Queens County,273,88,45,0,43,40,21,0,0,21,233,67,45,0,22,734,102,632
360810589001,36, New York,081, Queens County,333,148,124,0,24,75,11,0,0,11,258,137,124,0,13,850,167,683
360810589002,36, New York,081, Queens County,446,173,62,38,73,23,23,10,0,13,423,150,52,38,60,1288,53,1235
360810589003,36, New York,081, Queens County,189,141,32,21,88,95,70,0,0,70,94,71,32,21,18,951,217,734
360810590001,36, New York,081, Queens County,296,99,77,0,22,8,0,0,0,0,288,99,77,0,22,790,91,699
360810591001,36, New York,081, Queens County,404,230,126,26,78,26,26,0,26,0,378,204,126,0,78,707,0,707
360810591002,36, New York,081, Queens County,100,73,73,0,0,0,0,0,0,0,100,73,73,0,0,672,178,494
360810591003,36, New York,081, Queens County,352,96,48,0,48,0,0,0,0,0,352,96,48,0,48,1028,35,993
360810591004,36, New York,081, Queens County,349,223,152,0,71,106,106,99,0,7,243,117,53,0,64,842,81,761
360810592001,36, New York,081, Queens County,334,137,92,5,40,50,19,4,0,15,284,118,88,5,25,1167,192,975
360810593001,36, New York,081, Queens County,353,144,113,5,26,108,26,0,0,26,245,118,113,5,0,968,318,650
360810593002,36, New York,081, Queens County,575,216,98,9,109,47,10,0,0,10,528,206,98,9,99,1669,131,1538
360810594001,36, New York,081, Queens County,262,55,26,0,29,0,0,0,0,0,262,55,26,0,29,776,0,776
360810594002,36, New York,081, Queens County,224,73,42,0,31,0,0,0,0,0,224,73,42,0,31,638,0,638
360810595011,36, New York,081, Queens County,267,131,71,31,29,51,29,0,0,29,216,102,71,31,0,476,88,388
360810595012,36, New York,081, Queens County,216,26,25,1,0,33,0,0,0,0,183,26,25,1,0,618,44,574
360810595021,36, New York,081, Queens County,497,234,85,4,145,80,80,5,0,75,417,154,80,4,70,1204,14,1190
360810595022,36, New York,081, Queens County,300,211,127,62,22,45,31,9,0,22,255,180,118,62,0,486,105,381
360810596001,36, New York,081, Queens County,174,57,32,0,25,0,0,0,0,0,174,57,32,0,25,571,27,544
360810596002,36, New York,081, Queens County,195,86,48,38,0,0,0,0,0,0,195,86,48,38,0,716,53,663
360810598001,36, New York,081, Queens County,152,118,32,48,38,14,14,0,0,14,138,104,32,48,24,381,14,367
360810598002,36, New York,081, Queens County,270,77,22,34,21,0,0,0,0,0,270,77,22,34,21,566,7,559
360810599001,36, New York,081, Queens County,179,56,33,0,23,38,23,0,0,23,141,33,33,0,0,574,57,517
360810599002,36, New York,081, Queens County,194,94,35,16,43,20,20,0,0,20,174,74,35,16,23,478,68,410
360810600001,36, New York,081, Queens County,316,90,90,0,0,22,17,17,0,0,294,73,73,0,0,794,74,720
360810601001,36, New York,081, Queens County,303,187,149,7,31,30,30,5,7,18,273,157,144,0,13,634,40,594
360810601002,36, New York,081, Queens County,223,75,57,0,18,19,13,0,0,13,204,62,57,0,5,509,35,474
360810603001,36, New York,081, Queens County,502,276,161,57,58,85,72,25,8,39,417,204,136,49,19,1217,134,1083
360810606001,36, New York,081, Queens County,216,43,8,0,35,22,0,0,0,0,194,43,8,0,35,540,98,442
360810606002,36, New York,081, Queens County,138,29,18,0,11,9,0,0,0,0,129,29,18,0,11,506,32,474
360810607011,36, New York,081, Queens County,0,0,0,0,0,0,0,0,0,0,0,0,0,0,0,14,0,14
360810608001,36, New York,081, Queens County,343,107,50,0,57,13,0,0,0,0,330,107,50,0,57,1154,98,1056
360810610001,36, New York,081, Queens County,375,115,76,14,25,20,20,0,14,6,355,95,76,0,19,1303,47,1256
360810612001,36, New York,081, Queens County,314,107,98,0,9,0,0,0,0,0,314,107,98,0,9,1042,0,1042
360810612002,36, New York,081, Queens County,161,37,19,0,18,0,0,0,0,0,161,37,19,0,18,647,32,615
360810613011,36, New York,081, Queens County,159,84,84,0,0,14,0,0,0,0,145,84,84,0,0,570,82,488
360810613012,36, New York,081, Queens County,297,116,92,24,0,11,0,0,0,0,286,116,92,24,0,816,153,663
360810613013,36, New York,081, Queens County,195,26,9,0,17,15,0,0,0,0,180,26,9,0,17,808,56,752
360810613014,36, New York,081, Queens County,380,209,82,89,38,59,38,0,0,38,321,171,82,89,0,887,144,743
360810613021,36, New York,081, Queens County,0,0,0,0,0,0,0,0,0,0,0,0,0,0,0,0,0,0
360810614001,36, New York,081, Queens County,362,200,141,6,53,6,6,0,6,0,356,194,141,0,53,1082,27,1055
360810616011,36, New York,081, Queens County,251,115,107,0,8,1,0,0,0,0,250,115,107,0,8,990,38,952
360810616012,36, New York,081, Queens County,165,112,60,0,52,0,0,0,0,0,165,112,60,0,52,526,16,510
360810616013,36, New York,081, Queens County,88,16,0,16,0,0,0,0,0,0,88,16,0,16,0,499,32,467
360810616021,36, New York,081, Queens County,150,28,10,12,6,6,0,0,0,0,144,28,10,12,6,479,25,454
360810616022,36, New York,081, Queens County,130,37,16,0,21,0,0,0,0,0,130,37,16,0,21,405,7,398
360810618001,36, New York,081, Queens County,149,37,23,0,14,0,0,0,0,0,149,37,23,0,14,551,32,519
360810618002,36, New York,081, Queens County,257,109,88,3,18,0,0,0,0,0,257,109,88,3,18,856,0,856
360810619001,36, New York,081, Queens County,643,518,279,110,129,158,158,14,38,106,485,360,265,72,23,1140,170,970
360810619002,36, New York,081, Queens County,218,0,0,0,0,0,0,0,0,0,218,0,0,0,0,923,19,904
360810620001,36, New York,081, Queens County,414,158,111,6,41,0,0,0,0,0,414,158,111,6,41,1126,35,1091
360810621001,36, New York,081, Queens County,272,96,64,14,18,15,6,6,0,0,257,90,58,14,18,601,28,573
360810621002,36, New York,081, Queens County,206,80,35,5,40,10,10,0,0,10,196,70,35,5,30,576,27,549
360810621003,36, New York,081, Queens County,335,237,105,64,68,11,11,11,0,0,324,226,94,64,68,662,38,624
360810622001,36, New York,081, Queens County,249,90,79,11,0,7,0,0,0,0,242,90,79,11,0,797,22,775
360810622002,36, New York,081, Queens County,210,39,24,5,10,11,5,0,5,0,199,34,24,0,10,814,75,739
360810623001,36, New York,081, Queens County,186,87,69,0,18,14,14,0,0,14,172,73,69,0,4,639,17,622
360810623002,36, New York,081, Queens County,387,135,120,0,15,88,0,0,0,0,299,135,120,0,15,903,152,751
360810624001,36, New York,081, Queens County,0,0,0,0,0,0,0,0,0,0,0,0,0,0,0,0,0,0
360810625001,36, New York,081, Queens County,285,112,94,0,18,16,9,0,0,9,269,103,94,0,9,689,41,648
360810625002,36, New York,081, Queens County,371,167,118,23,26,7,0,0,0,0,364,167,118,23,26,1128,90,1038
360810626001,36, New York,081, Queens County,160,92,49,33,10,0,0,0,0,0,160,92,49,33,10,549,15,534
360810626002,36, New York,081, Queens County,323,189,118,13,58,0,0,0,0,0,323,189,118,13,58,942,0,942
360810626003,36, New York,081, Queens County,170,33,23,0,10,0,0,0,0,0,170,33,23,0,10,619,37,582
360810627001,36, New York,081, Queens County,335,140,108,14,18,10,0,0,0,0,325,140,108,14,18,837,21,816
360810627002,36, New York,081, Queens County,472,163,91,23,49,24,12,0,0,12,448,151,91,23,37,1250,41,1209
360810629001,36, New York,081, Queens County,464,183,116,0,67,30,20,0,0,20,434,163,116,0,47,924,59,865
360810629002,36, New York,081, Queens County,262,148,148,0,0,26,26,26,0,0,236,122,122,0,0,528,82,446
360810629003,36, New York,081, Queens County,250,141,119,0,22,0,0,0,0,0,250,141,119,0,22,601,55,546
360810630001,36, New York,081, Queens County,269,143,107,0,36,0,0,0,0,0,269,143,107,0,36,640,32,608
360810630002,36, New York,081, Queens County,154,14,14,0,0,0,0,0,0,0,154,14,14,0,0,526,7,519
360810632001,36, New York,081, Queens County,274,100,54,0,46,12,12,0,0,12,262,88,54,0,34,946,67,879
360810632002,36, New York,081, Queens County,273,117,87,6,24,6,0,0,0,0,267,117,87,6,24,919,39,880
360810633011,36, New York,081, Queens County,403,236,144,21,71,0,0,0,0,0,403,236,144,21,71,1033,22,1011
360810633021,36, New York,081, Queens County,141,57,48,9,0,0,0,0,0,0,141,57,48,9,0,333,0,333
360810633022,36, New York,081, Queens County,334,268,152,54,62,37,37,0,0,37,297,231,152,54,25,954,118,836
360810635001,36, New York,081, Queens County,271,56,28,0,28,17,5,0,0,5,254,51,28,0,23,722,80,642
360810635002,36, New York,081, Queens County,429,192,60,0,132,33,5,0,0,5,396,187,60,0,127,1165,80,1085
360810637001,36, New York,081, Queens County,0,0,0,0,0,0,0,0,0,0,0,0,0,0,0,111,79,32
360810637002,36, New York,081, Queens County,329,203,151,0,52,27,27,27,0,0,302,176,124,0,52,559,0,559
360810637003,36, New York,081, Queens County,387,161,102,59,0,56,56,47,9,0,331,105,55,50,0,917,151,766
360810637004,36, New York,081, Queens County,322,82,65,0,17,27,0,0,0,0,295,82,65,0,17,805,95,710
360810638001,36, New York,081, Queens County,216,35,35,0,0,9,9,9,0,0,207,26,26,0,0,796,33,763
360810638002,36, New York,081, Queens County,106,30,0,0,30,59,0,0,0,0,47,30,0,0,30,164,35,129
360810638003,36, New York,081, Queens County,86,43,12,0,31,31,31,0,0,31,55,12,12,0,0,266,31,235
360810638004,36, New York,081, Queens County,239,64,43,0,21,0,0,0,0,0,239,64,43,0,21,795,10,785
360810638005,36, New York,081, Queens County,133,17,0,0,17,0,0,0,0,0,133,17,0,0,17,630,35,595
360810639001,36, New York,081, Queens County,507,150,136,0,14,0,0,0,0,0,507,150,136,0,14,1769,141,1628
360810639002,36, New York,081, Queens County,115,52,11,41,0,0,0,0,0,0,115,52,11,41,0,490,60,430
360810641011,36, New York,081, Queens County,636,235,214,7,14,0,0,0,0,0,636,235,214,7,14,1783,91,1692
360810641021,36, New York,081, Queens County,0,0,0,0,0,0,0,0,0,0,0,0,0,0,0,0,0,0
360810645001,36, New York,081, Queens County,276,167,73,0,94,95,95,1,0,94,181,72,72,0,0,612,114,498
360810645002,36, New York,081, Queens County,237,101,82,7,12,8,8,0,0,8,229,93,82,7,4,763,23,740
360810646001,36, New York,081, Queens County,502,170,98,0,72,20,8,0,0,8,482,162,98,0,64,1515,93,1422
360810646002,36, New York,081, Queens County,355,189,111,11,67,0,0,0,0,0,355,189,111,11,67,1001,11,990
360810650001,36, New York,081, Queens County,245,59,43,3,13,8,8,0,0,8,237,51,43,3,5,852,74,778
360810650002,36, New York,081, Queens County,394,145,85,17,43,16,16,0,0,16,378,129,85,17,27,1112,74,1038
360810654011,36, New York,081, Queens County,346,130,77,8,45,18,18,18,0,0,328,112,59,8,45,989,39,950
360810654012,36, New York,081, Queens County,310,148,45,9,94,47,34,0,0,34,263,114,45,9,60,834,68,766
360810654013,36, New York,081, Queens County,184,113,81,13,19,14,14,14,0,0,170,99,67,13,19,487,34,453
360810654021,36, New York,081, Queens County,0,0,0,0,0,0,0,0,0,0,0,0,0,0,0,0,0,0
360810655011,36, New York,081, Queens County,0,0,0,0,0,0,0,0,0,0,0,0,0,0,0,0,0,0
360810656001,36, New York,081, Queens County,201,111,42,0,69,0,0,0,0,0,201,111,42,0,69,645,26,619
360810656002,36, New York,081, Queens County,350,47,17,0,30,21,0,0,0,0,329,47,17,0,30,984,93,891
360810656003,36, New York,081, Queens County,489,133,115,18,0,0,0,0,0,0,489,133,115,18,0,1580,6,1574
360810657021,36, New York,081, Queens County,416,161,133,0,28,0,0,0,0,0,416,161,133,0,28,1044,44,1000
360810657031,36, New York,081, Queens County,377,75,40,0,35,0,0,0,0,0,377,75,40,0,35,1145,27,1118
360810657032,36, New York,081, Queens County,250,137,137,0,0,10,0,0,0,0,240,137,137,0,0,574,38,536
360810657033,36, New York,081, Queens County,159,18,18,0,0,21,0,0,0,0,138,18,18,0,0,451,43,408
360810659001,36, New York,081, Queens County,325,87,82,0,5,7,0,0,0,0,318,87,82,0,5,886,32,854
360810659002,36, New York,081, Queens County,178,71,41,0,30,24,19,0,0,19,154,52,41,0,11,621,48,573
360810660001,36, New York,081, Queens County,194,73,29,19,25,7,0,0,0,0,187,73,29,19,25,737,15,722
360810660002,36, New York,081, Queens County,632,277,220,23,34,25,25,0,0,25,607,252,220,23,9,1637,36,1601
360810661001,36, New York,081, Queens County,469,128,113,0,15,5,0,0,0,0,464,128,113,0,15,1239,69,1170
360810663011,36, New York,081, Queens County,382,182,171,2,9,3,0,0,0,0,379,182,171,2,9,1025,38,987
360810663012,36, New York,081, Queens County,366,137,112,0,25,5,0,0,0,0,361,137,112,0,25,1159,28,1131
360810663021,36, New York,081, Queens County,0,0,0,0,0,0,0,0,0,0,0,0,0,0,0,0,0,0
360810664011,36, New York,081, Queens County,54,29,8,21,0,0,0,0,0,0,54,29,8,21,0,177,95,82
360810664012,36, New York,081, Queens County,239,125,60,32,33,0,0,0,0,0,239,125,60,32,33,704,0,704
360810664021,36, New York,081, Queens County,396,23,23,0,0,0,0,0,0,0,396,23,23,0,0,1454,0,1454
360810664022,36, New York,081, Queens County,159,89,23,0,66,0,0,0,0,0,159,89,23,0,66,414,34,380
360810664023,36, New York,081, Queens County,236,112,57,0,55,0,0,0,0,0,236,112,57,0,55,680,49,631
360810664031,36, New York,081, Queens County,636,314,121,0,193,188,152,0,0,152,448,162,121,0,41,1901,254,1647
360810664032,36, New York,081, Queens County,412,237,222,0,15,24,24,24,0,0,388,213,198,0,15,1199,147,1052
360810664033,36, New York,081, Queens County,288,232,128,43,61,0,0,0,0,0,288,232,128,43,61,717,28,689
360810664041,36, New York,081, Queens County,0,0,0,0,0,0,0,0,0,0,0,0,0,0,0,0,0,0
360810665011,36, New York,081, Queens County,233,122,103,0,19,8,8,0,0,8,225,114,103,0,11,892,65,827
360810665012,36, New York,081, Queens County,208,53,34,9,10,0,0,0,0,0,208,53,34,9,10,735,29,706
360810665013,36, New York,081, Queens County,243,164,159,5,0,0,0,0,0,0,243,164,159,5,0,702,84,618
360810665014,36, New York,081, Queens County,161,50,50,0,0,0,0,0,0,0,161,50,50,0,0,430,0,430
360810667011,36, New York,081, Queens County,326,205,119,0,86,1,1,1,0,0,325,204,118,0,86,1130,128,1002
360810667012,36, New York,081, Queens County,275,66,47,0,19,18,18,18,0,0,257,48,29,0,19,862,51,811
360810669001,36, New York,081, Queens County,215,52,45,0,7,0,0,0,0,0,215,52,45,0,7,593,56,537
360810669002,36, New York,081, Queens County,286,179,139,0,40,35,35,0,0,35,251,144,139,0,5,539,18,521
360810671001,36, New York,081, Queens County,369,127,123,0,4,16,0,0,0,0,353,127,123,0,4,1078,71,1007
360810671002,36, New York,081, Queens County,217,66,57,0,9,11,0,0,0,0,206,66,57,0,9,790,42,748
360810677001,36, New York,081, Queens County,293,101,86,0,15,0,0,0,0,0,293,101,86,0,15,779,21,758
360810677002,36, New York,081, Queens County,262,78,71,0,7,5,5,5,0,0,257,73,66,0,7,687,50,637
360810679001,36, New York,081, Queens County,92,18,18,0,0,1,0,0,0,0,91,18,18,0,0,198,3,195
360810679002,36, New York,081, Queens County,623,305,134,99,72,46,46,0,18,28,577,259,134,81,44,1438,171,1267
360810679003,36, New York,081, Queens County,346,132,118,0,14,6,0,0,0,0,340,132,118,0,14,911,71,840
360810680001,36, New York,081, Queens County,294,146,47,18,81,11,11,0,11,0,283,135,47,7,81,938,40,898
360810680002,36, New York,081, Queens County,304,127,36,0,91,0,0,0,0,0,304,127,36,0,91,1062,14,1048
360810680003,36, New York,081, Queens County,432,99,35,6,58,0,0,0,0,0,432,99,35,6,58,1278,4,1274
360810680004,36, New York,081, Queens County,283,163,67,0,96,25,25,0,0,25,258,138,67,0,71,853,85,768
360810682001,36, New York,081, Queens County,139,42,30,0,12,0,0,0,0,0,139,42,30,0,12,454,55,399
360810682002,36, New York,081, Queens County,102,48,16,0,32,0,0,0,0,0,102,48,16,0,32,341,12,329
360810683001,36, New York,081, Queens County,380,127,73,0,54,43,28,0,0,28,337,99,73,0,26,1155,117,1038
360810683002,36, New York,081, Queens County,320,85,45,2,38,27,0,0,0,0,293,85,45,2,38,867,102,765
360810683003,36, New York,081, Queens County,251,106,82,24,0,23,0,0,0,0,228,106,82,24,0,622,62,560
360810687001,36, New York,081, Queens County,256,104,47,0,57,9,0,0,0,0,247,104,47,0,57,730,133,597
360810687002,36, New York,081, Queens County,362,162,120,0,42,0,0,0,0,0,362,162,120,0,42,956,1,955
360810687003,36, New York,081, Queens County,587,335,54,25,256,18,0,0,0,0,569,335,54,25,256,1094,88,1006
360810690001,36, New York,081, Queens County,546,271,148,20,103,0,0,0,0,0,546,271,148,20,103,1801,13,1788
360810690002,36, New York,081, Queens County,357,173,18,0,155,18,0,0,0,0,339,173,18,0,155,881,46,835
360810693001,36, New York,081, Queens County,627,331,257,19,55,13,13,4,0,9,614,318,253,19,46,1429,92,1337
360810693002,36, New York,081, Queens County,198,48,11,0,37,19,9,9,0,0,179,39,2,0,37,580,18,562
360810694001,36, New York,081, Queens County,331,159,72,19,68,18,18,0,0,18,313,141,72,19,50,1352,156,1196
360810694002,36, New York,081, Queens County,493,286,90,0,196,0,0,0,0,0,493,286,90,0,196,1199,18,1181
360810695001,36, New York,081, Queens County,327,129,110,0,19,14,0,0,0,0,313,129,110,0,19,853,76,777
360810695002,36, New York,081, Queens County,309,42,18,8,16,5,0,0,0,0,304,42,18,8,16,809,51,758
360810697011,36, New York,081, Queens County,414,216,204,12,0,15,0,0,0,0,399,216,204,12,0,1075,13,1062
360810697012,36, New York,081, Queens County,267,76,57,19,0,29,19,0,19,0,238,57,57,0,0,590,69,521
360810697013,36, New York,081, Queens County,354,225,218,0,7,0,0,0,0,0,354,225,218,0,7,974,36,938
360810697021,36, New York,081, Queens County,155,105,105,0,0,0,0,0,0,0,155,105,105,0,0,215,10,205
360810697022,36, New York,081, Queens County,243,52,20,11,21,41,0,0,0,0,202,52,20,11,21,683,83,600
360810697023,36, New York,081, Queens County,237,71,70,0,1,1,1,0,0,1,236,70,70,0,0,681,132,549
360810697024,36, New York,081, Queens County,462,110,84,0,26,11,11,11,0,0,451,99,73,0,26,1172,88,1084
360810703001,36, New York,081, Queens County,228,100,100,0,0,21,0,0,0,0,207,100,100,0,0,464,43,421
360810703002,36, New York,081, Queens County,356,125,83,8,34,20,7,0,0,7,336,118,83,8,27,928,116,812
360810707001,36, New York,081, Queens County,213,98,78,14,6,0,0,0,0,0,213,98,78,14,6,508,0,508
360810707002,36, New York,081, Queens County,166,83,54,10,19,0,0,0,0,0,166,83,54,10,19,480,33,447
360810707003,36, New York,081, Queens County,370,125,125,0,0,8,0,0,0,0,362,125,125,0,0,836,20,816
360810709001,36, New York,081, Queens County,367,217,111,0,106,33,24,24,0,0,334,193,87,0,106,1021,125,896
360810709002,36, New York,081, Queens County,359,190,155,0,35,0,0,0,0,0,359,190,155,0,35,887,54,833
360810711001,36, New York,081, Queens County,297,153,140,0,13,0,0,0,0,0,297,153,140,0,13,818,16,802
360810711002,36, New York,081, Queens County,455,177,125,46,6,52,52,0,46,6,403,125,125,0,0,1988,199,1789
360810711003,36, New York,081, Queens County,376,119,102,0,17,15,0,0,0,0,361,119,102,0,17,856,30,826
360810711004,36, New York,081, Queens County,296,74,74,0,0,0,0,0,0,0,296,74,74,0,0,998,0,998
360810713031,36, New York,081, Queens County,618,197,156,0,41,0,0,0,0,0,618,197,156,0,41,1306,24,1282
360810713032,36, New York,081, Queens County,360,152,122,0,30,15,15,0,0,15,345,137,122,0,15,724,15,709
360810713033,36, New York,081, Queens County,392,207,180,0,27,0,0,0,0,0,392,207,180,0,27,1424,244,1180
360810713041,36, New York,081, Queens County,288,91,45,9,37,64,16,0,0,16,224,75,45,9,21,638,239,399
360810713042,36, New York,081, Queens County,558,186,168,0,18,18,18,0,0,18,540,168,168,0,0,1808,30,1778
360810713043,36, New York,081, Queens County,118,22,0,0,22,22,22,0,0,22,96,0,0,0,0,220,40,180
360810713044,36, New York,081, Queens County,697,139,139,0,0,120,38,38,0,0,577,101,101,0,0,2092,318,1774
360810713051,36, New York,081, Queens County,351,136,131,0,5,50,0,0,0,0,301,136,131,0,5,832,79,753
360810713052,36, New York,081, Queens County,297,118,85,33,0,0,0,0,0,0,297,118,85,33,0,572,23,549
360810713053,36, New York,081, Queens County,602,218,173,0,45,0,0,0,0,0,602,218,173,0,45,1233,0,1233
360810713054,36, New York,081, Queens County,214,59,59,0,0,0,0,0,0,0,214,59,59,0,0,512,43,469
360810713061,36, New York,081, Queens County,282,38,24,0,14,63,10,10,0,0,219,28,14,0,14,959,150,809
360810713062,36, New York,081, Queens County,1175,730,688,25,17,140,71,46,25,0,1035,659,642,0,17,1839,267,1572
360810713063,36, New York,081, Queens County,196,118,91,12,15,0,0,0,0,0,196,118,91,12,15,814,189,625
360810713064,36, New York,081, Queens County,119,31,31,0,0,12,12,12,0,0,107,19,19,0,0,308,2,306
360810716001,36, New York,081, Queens County,0,0,0,0,0,0,0,0,0,0,0,0,0,0,0,0,0,0
360810717011,36, New York,081, Queens County,454,182,109,0,73,25,25,0,0,25,429,157,109,0,48,981,61,920
360810717012,36, New York,081, Queens County,172,122,109,13,0,137,109,109,0,0,35,13,0,13,0,398,129,269
360810717013,36, New York,081, Queens County,185,0,0,0,0,0,0,0,0,0,185,0,0,0,0,667,59,608
360810717014,36, New York,081, Queens County,395,199,129,53,17,99,0,0,0,0,296,199,129,53,17,1111,253,858
360810717021,36, New York,081, Queens County,688,179,169,0,10,44,10,0,0,10,644,169,169,0,0,1907,316,1591
360810717022,36, New York,081, Queens County,436,182,133,0,49,50,42,0,0,42,386,140,133,0,7,1199,131,1068
360810719001,36, New York,081, Queens County,315,138,35,0,103,31,27,17,0,10,284,111,18,0,93,971,123,848
360810719002,36, New York,081, Queens County,570,230,168,55,7,93,72,59,6,7,477,158,109,49,0,1098,114,984
360810721001,36, New York,081, Queens County,286,93,87,6,0,0,0,0,0,0,286,93,87,6,0,533,0,533
360810721002,36, New York,081, Queens County,259,90,68,22,0,22,22,0,22,0,237,68,68,0,0,674,37,637
360810721003,36, New York,081, Queens County,205,75,75,0,0,42,0,0,0,0,163,75,75,0,0,661,158,503
360810721004,36, New York,081, Queens County,448,148,148,0,0,0,0,0,0,0,448,148,148,0,0,520,0,520
360810721005,36, New York,081, Queens County,247,177,153,24,0,0,0,0,0,0,247,177,153,24,0,562,80,482
360810723001,36, New York,081, Queens County,62,8,8,0,0,0,0,0,0,0,62,8,8,0,0,230,5,225
360810723002,36, New York,081, Queens County,195,56,56,0,0,0,0,0,0,0,195,56,56,0,0,567,18,549
360810723003,36, New York,081, Queens County,377,231,231,0,0,15,0,0,0,0,362,231,231,0,0,803,36,767
360810729001,36, New York,081, Queens County,149,40,40,0,0,0,0,0,0,0,149,40,40,0,0,553,12,541
360810729002,36, New York,081, Queens County,138,57,57,0,0,20,9,9,0,0,118,48,48,0,0,426,27,399
360810731001,36, New York,081, Queens County,266,72,64,8,0,0,0,0,0,0,266,72,64,8,0,724,0,724
360810731002,36, New York,081, Queens County,214,122,101,0,21,21,21,0,0,21,193,101,101,0,0,544,32,512
360810737001,36, New York,081, Queens County,181,62,51,0,11,0,0,0,0,0,181,62,51,0,11,588,26,562
360810737002,36, New York,081, Queens County,341,90,43,18,29,10,0,0,0,0,331,90,43,18,29,913,56,857
360810739001,36, New York,081, Queens County,229,106,106,0,0,0,0,0,0,0,229,106,106,0,0,590,0,590
360810739002,36, New York,081, Queens County,200,67,43,0,24,11,11,11,0,0,189,56,32,0,24,420,22,398
360810739003,36, New York,081, Queens County,255,121,121,0,0,15,0,0,0,0,240,121,121,0,0,667,56,611
360810739004,36, New York,081, Queens County,594,170,103,0,67,0,0,0,0,0,594,170,103,0,67,1285,0,1285
360810739005,36, New York,081, Queens County,367,84,84,0,0,0,0,0,0,0,367,84,84,0,0,984,19,965
360810741001,36, New York,081, Queens County,216,18,18,0,0,33,0,0,0,0,183,18,18,0,0,605,71,534
360810741002,36, New York,081, Queens County,251,55,24,31,0,0,0,0,0,0,251,55,24,31,0,863,67,796
360810741003,36, New York,081, Queens County,154,47,35,0,12,0,0,0,0,0,154,47,35,0,12,429,23,406
360810741004,36, New York,081, Queens County,165,65,49,0,16,0,0,0,0,0,165,65,49,0,16,501,11,490
360810743001,36, New York,081, Queens County,261,34,34,0,0,9,0,0,0,0,252,34,34,0,0,801,27,774
360810743002,36, New York,081, Queens County,222,100,100,0,0,26,0,0,0,0,196,100,100,0,0,530,53,477
360810743003,36, New York,081, Queens County,381,182,81,52,49,24,5,5,0,0,357,177,76,52,49,1090,91,999
360810743004,36, New York,081, Queens County,196,61,51,0,10,0,0,0,0,0,196,61,51,0,10,580,35,545
360810745001,36, New York,081, Queens County,663,88,49,0,39,73,0,0,0,0,590,88,49,0,39,1841,313,1528
360810745002,36, New York,081, Queens County,388,137,109,28,0,121,28,0,28,0,267,109,109,0,0,985,286,699
360810747001,36, New York,081, Queens County,475,168,168,0,0,19,10,10,0,0,456,158,158,0,0,1094,39,1055
360810747002,36, New York,081, Queens County,436,62,33,19,10,33,0,0,0,0,403,62,33,19,10,929,101,828
360810749001,36, New York,081, Queens County,249,111,104,7,0,3,0,0,0,0,246,111,104,7,0,533,5,528
360810749002,36, New York,081, Queens County,181,113,106,0,7,7,7,0,0,7,174,106,106,0,0,353,27,326
360810757011,36, New York,081, Queens County,506,178,130,0,48,48,48,0,0,48,458,130,130,0,0,1488,48,1440
360810757012,36, New York,081, Queens County,261,38,32,6,0,0,0,0,0,0,261,38,32,6,0,898,6,892
360810757013,36, New York,081, Queens County,448,141,86,14,41,0,0,0,0,0,448,141,86,14,41,1169,43,1126
360810757021,36, New York,081, Queens County,406,40,40,0,0,26,0,0,0,0,380,40,40,0,0,1438,48,1390
360810757022,36, New York,081, Queens County,267,58,58,0,0,0,0,0,0,0,267,58,58,0,0,990,82,908
360810757023,36, New York,081, Queens County,563,343,323,0,20,23,23,23,0,0,540,320,300,0,20,1299,48,1251
360810769011,36, New York,081, Queens County,890,279,180,30,69,0,0,0,0,0,890,279,180,30,69,2006,53,1953
360810769012,36, New York,081, Queens County,410,164,135,0,29,19,0,0,0,0,391,164,135,0,29,1422,48,1374
360810769021,36, New York,081, Queens County,288,148,114,0,34,4,4,4,0,0,284,144,110,0,34,728,41,687
360810773001,36, New York,081, Queens County,218,103,100,0,3,17,9,9,0,0,201,94,91,0,3,702,71,631
360810773002,36, New York,081, Queens County,167,43,35,0,8,14,0,0,0,0,153,43,35,0,8,457,27,430
360810773003,36, New York,081, Queens County,71,23,23,0,0,0,0,0,0,0,71,23,23,0,0,410,0,410
360810775001,36, New York,081, Queens County,265,60,55,0,5,35,0,0,0,0,230,60,55,0,5,669,85,584
360810775002,36, New York,081, Queens County,170,70,59,11,0,0,0,0,0,0,170,70,59,11,0,614,9,605
360810775003,36, New York,081, Queens County,123,17,17,0,0,0,0,0,0,0,123,17,17,0,0,429,0,429
360810779021,36, New York,081, Queens County,131,76,76,0,0,0,0,0,0,0,131,76,76,0,0,322,13,309
360810779022,36, New York,081, Queens County,354,184,138,0,46,56,46,0,0,46,298,138,138,0,0,1028,75,953
360810779023,36, New York,081, Queens County,190,88,88,0,0,0,0,0,0,0,190,88,88,0,0,503,0,503
360810779024,36, New York,081, Queens County,155,54,54,0,0,0,0,0,0,0,155,54,54,0,0,322,0,322
360810779025,36, New York,081, Queens County,625,474,148,0,326,268,250,0,0,250,357,224,148,0,76,1041,443,598
360810779031,36, New York,081, Queens County,168,50,50,0,0,8,7,7,0,0,160,43,43,0,0,599,51,548
360810779032,36, New York,081, Queens County,324,184,156,14,14,0,0,0,0,0,324,184,156,14,14,901,0,901
360810779033,36, New York,081, Queens County,366,177,112,10,55,41,21,21,0,0,325,156,91,10,55,921,82,839
360810779041,36, New York,081, Queens County,135,23,23,0,0,0,0,0,0,0,135,23,23,0,0,338,50,288
360810779042,36, New York,081, Queens County,361,228,188,15,25,50,15,0,15,0,311,213,188,0,25,923,57,866
360810779043,36, New York,081, Queens County,664,347,240,55,52,0,0,0,0,0,664,347,240,55,52,1635,71,1564
360810779044,36, New York,081, Queens County,299,168,168,0,0,0,0,0,0,0,299,168,168,0,0,757,45,712
360810779051,36, New York,081, Queens County,556,191,180,0,11,30,19,19,0,0,526,172,161,0,11,1681,93,1588
360810779052,36, New York,081, Queens County,168,43,19,0,24,24,12,0,0,12,144,31,19,0,12,383,30,353
360810779061,36, New York,081, Queens County,528,58,19,29,10,75,39,0,29,10,453,19,19,0,0,1335,198,1137
360810779062,36, New York,081, Queens County,424,175,139,0,36,10,0,0,0,0,414,175,139,0,36,933,20,913
360810779071,36, New York,081, Queens County,738,285,265,9,11,78,65,56,9,0,660,220,209,0,11,1703,122,1581
360810779072,36, New York,081, Queens County,133,80,80,0,0,34,23,23,0,0,99,57,57,0,0,402,123,279
360810779081,36, New York,081, Queens County,271,193,130,0,63,70,70,62,0,8,201,123,68,0,55,828,263,565
360810779082,36, New York,081, Queens County,413,119,79,0,40,96,8,0,0,8,317,111,79,0,32,951,158,793
360810788001,36, New York,081, Queens County,281,158,81,43,34,9,0,0,0,0,272,158,81,43,34,763,0,763
360810788002,36, New York,081, Queens County,115,52,25,0,27,0,0,0,0,0,115,52,25,0,27,453,40,413
360810790001,36, New York,081, Queens County,347,131,93,6,32,43,37,29,0,8,304,94,64,6,24,734,62,672
360810790002,36, New York,081, Queens County,361,127,66,14,47,0,0,0,0,0,361,127,66,14,47,944,20,924
360810792001,36, New York,081, Queens County,194,43,10,0,33,9,0,0,0,0,185,43,10,0,33,660,47,613
360810792002,36, New York,081, Queens County,363,143,109,17,17,0,0,0,0,0,363,143,109,17,17,1292,82,1210
360810793001,36, New York,081, Queens County,0,0,0,0,0,0,0,0,0,0,0,0,0,0,0,0,0,0
360810797011,36, New York,081, Queens County,489,63,16,0,47,29,29,0,0,29,460,34,16,0,18,695,71,624
360810797012,36, New York,081, Queens County,762,281,212,51,18,176,106,106,0,0,586,175,106,51,18,947,167,780
360810797013,36, New York,081, Queens County,0,0,0,0,0,0,0,0,0,0,0,0,0,0,0,0,0,0
360810797014,36, New York,081, Queens County,739,151,151,0,0,68,46,46,0,0,671,105,105,0,0,1444,287,1157
360810797021,36, New York,081, Queens County,352,156,132,0,24,91,47,25,0,22,261,109,107,0,2,724,202,522
360810797022,36, New York,081, Queens County,148,92,92,0,0,14,0,0,0,0,134,92,92,0,0,268,48,220
360810797023,36, New York,081, Queens County,0,0,0,0,0,0,0,0,0,0,0,0,0,0,0,0,0,0
360810797024,36, New York,081, Queens County,490,317,317,0,0,283,210,210,0,0,207,107,107,0,0,504,70,434
360810799001,36, New York,081, Queens County,343,24,13,0,11,20,11,0,0,11,323,13,13,0,0,546,52,494
360810799002,36, New York,081, Queens County,534,298,219,79,0,240,216,157,59,0,294,82,62,20,0,812,211,601
360810803011,36, New York,081, Queens County,363,163,132,11,20,33,11,0,11,0,330,152,132,0,20,479,78,401
360810803012,36, New York,081, Queens County,297,78,49,0,29,57,11,11,0,0,240,67,38,0,29,403,57,346
360810803013,36, New York,081, Queens County,269,175,125,25,25,31,0,0,0,0,238,175,125,25,25,659,129,530
360810803021,36, New York,081, Queens County,408,226,213,13,0,0,0,0,0,0,408,226,213,13,0,1146,0,1146
360810803022,36, New York,081, Queens County,139,15,15,0,0,8,0,0,0,0,131,15,15,0,0,454,43,411
360810803023,36, New York,081, Queens County,248,153,142,11,0,0,0,0,0,0,248,153,142,11,0,818,0,818
360810809001,36, New York,081, Queens County,486,225,126,0,99,6,0,0,0,0,480,225,126,0,99,1236,41,1195
360810809002,36, New York,081, Queens County,105,9,9,0,0,0,0,0,0,0,105,9,9,0,0,291,15,276
360810809003,36, New York,081, Queens County,152,106,84,0,22,0,0,0,0,0,152,106,84,0,22,308,0,308
360810809004,36, New York,081, Queens County,432,335,259,0,76,0,0,0,0,0,432,335,259,0,76,953,0,953
360810809005,36, New York,081, Queens County,172,0,0,0,0,38,0,0,0,0,134,0,0,0,0,392,111,281
360810809006,36, New York,081, Queens County,362,159,130,0,29,103,76,76,0,0,259,83,54,0,29,779,280,499
360810809007,36, New York,081, Queens County,139,35,14,12,9,0,0,0,0,0,139,35,14,12,9,299,10,289
360810814001,36, New York,081, Queens County,342,140,115,0,25,25,25,0,0,25,317,115,115,0,0,1100,67,1033
360810814002,36, New York,081, Queens County,359,183,118,7,58,74,66,66,0,0,285,117,52,7,58,1161,221,940
360810814003,36, New York,081, Queens County,212,50,31,0,19,15,15,15,0,0,197,35,16,0,19,869,15,854
360810818001,36, New York,081, Queens County,352,137,100,0,37,30,30,30,0,0,322,107,70,0,37,1197,43,1154
360810818002,36, New York,081, Queens County,281,192,157,35,0,60,34,34,0,0,221,158,123,35,0,617,121,496
360810818003,36, New York,081, Queens County,209,69,69,0,0,0,0,0,0,0,209,69,69,0,0,660,27,633
360810837001,36, New York,081, Queens County,576,98,89,0,9,53,9,0,0,9,523,89,89,0,0,1339,141,1198
360810837002,36, New York,081, Queens County,163,61,51,10,0,62,19,9,10,0,101,42,42,0,0,317,51,266
360810837003,36, New York,081, Queens County,288,140,93,0,47,16,0,0,0,0,272,140,93,0,47,746,16,730
360810837004,36, New York,081, Queens County,0,0,0,0,0,0,0,0,0,0,0,0,0,0,0,0,0,0
360810837005,36, New York,081, Queens County,127,47,40,7,0,10,10,10,0,0,117,37,30,7,0,311,10,301
360810838001,36, New York,081, Queens County,424,179,158,21,0,23,0,0,0,0,401,179,158,21,0,1034,0,1034
360810838002,36, New York,081, Queens County,386,197,197,0,0,18,18,18,0,0,368,179,179,0,0,975,0,975
360810838003,36, New York,081, Queens County,331,90,56,34,0,6,0,0,0,0,325,90,56,34,0,975,19,956
360810838004,36, New York,081, Queens County,306,96,88,8,0,12,0,0,0,0,294,96,88,8,0,955,66,889
360810840001,36, New York,081, Queens County,476,168,54,28,86,106,53,0,28,25,370,115,54,0,61,1171,246,925
360810840002,36, New York,081, Queens County,364,89,89,0,0,0,0,0,0,0,364,89,89,0,0,926,0,926
360810840003,36, New York,081, Queens County,411,194,161,2,31,0,0,0,0,0,411,194,161,2,31,1212,0,1212
360810840004,36, New York,081, Queens County,228,92,16,63,13,0,0,0,0,0,228,92,16,63,13,755,14,741
360810840005,36, New York,081, Queens County,313,80,35,9,36,13,0,0,0,0,300,80,35,9,36,849,69,780
360810845001,36, New York,081, Queens County,524,68,20,0,48,175,26,0,0,26,349,42,20,0,22,1454,604,850
360810845002,36, New York,081, Queens County,345,107,73,0,34,18,18,18,0,0,327,89,55,0,34,804,36,768
360810845003,36, New York,081, Queens County,266,80,80,0,0,40,15,15,0,0,226,65,65,0,0,566,190,376
360810846011,36, New York,081, Queens County,274,157,89,55,13,5,5,0,0,5,269,152,89,55,8,820,5,815
360810846012,36, New York,081, Queens County,391,143,79,18,46,7,7,0,0,7,384,136,79,18,39,1089,52,1037
360810846021,36, New York,081, Queens County,191,116,61,0,55,0,0,0,0,0,191,116,61,0,55,895,133,762
360810849011,36, New York,081, Queens County,469,225,153,72,0,75,74,74,0,0,394,151,79,72,0,659,54,605
360810849012,36, New York,081, Queens County,325,15,15,0,0,26,0,0,0,0,299,15,15,0,0,160,0,160
360810849021,36, New York,081, Queens County,390,45,32,0,13,60,19,19,0,0,330,26,13,0,13,848,229,619
360810849022,36, New York,081, Queens County,521,236,184,0,52,191,108,56,0,52,330,128,128,0,0,581,174,407
360810853001,36, New York,081, Queens County,854,184,157,0,27,38,38,25,0,13,816,146,132,0,14,1076,75,1001
360810853002,36, New York,081, Queens County,205,31,31,0,0,49,0,0,0,0,156,31,31,0,0,581,59,522
360810853003,36, New York,081, Queens County,249,73,52,0,21,21,0,0,0,0,228,73,52,0,21,661,87,574
360810853004,36, New York,081, Queens County,304,134,134,0,0,64,44,44,0,0,240,90,90,0,0,385,39,346
360810855001,36, New York,081, Queens County,140,47,47,0,0,24,0,0,0,0,116,47,47,0,0,487,154,333
360810855002,36, New York,081, Queens County,480,145,63,36,46,83,46,0,0,46,397,99,63,36,0,1147,273,874
360810855003,36, New York,081, Queens County,451,245,245,0,0,0,0,0,0,0,451,245,245,0,0,856,51,805
360810855004,36, New York,081, Queens County,375,106,53,0,53,58,34,0,0,34,317,72,53,0,19,845,97,748
360810857001,36, New York,081, Queens County,481,172,103,0,69,88,38,37,0,1,393,134,66,0,68,996,148,848
360810857002,36, New York,081, Queens County,249,26,26,0,0,49,12,12,0,0,200,14,14,0,0,519,91,428
360810857003,36, New York,081, Queens County,609,123,123,0,0,41,0,0,0,0,568,123,123,0,0,896,190,706
360810859001,36, New York,081, Queens County,401,68,24,0,44,42,0,0,0,0,359,68,24,0,44,658,107,551
360810859002,36, New York,081, Queens County,423,94,56,0,38,87,14,14,0,0,336,80,42,0,38,582,71,511
360810859003,36, New York,081, Queens County,790,296,268,0,28,192,37,37,0,0,598,259,231,0,28,1608,421,1187
360810861001,36, New York,081, Queens County,314,63,57,0,6,36,6,0,0,6,278,57,57,0,0,672,119,553
360810861002,36, New York,081, Queens County,258,53,43,10,0,91,7,7,0,0,167,46,36,10,0,329,66,263
360810863001,36, New York,081, Queens County,306,63,47,16,0,88,0,0,0,0,218,63,47,16,0,514,55,459
360810863002,36, New York,081, Queens County,183,130,67,0,63,67,67,67,0,0,116,63,0,0,63,227,62,165
360810863003,36, New York,081, Queens County,417,308,308,0,0,97,96,96,0,0,320,212,212,0,0,371,155,216
360810863004,36, New York,081, Queens County,689,148,130,0,18,18,0,0,0,0,671,148,130,0,18,1535,84,1451
360810864001,36, New York,081, Queens County,405,137,102,0,35,32,16,0,0,16,373,121,102,0,19,1341,144,1197
360810864002,36, New York,081, Queens County,218,95,81,0,14,28,28,19,0,9,190,67,62,0,5,530,27,503
360810865001,36, New York,081, Queens County,398,171,125,25,21,96,21,0,0,21,302,150,125,25,0,809,86,723
360810865002,36, New York,081, Queens County,469,60,0,60,0,69,0,0,0,0,400,60,0,60,0,1221,172,1049
360810865003,36, New York,081, Queens County,79,13,0,0,13,1,0,0,0,0,78,13,0,0,13,190,49,141
360810869001,36, New York,081, Queens County,379,57,29,0,28,46,0,0,0,0,333,57,29,0,28,734,115,619
360810869002,36, New York,081, Queens County,27,26,11,6,9,0,0,0,0,0,27,26,11,6,9,52,0,52
360810871001,36, New York,081, Queens County,321,105,80,0,25,14,0,0,0,0,307,105,80,0,25,672,75,597
360810871002,36, New York,081, Queens County,896,188,82,0,106,304,56,0,0,56,592,132,82,0,50,1574,269,1305
360810884000,36, New York,081, Queens County,0,0,0,0,0,0,0,0,0,0,0,0,0,0,0,0,0,0
360810884001,36, New York,081, Queens County,391,114,69,0,45,15,0,0,0,0,376,114,69,0,45,1490,114,1376
360810884002,36, New York,081, Queens County,136,123,107,0,16,0,0,0,0,0,136,123,107,0,16,433,16,417
360810884003,36, New York,081, Queens County,219,86,86,0,0,37,0,0,0,0,182,86,86,0,0,762,280,482
360810884004,36, New York,081, Queens County,408,119,73,15,31,0,0,0,0,0,408,119,73,15,31,868,0,868
360810884005,36, New York,081, Queens County,236,119,79,0,40,12,0,0,0,0,224,119,79,0,40,1104,118,986
360810884006,36, New York,081, Queens County,426,150,150,0,0,0,0,0,0,0,426,150,150,0,0,1047,62,985
360810884007,36, New York,081, Queens County,110,35,22,0,13,0,0,0,0,0,110,35,22,0,13,452,0,452
360810884008,36, New York,081, Queens County,278,72,38,16,18,0,0,0,0,0,278,72,38,16,18,728,2,726
360810889021,36, New York,081, Queens County,517,184,184,0,0,51,32,32,0,0,466,152,152,0,0,680,20,660
360810889022,36, New York,081, Queens County,736,52,52,0,0,58,33,33,0,0,678,19,19,0,0,1396,146,1250
360810889023,36, New York,081, Queens County,223,46,0,0,46,122,0,0,0,0,101,46,0,0,46,798,463,335
360810889024,36, New York,081, Queens County,168,55,24,0,31,31,31,0,0,31,137,24,24,0,0,290,127,163
360810889031,36, New York,081, Queens County,216,55,24,0,31,0,0,0,0,0,216,55,24,0,31,493,35,458
360810889032,36, New York,081, Queens County,532,18,14,0,4,88,4,0,0,4,444,14,14,0,0,1502,247,1255
360810889033,36, New York,081, Queens County,537,226,217,0,9,188,95,95,0,0,349,131,122,0,9,1172,526,646
360810892011,36, New York,081, Queens County,207,17,17,0,0,0,0,0,0,0,207,17,17,0,0,704,0,704
360810892012,36, New York,081, Queens County,487,252,208,0,44,36,36,0,0,36,451,216,208,0,8,1107,36,1071
360810892013,36, New York,081, Queens County,115,49,49,0,0,0,0,0,0,0,115,49,49,0,0,278,0,278
360810892014,36, New York,081, Queens County,487,236,230,0,6,35,0,0,0,0,452,236,230,0,6,1430,72,1358
360810892015,36, New York,081, Queens County,298,0,0,0,0,44,0,0,0,0,254,0,0,0,0,1138,85,1053
360810892016,36, New York,081, Queens County,334,250,203,0,47,0,0,0,0,0,334,250,203,0,47,1003,0,1003
360810892017,36, New York,081, Queens County,175,73,73,0,0,0,0,0,0,0,175,73,73,0,0,457,36,421
360810892018,36, New York,081, Queens County,142,33,33,0,0,0,0,0,0,0,142,33,33,0,0,622,31,591
360810892021,36, New York,081, Queens County,0,0,0,0,0,0,0,0,0,0,0,0,0,0,0,0,0,0
360810907000,36, New York,081, Queens County,0,0,0,0,0,0,0,0,0,0,0,0,0,0,0,0,0,0
360810907001,36, New York,081, Queens County,482,232,229,0,3,71,68,68,0,0,411,164,161,0,3,694,132,562
360810916020,36, New York,081, Queens County,0,0,0,0,0,0,0,0,0,0,0,0,0,0,0,0,0,0
360810916021,36, New York,081, Queens County,0,0,0,0,0,0,0,0,0,0,0,0,0,0,0,0,0,0
360810916030,36, New York,081, Queens County,0,0,0,0,0,0,0,0,0,0,0,0,0,0,0,0,0,0
360810916031,36, New York,081, Queens County,0,0,0,0,0,0,0,0,0,0,0,0,0,0,0,0,0,0
360810916032,36, New York,081, Queens County,122,88,67,0,21,0,0,0,0,0,122,88,67,0,21,364,1,363
360810916033,36, New York,081, Queens County,0,0,0,0,0,0,0,0,0,0,0,0,0,0,0,0,0,0
360810916034,36, New York,081, Queens County,533,110,89,0,21,21,21,0,0,21,512,89,89,0,0,1860,92,1768
360810916035,36, New York,081, Queens County,139,31,24,0,7,0,0,0,0,0,139,31,24,0,7,375,16,359
360810916036,36, New York,081, Queens County,221,40,40,0,0,0,0,0,0,0,221,40,40,0,0,615,9,606
360810916040,36, New York,081, Queens County,0,0,0,0,0,0,0,0,0,0,0,0,0,0,0,0,0,0
360810916041,36, New York,081, Queens County,0,0,0,0,0,0,0,0,0,0,0,0,0,0,0,0,0,0
360810918000,36, New York,081, Queens County,0,0,0,0,0,0,0,0,0,0,0,0,0,0,0,0,0,0
360810918001,36, New York,081, Queens County,3,0,0,0,0,0,0,0,0,0,3,0,0,0,0,15,0,15
360810919000,36, New York,081, Queens County,0,0,0,0,0,0,0,0,0,0,0,0,0,0,0,0,0,0
360810919001,36, New York,081, Queens County,304,109,64,0,45,32,0,0,0,0,272,109,64,0,45,719,116,603
360810919002,36, New York,081, Queens County,531,192,135,0,57,42,0,0,0,0,489,192,135,0,57,985,82,903
360810919003,36, New York,081, Queens County,487,83,53,30,0,23,0,0,0,0,464,83,53,30,0,1275,57,1218
360810922000,36, New York,081, Queens County,0,0,0,0,0,0,0,0,0,0,0,0,0,0,0,0,0,0
360810922001,36, New York,081, Queens County,276,126,121,0,5,5,5,0,0,5,271,121,121,0,0,803,22,781
360810922002,36, New York,081, Queens County,183,83,63,20,0,5,0,0,0,0,178,83,63,20,0,548,73,475
360810922003,36, New York,081, Queens County,110,29,14,0,15,0,0,0,0,0,110,29,14,0,15,250,0,250
360810925001,36, New York,081, Queens County,385,148,148,0,0,55,55,55,0,0,330,93,93,0,0,1040,142,898
360810925002,36, New York,081, Queens County,292,205,66,39,100,55,35,7,0,28,237,170,59,39,72,536,49,487
360810925003,36, New York,081, Queens County,242,93,55,0,38,20,20,20,0,0,222,73,35,0,38,561,19,542
360810928000,36, New York,081, Queens County,0,0,0,0,0,0,0,0,0,0,0,0,0,0,0,0,0,0
360810928001,36, New York,081, Queens County,361,110,68,0,42,34,0,0,0,0,327,110,68,0,42,1085,72,1013
360810928002,36, New York,081, Queens County,278,125,125,0,0,0,0,0,0,0,278,125,125,0,0,676,14,662
360810928003,36, New York,081, Queens County,323,137,127,10,0,11,11,11,0,0,312,126,116,10,0,901,17,884
360810929000,36, New York,081, Queens County,0,0,0,0,0,0,0,0,0,0,0,0,0,0,0,0,0,0
360810929001,36, New York,081, Queens County,174,24,24,0,0,0,0,0,0,0,174,24,24,0,0,563,25,538
360810929002,36, New York,081, Queens County,248,80,80,0,0,20,0,0,0,0,228,80,80,0,0,514,48,466
360810929003,36, New York,081, Queens County,204,136,55,60,21,0,0,0,0,0,204,136,55,60,21,532,26,506
360810929004,36, New York,081, Queens County,286,75,55,0,20,20,20,0,0,20,266,55,55,0,0,354,67,287
360810929005,36, New York,081, Queens County,923,513,406,67,40,0,0,0,0,0,923,513,406,67,40,3082,0,3082
360810934010,36, New York,081, Queens County,0,0,0,0,0,0,0,0,0,0,0,0,0,0,0,0,0,0
360810934011,36, New York,081, Queens County,422,245,155,35,55,15,0,0,0,0,407,245,155,35,55,1382,61,1321
360810934012,36, New York,081, Queens County,252,107,77,0,30,33,21,0,0,21,219,86,77,0,9,890,221,669
360810934013,36, New York,081, Queens County,230,98,57,41,0,22,0,0,0,0,208,98,57,41,0,649,143,506
360810934020,36, New York,081, Queens County,0,0,0,0,0,0,0,0,0,0,0,0,0,0,0,0,0,0
360810934021,36, New York,081, Queens County,284,48,48,0,0,26,0,0,0,0,258,48,48,0,0,1248,239,1009
360810934022,36, New York,081, Queens County,179,95,52,11,32,60,60,28,0,32,119,35,24,11,0,554,100,454
360810934023,36, New York,081, Queens County,373,167,133,0,34,0,0,0,0,0,373,167,133,0,34,1250,8,1242
360810938000,36, New York,081, Queens County,0,0,0,0,0,0,0,0,0,0,0,0,0,0,0,0,0,0
360810938001,36, New York,081, Queens County,389,190,168,22,0,22,22,0,22,0,367,168,168,0,0,1413,22,1391
360810938002,36, New York,081, Queens County,445,164,141,23,0,41,0,0,0,0,404,164,141,23,0,1256,120,1136
360810938003,36, New York,081, Queens County,180,60,29,31,0,12,12,12,0,0,168,48,17,31,0,843,285,558
360810939000,36, New York,081, Queens County,0,0,0,0,0,0,0,0,0,0,0,0,0,0,0,0,0,0
360810939001,36, New York,081, Queens County,971,526,406,49,71,62,62,33,0,29,909,464,373,49,42,2379,127,2252
360810939002,36, New York,081, Queens County,383,145,145,0,0,0,0,0,0,0,383,145,145,0,0,905,0,905
360810939003,36, New York,081, Queens County,237,83,63,0,20,16,16,0,0,16,221,67,63,0,4,646,71,575
360810942010,36, New York,081, Queens County,0,0,0,0,0,0,0,0,0,0,0,0,0,0,0,0,0,0
360810942011,36, New York,081, Queens County,545,233,96,0,137,40,40,12,0,28,505,193,84,0,109,1550,225,1325
360810942012,36, New York,081, Queens County,277,90,14,29,47,77,62,0,29,33,200,28,14,0,14,707,209,498
360810942020,36, New York,081, Queens County,0,0,0,0,0,0,0,0,0,0,0,0,0,0,0,0,0,0
360810942021,36, New York,081, Queens County,546,311,209,19,83,41,41,13,0,28,505,270,196,19,55,1713,118,1595
360810942022,36, New York,081, Queens County,653,429,20,0,409,362,320,0,0,320,291,109,20,0,89,1330,755,575
360810942023,36, New York,081, Queens County,241,149,102,47,0,0,0,0,0,0,241,149,102,47,0,684,0,684
360810942030,36, New York,081, Queens County,0,0,0,0,0,0,0,0,0,0,0,0,0,0,0,0,0,0
360810942031,36, New York,081, Queens County,594,230,44,0,186,21,21,21,0,0,573,209,23,0,186,1476,61,1415
360810942032,36, New York,081, Queens County,422,174,24,0,150,73,73,0,0,73,349,101,24,0,77,1054,118,936
360810942033,36, New York,081, Queens County,186,60,3,57,0,13,0,0,0,0,173,60,3,57,0,525,96,429
360810942034,36, New York,081, Queens County,319,24,24,0,0,24,24,24,0,0,295,0,0,0,0,942,85,857
360810942035,36, New York,081, Queens County,275,91,56,0,35,0,0,0,0,0,275,91,56,0,35,993,180,813
360810945000,36, New York,081, Queens County,0,0,0,0,0,0,0,0,0,0,0,0,0,0,0,0,0,0
360810945001,36, New York,081, Queens County,660,263,152,0,111,19,8,8,0,0,641,255,144,0,111,1779,246,1533
360810945002,36, New York,081, Queens County,402,210,121,71,18,23,11,5,0,6,379,199,116,71,12,814,44,770
360810947001,36, New York,081, Queens County,276,91,44,23,24,0,0,0,0,0,276,91,44,23,24,493,5,488
360810947002,36, New York,081, Queens County,311,127,78,39,10,64,35,28,0,7,247,92,50,39,3,880,140,740
360810954000,36, New York,081, Queens County,0,0,0,0,0,0,0,0,0,0,0,0,0,0,0,0,0,0
360810954001,36, New York,081, Queens County,488,308,36,80,192,145,83,0,0,83,343,225,36,80,109,1323,306,1017
360810954002,36, New York,081, Queens County,352,191,146,19,26,55,55,55,0,0,297,136,91,19,26,716,55,661
360810954003,36, New York,081, Queens County,662,406,251,39,116,29,13,0,0,13,633,393,251,39,103,2067,150,1917
360810964000,36, New York,081, Queens County,0,0,0,0,0,0,0,0,0,0,0,0,0,0,0,0,0,0
360810964001,36, New York,081, Queens County,829,414,199,145,70,118,59,0,0,59,711,355,199,145,11,2104,335,1769
360810964002,36, New York,081, Queens County,896,387,313,23,51,61,38,28,0,10,835,349,285,23,41,2408,320,2088
360810972020,36, New York,081, Queens County,0,0,0,0,0,0,0,0,0,0,0,0,0,0,0,0,0,0
360810972021,36, New York,081, Queens County,683,470,51,20,399,267,191,0,12,179,416,279,51,8,220,2154,918,1236
360810972041,36, New York,081, Queens County,288,221,129,43,49,0,0,0,0,0,288,221,129,43,49,873,142,731
360810972042,36, New York,081, Queens County,237,171,0,21,150,2,0,0,0,0,235,171,0,21,150,544,57,487
360810972043,36, New York,081, Queens County,255,162,104,43,15,16,0,0,0,0,239,162,104,43,15,691,64,627
360810972051,36, New York,081, Queens County,624,421,164,0,257,302,200,26,0,174,322,221,138,0,83,1256,715,541
360810972052,36, New York,081, Queens County,254,178,79,0,99,119,90,42,0,48,135,88,37,0,51,672,280,392
360810972061,36, New York,081, Queens County,431,367,11,0,356,147,147,0,0,147,284,220,11,0,209,1061,514,547
360810972062,36, New York,081, Queens County,356,31,16,0,15,16,16,16,0,0,340,15,0,0,15,706,34,672
360810972070,36, New York,081, Queens County,0,0,0,0,0,0,0,0,0,0,0,0,0,0,0,0,0,0
360810972071,36, New York,081, Queens County,0,0,0,0,0,0,0,0,0,0,0,0,0,0,0,0,0,0
360810973000,36, New York,081, Queens County,0,0,0,0,0,0,0,0,0,0,0,0,0,0,0,0,0,0
360810973001,36, New York,081, Queens County,273,58,52,0,6,0,0,0,0,0,273,58,52,0,6,795,17,778
360810973002,36, New York,081, Queens County,133,50,17,0,33,0,0,0,0,0,133,50,17,0,33,367,40,327
360810973003,36, New York,081, Queens County,245,83,83,0,0,14,14,14,0,0,231,69,69,0,0,660,40,620
360810981000,36, New York,081, Queens County,0,0,0,0,0,0,0,0,0,0,0,0,0,0,0,0,0,0
360810981001,36, New York,081, Queens County,353,84,79,0,5,46,12,12,0,0,307,72,67,0,5,1031,128,903
360810981002,36, New York,081, Queens County,287,120,102,7,11,20,20,20,0,0,267,100,82,7,11,803,53,750
360810987000,36, New York,081, Queens County,0,0,0,0,0,0,0,0,0,0,0,0,0,0,0,0,0,0
360810987001,36, New York,081, Queens County,358,124,98,10,16,23,12,12,0,0,335,112,86,10,16,1107,84,1023
360810987002,36, New York,081, Queens County,284,82,56,14,12,25,25,11,14,0,259,57,45,0,12,874,65,809
360810991000,36, New York,081, Queens County,0,0,0,0,0,0,0,0,0,0,0,0,0,0,0,0,0,0
360810991001,36, New York,081, Queens County,452,229,161,0,68,97,77,9,0,68,355,152,152,0,0,1601,213,1388
360810991002,36, New York,081, Queens County,375,133,93,18,22,22,22,0,0,22,353,111,93,18,0,1151,62,1089
360810991003,36, New York,081, Queens County,158,63,49,14,0,0,0,0,0,0,158,63,49,14,0,379,0,379
360810991004,36, New York,081, Queens County,327,129,129,0,0,0,0,0,0,0,327,129,129,0,0,785,0,785
360810991005,36, New York,081, Queens County,423,137,137,0,0,0,0,0,0,0,423,137,137,0,0,1307,0,1307
360810992000,36, New York,081, Queens County,0,0,0,0,0,0,0,0,0,0,0,0,0,0,0,0,0,0
360810992001,36, New York,081, Queens County,790,520,268,110,142,307,292,147,28,117,483,228,121,82,25,2198,797,1401
360810992002,36, New York,081, Queens County,128,106,86,0,20,0,0,0,0,0,128,106,86,0,20,677,246,431
360810997011,36, New York,081, Queens County,308,55,55,0,0,5,0,0,0,0,303,55,55,0,0,788,14,774
360810997012,36, New York,081, Queens County,153,19,19,0,0,0,0,0,0,0,153,19,19,0,0,396,0,396
360810997013,36, New York,081, Queens County,321,143,75,36,32,21,21,1,11,9,300,122,74,25,23,933,18,915
360810997031,36, New York,081, Queens County,387,247,223,0,24,11,0,0,0,0,376,247,223,0,24,1023,22,1001
360810997032,36, New York,081, Queens County,246,67,5,0,62,0,0,0,0,0,246,67,5,0,62,1034,0,1034
360810997033,36, New York,081, Queens County,366,77,77,0,0,17,17,17,0,0,349,60,60,0,0,1113,173,940
360810997041,36, New York,081, Queens County,440,56,56,0,0,0,0,0,0,0,440,56,56,0,0,1477,44,1433
360810997042,36, New York,081, Queens County,330,166,112,0,54,57,37,0,0,37,273,129,112,0,17,1020,126,894
360810997043,36, New York,081, Queens County,628,274,258,0,16,0,0,0,0,0,628,274,258,0,16,2156,122,2034
360810997044,36, New York,081, Queens County,51,23,23,0,0,0,0,0,0,0,51,23,23,0,0,164,14,150
360810997045,36, New York,081, Queens County,214,46,30,16,0,23,0,0,0,0,191,46,30,16,0,1285,111,1174
360810997050,36, New York,081, Queens County,0,0,0,0,0,0,0,0,0,0,0,0,0,0,0,0,0,0
360810997051,36, New York,081, Queens County,702,102,48,28,26,53,0,0,0,0,649,102,48,28,26,2134,137,1997
360810998011,36, New York,081, Queens County,331,125,49,0,76,23,23,0,0,23,308,102,49,0,53,943,23,920
360810998012,36, New York,081, Queens County,381,185,165,0,20,42,42,22,0,20,339,143,143,0,0,714,120,594
360810998013,36, New York,081, Queens County,362,146,68,0,78,0,0,0,0,0,362,146,68,0,78,1281,246,1035
360810998014,36, New York,081, Queens County,461,184,87,0,97,0,0,0,0,0,461,184,87,0,97,1439,170,1269
360810998015,36, New York,081, Queens County,393,240,184,56,0,114,43,43,0,0,279,197,141,56,0,1038,409,629
360810998020,36, New York,081, Queens County,0,0,0,0,0,0,0,0,0,0,0,0,0,0,0,0,0,0
360810998021,36, New York,081, Queens County,668,362,140,14,208,114,57,0,0,57,554,305,140,14,151,1680,516,1164
360810998022,36, New York,081, Queens County,405,316,169,50,97,27,27,0,0,27,378,289,169,50,70,1297,185,1112
360810998023,36, New York,081, Queens County,207,0,0,0,0,39,0,0,0,0,168,0,0,0,0,1037,542,495
360810999001,36, New York,081, Queens County,0,0,0,0,0,0,0,0,0,0,0,0,0,0,0,0,0,0
360811008010,36, New York,081, Queens County,0,0,0,0,0,0,0,0,0,0,0,0,0,0,0,0,0,0
360811008011,36, New York,081, Queens County,145,100,100,0,0,18,9,9,0,0,127,91,91,0,0,383,57,326
360811008012,36, New York,081, Queens County,430,228,134,0,94,19,19,0,0,19,411,209,134,0,75,1796,85,1711
360811008031,36, New York,081, Queens County,432,258,61,71,126,63,0,0,0,0,369,258,61,71,126,972,189,783
360811008032,36, New York,081, Queens County,409,127,50,0,77,84,84,7,0,77,325,43,43,0,0,1426,144,1282
360811008040,36, New York,081, Queens County,0,0,0,0,0,0,0,0,0,0,0,0,0,0,0,0,0,0
360811008041,36, New York,081, Queens County,769,410,306,21,83,43,42,0,0,42,726,368,306,21,41,2574,128,2446
360811008042,36, New York,081, Queens County,337,124,38,77,9,17,17,0,17,0,320,107,38,60,9,895,60,835
360811010020,36, New York,081, Queens County,0,0,0,0,0,0,0,0,0,0,0,0,0,0,0,0,0,0
360811010021,36, New York,081, Queens County,619,418,358,13,47,22,22,22,0,0,597,396,336,13,47,1594,71,1523
360811010022,36, New York,081, Queens County,625,346,237,0,109,118,37,0,0,37,507,309,237,0,72,1595,553,1042
360811010031,36, New York,081, Queens County,237,145,50,0,95,97,44,0,0,44,140,101,50,0,51,777,340,437
360811010032,36, New York,081, Queens County,52,17,17,0,0,0,0,0,0,0,52,17,17,0,0,70,0,70
360811010033,36, New York,081, Queens County,450,356,273,22,61,0,0,0,0,0,450,356,273,22,61,955,42,913
360811010040,36, New York,081, Queens County,0,0,0,0,0,0,0,0,0,0,0,0,0,0,0,0,0,0
360811010041,36, New York,081, Queens County,539,264,195,12,57,96,96,44,12,40,443,168,151,0,17,1132,217,915
360811010042,36, New York,081, Queens County,322,115,64,0,51,20,20,0,0,20,302,95,64,0,31,1138,164,974
360811010043,36, New York,081, Queens County,407,139,72,19,48,72,19,0,19,0,335,120,72,0,48,1191,417,774
360811010044,36, New York,081, Queens County,0,0,0,0,0,0,0,0,0,0,0,0,0,0,0,0,0,0
360811010045,36, New York,081, Queens County,149,27,0,27,0,30,0,0,0,0,119,27,0,27,0,516,98,418
360811017001,36, New York,081, Queens County,277,180,159,21,0,0,0,0,0,0,277,180,159,21,0,783,28,755
360811017002,36, New York,081, Queens County,176,16,16,0,0,0,0,0,0,0,176,16,16,0,0,489,0,489
360811017003,36, New York,081, Queens County,76,0,0,0,0,0,0,0,0,0,76,0,0,0,0,241,13,228
360811017004,36, New York,081, Queens County,375,147,147,0,0,36,18,18,0,0,339,129,129,0,0,1122,143,979
360811017005,36, New York,081, Queens County,176,77,77,0,0,0,0,0,0,0,176,77,77,0,0,405,17,388
360811017006,36, New York,081, Queens County,304,113,113,0,0,0,0,0,0,0,304,113,113,0,0,882,0,882
360811017007,36, New York,081, Queens County,241,94,50,0,44,0,0,0,0,0,241,94,50,0,44,735,197,538
360811029001,36, New York,081, Queens County,485,213,165,11,37,40,10,10,0,0,445,203,155,11,37,1546,137,1409
360811029002,36, New York,081, Queens County,410,175,130,32,13,11,11,11,0,0,399,164,119,32,13,968,48,920
360811032011,36, New York,081, Queens County,596,374,62,59,253,78,62,0,0,62,518,312,62,59,191,1645,93,1552
360811032012,36, New York,081, Queens County,458,330,157,0,173,119,119,0,0,119,339,211,157,0,54,977,147,830
360811032013,36, New York,081, Queens County,455,265,23,89,153,205,155,0,38,117,250,110,23,51,36,1122,384,738
360811032021,36, New York,081, Queens County,279,178,65,32,81,79,51,0,0,51,200,127,65,32,30,361,25,336
360811032022,36, New York,081, Queens County,356,215,215,0,0,31,31,31,0,0,325,184,184,0,0,1066,115,951
360811032023,36, New York,081, Queens County,897,525,457,0,68,52,0,0,0,0,845,525,457,0,68,1315,83,1232
360811032024,36, New York,081, Queens County,236,194,117,0,77,29,29,0,0,29,207,165,117,0,48,478,74,404
360811033001,36, New York,081, Queens County,467,187,90,86,11,21,11,0,0,11,446,176,90,86,0,1320,116,1204
360811033002,36, New York,081, Queens County,250,101,69,0,32,11,0,0,0,0,239,101,69,0,32,718,24,694
360811033003,36, New York,081, Queens County,168,97,89,0,8,16,0,0,0,0,152,97,89,0,8,439,49,390
360811033004,36, New York,081, Queens County,327,62,52,0,10,31,0,0,0,0,296,62,52,0,10,866,100,766
360811039001,36, New York,081, Queens County,453,157,0,98,59,15,0,0,0,0,438,157,0,98,59,1259,62,1197
360811039002,36, New York,081, Queens County,775,364,266,0,98,34,17,0,0,17,741,347,266,0,81,1751,112,1639
360811039003,36, New York,081, Queens County,169,114,60,0,54,21,0,0,0,0,148,114,60,0,54,574,163,411
360811039004,36, New York,081, Queens County,483,107,76,0,31,22,0,0,0,0,461,107,76,0,31,1233,83,1150
360811047001,36, New York,081, Queens County,218,48,48,0,0,0,0,0,0,0,218,48,48,0,0,348,27,321
360811047002,36, New York,081, Queens County,367,207,159,0,48,53,53,41,0,12,314,154,118,0,36,937,54,883
360811047003,36, New York,081, Queens County,578,112,112,0,0,38,0,0,0,0,540,112,112,0,0,862,140,722
360811047004,36, New York,081, Queens County,533,105,105,0,0,12,0,0,0,0,521,105,105,0,0,1002,87,915
360811047005,36, New York,081, Queens County,248,103,74,29,0,24,14,14,0,0,224,89,60,29,0,555,76,479
360811059001,36, New York,081, Queens County,297,137,113,0,24,0,0,0,0,0,297,137,113,0,24,769,20,749
360811059002,36, New York,081, Queens County,259,152,152,0,0,7,0,0,0,0,252,152,152,0,0,561,16,545
360811059003,36, New York,081, Queens County,138,11,11,0,0,0,0,0,0,0,138,11,11,0,0,343,1,342
360811059004,36, New York,081, Queens County,484,257,231,0,26,59,59,59,0,0,425,198,172,0,26,1025,7,1018
360811072011,36, New York,081, Queens County,551,191,172,0,19,19,13,13,0,0,532,178,159,0,19,1576,115,1461
360811072020,36, New York,081, Queens County,0,0,0,0,0,0,0,0,0,0,0,0,0,0,0,0,0,0
360811072021,36, New York,081, Queens County,0,0,0,0,0,0,0,0,0,0,0,0,0,0,0,0,0,0
360811085001,36, New York,081, Queens County,286,27,27,0,0,0,0,0,0,0,286,27,27,0,0,794,14,780
360811085002,36, New York,081, Queens County,174,103,83,0,20,4,4,0,0,4,170,99,83,0,16,477,30,447
360811085003,36, New York,081, Queens County,250,88,68,8,12,5,0,0,0,0,245,88,68,8,12,568,38,530
360811093000,36, New York,081, Queens County,0,0,0,0,0,0,0,0,0,0,0,0,0,0,0,0,0,0
360811093001,36, New York,081, Queens County,278,72,72,0,0,21,0,0,0,0,257,72,72,0,0,804,44,760
360811093002,36, New York,081, Queens County,155,63,52,11,0,37,18,18,0,0,118,45,34,11,0,485,86,399
360811093003,36, New York,081, Queens County,312,78,78,0,0,20,20,20,0,0,292,58,58,0,0,1051,64,987
360811097001,36, New York,081, Queens County,155,17,17,0,0,6,0,0,0,0,149,17,17,0,0,425,28,397
360811097002,36, New York,081, Queens County,136,54,49,0,5,0,0,0,0,0,136,54,49,0,5,394,2,392
360811097003,36, New York,081, Queens County,207,70,34,0,36,0,0,0,0,0,207,70,34,0,36,519,0,519
360811099001,36, New York,081, Queens County,641,248,119,91,38,24,8,8,0,0,617,240,111,91,38,1305,38,1267
360811099002,36, New York,081, Queens County,256,115,115,0,0,0,0,0,0,0,256,115,115,0,0,615,17,598
360811099003,36, New York,081, Queens County,135,28,20,0,8,17,9,9,0,0,118,19,11,0,8,376,41,335
360811113000,36, New York,081, Queens County,0,0,0,0,0,0,0,0,0,0,0,0,0,0,0,0,0,0
360811113001,36, New York,081, Queens County,180,67,50,0,17,17,17,0,0,17,163,50,50,0,0,466,36,430
360811113002,36, New York,081, Queens County,216,96,45,0,51,22,16,0,0,16,194,80,45,0,35,678,130,548
360811113003,36, New York,081, Queens County,255,100,100,0,0,0,0,0,0,0,255,100,100,0,0,633,5,628
360811123001,36, New York,081, Queens County,291,148,116,0,32,47,40,15,0,25,244,108,101,0,7,543,37,506
360811123002,36, New York,081, Queens County,274,125,86,17,22,0,0,0,0,0,274,125,86,17,22,824,25,799
360811129001,36, New York,081, Queens County,177,53,53,0,0,0,0,0,0,0,177,53,53,0,0,356,0,356
360811129002,36, New York,081, Queens County,146,75,75,0,0,0,0,0,0,0,146,75,75,0,0,471,15,456
360811129003,36, New York,081, Queens County,283,107,49,0,58,9,0,0,0,0,274,107,49,0,58,851,43,808
360811133001,36, New York,081, Queens County,234,34,20,0,14,6,6,0,0,6,228,28,20,0,8,612,21,591
360811133002,36, New York,081, Queens County,158,75,60,0,15,5,0,0,0,0,153,75,60,0,15,375,23,352
360811139001,36, New York,081, Queens County,311,193,193,0,0,21,0,0,0,0,290,193,193,0,0,545,35,510
360811139002,36, New York,081, Queens County,390,243,172,71,0,39,39,39,0,0,351,204,133,71,0,1018,80,938
360811139003,36, New York,081, Queens County,314,108,96,0,12,55,23,11,0,12,259,85,85,0,0,799,123,676
360811141001,36, New York,081, Queens County,440,182,174,0,8,0,0,0,0,0,440,182,174,0,8,1140,23,1117
360811141002,36, New York,081, Queens County,219,64,57,0,7,12,6,6,0,0,207,58,51,0,7,651,36,615
360811147001,36, New York,081, Queens County,254,128,116,0,12,5,5,5,0,0,249,123,111,0,12,620,0,620
360811147002,36, New York,081, Queens County,277,119,106,0,13,17,0,0,0,0,260,119,106,0,13,676,33,643
360811151001,36, New York,081, Queens County,242,78,78,0,0,8,0,0,0,0,234,78,78,0,0,751,30,721
360811155001,36, New York,081, Queens County,336,135,109,0,26,38,17,16,0,1,298,118,93,0,25,904,50,854
360811155002,36, New York,081, Queens County,120,47,47,0,0,13,0,0,0,0,107,47,47,0,0,295,63,232
360811157001,36, New York,081, Queens County,220,81,49,7,25,7,7,0,7,0,213,74,49,0,25,653,29,624
360811157002,36, New York,081, Queens County,422,168,121,6,41,78,23,23,0,0,344,145,98,6,41,933,165,768
360811157003,36, New York,081, Queens County,226,65,54,4,7,42,27,20,0,7,184,38,34,4,0,439,118,321
360811159001,36, New York,081, Queens County,309,176,115,61,0,0,0,0,0,0,309,176,115,61,0,654,84,570
360811159002,36, New York,081, Queens County,210,35,35,0,0,34,11,11,0,0,176,24,24,0,0,539,43,496
360811159003,36, New York,081, Queens County,686,303,201,0,102,68,42,0,0,42,618,261,201,0,60,1225,158,1067
360811161001,36, New York,081, Queens County,233,47,14,0,33,26,14,14,0,0,207,33,0,0,33,521,115,406
360811161002,36, New York,081, Queens County,665,177,144,33,0,233,50,50,0,0,432,127,94,33,0,1311,262,1049
360811163011,36, New York,081, Queens County,327,89,51,0,38,76,11,11,0,0,251,78,40,0,38,608,216,392
360811163012,36, New York,081, Queens County,482,274,274,0,0,231,210,210,0,0,251,64,64,0,0,312,43,269
360811163013,36, New York,081, Queens County,460,159,74,20,65,36,36,0,0,36,424,123,74,20,29,515,20,495
360811163021,36, New York,081, Queens County,428,104,67,0,37,45,24,24,0,0,383,80,43,0,37,1064,170,894
360811163022,36, New York,081, Queens County,298,143,125,0,18,104,75,57,0,18,194,68,68,0,0,623,50,573
360811167001,36, New York,081, Queens County,420,182,141,14,27,83,59,49,0,10,337,123,92,14,17,821,136,685
360811171001,36, New York,081, Queens County,158,67,13,0,54,5,0,0,0,0,153,67,13,0,54,416,43,373
360811171002,36, New York,081, Queens County,191,86,33,13,40,27,27,0,8,19,164,59,33,5,21,444,91,353
360811171003,36, New York,081, Queens County,323,93,54,0,39,32,26,4,0,22,291,67,50,0,17,679,39,640
360811175001,36, New York,081, Queens County,245,90,67,0,23,0,0,0,0,0,245,90,67,0,23,570,0,570
360811175002,36, New York,081, Queens County,285,111,102,0,9,35,0,0,0,0,250,111,102,0,9,662,97,565
360811175003,36, New York,081, Queens County,207,56,25,0,31,31,20,0,0,20,176,36,25,0,11,542,66,476
360811175004,36, New York,081, Queens County,245,116,106,10,0,41,8,8,0,0,204,108,98,10,0,828,96,732
360811175005,36, New York,081, Queens County,112,47,47,0,0,9,0,0,0,0,103,47,47,0,0,215,22,193
360811181001,36, New York,081, Queens County,167,46,32,8,6,6,6,0,0,6,161,40,32,8,0,517,35,482
360811181002,36, New York,081, Queens County,308,91,23,0,68,39,34,0,0,34,269,57,23,0,34,852,37,815
360811185001,36, New York,081, Queens County,278,68,54,0,14,0,0,0,0,0,278,68,54,0,14,681,8,673
360811185002,36, New York,081, Queens County,212,43,32,11,0,31,0,0,0,0,181,43,32,11,0,451,60,391
360811187001,36, New York,081, Queens County,378,193,176,17,0,7,7,7,0,0,371,186,169,17,0,708,34,674
360811187002,36, New York,081, Queens County,283,118,118,0,0,45,25,25,0,0,238,93,93,0,0,594,69,525
360811189001,36, New York,081, Queens County,243,85,68,17,0,25,17,0,17,0,218,68,68,0,0,740,72,668
360811189002,36, New York,081, Queens County,182,38,38,0,0,0,0,0,0,0,182,38,38,0,0,462,33,429
360811191001,36, New York,081, Queens County,552,160,125,0,35,106,42,42,0,0,446,118,83,0,35,959,204,755
360811191002,36, New York,081, Queens County,244,13,13,0,0,11,10,10,0,0,233,3,3,0,0,503,85,418
360811193001,36, New York,081, Queens County,310,83,59,0,24,25,12,0,0,12,285,71,59,0,12,934,61,873
360811193002,36, New York,081, Queens County,163,54,43,11,0,29,13,13,0,0,134,41,30,11,0,423,31,392
360811195001,36, New York,081, Queens County,375,92,92,0,0,0,0,0,0,0,375,92,92,0,0,923,17,906
360811199001,36, New York,081, Queens County,371,92,74,7,11,32,7,0,7,0,339,85,74,0,11,946,112,834
360811201001,36, New York,081, Queens County,333,99,72,0,27,50,7,6,0,1,283,92,66,0,26,782,50,732
360811203001,36, New York,081, Queens County,156,54,54,0,0,7,7,7,0,0,149,47,47,0,0,408,15,393
360811203002,36, New York,081, Queens County,244,89,45,4,40,38,14,0,0,14,206,75,45,4,26,360,29,331
360811205001,36, New York,081, Queens County,329,71,39,8,24,75,24,0,0,24,254,47,39,8,0,534,63,471
360811205002,36, New York,081, Queens County,184,70,22,0,48,40,0,0,0,0,144,70,22,0,48,859,296,563
360811207011,36, New York,081, Queens County,515,165,129,3,33,41,7,7,0,0,474,158,122,3,33,1022,41,981
360811207012,36, New York,081, Queens County,277,89,38,0,51,6,0,0,0,0,271,89,38,0,51,962,35,927
360811207021,36, New York,081, Queens County,0,0,0,0,0,0,0,0,0,0,0,0,0,0,0,0,0,0
360811211001,36, New York,081, Queens County,0,0,0,0,0,0,0,0,0,0,0,0,0,0,0,0,0,0
360811215001,36, New York,081, Queens County,223,117,105,12,0,0,0,0,0,0,223,117,105,12,0,606,42,564
360811215002,36, New York,081, Queens County,269,170,102,40,28,14,14,14,0,0,255,156,88,40,28,811,44,767
360811215003,36, New York,081, Queens County,402,165,113,14,38,51,32,10,0,22,351,133,103,14,16,1039,41,998
360811223001,36, New York,081, Queens County,664,476,406,0,70,36,36,0,0,36,628,440,406,0,34,894,12,882
360811223002,36, New York,081, Queens County,156,64,64,0,0,0,0,0,0,0,156,64,64,0,0,550,12,538
360811223003,36, New York,081, Queens County,356,39,34,0,5,0,0,0,0,0,356,39,34,0,5,921,52,869
360811227021,36, New York,081, Queens County,399,133,91,17,25,137,94,69,0,25,262,39,22,17,0,1131,320,811
360811227022,36, New York,081, Queens County,430,121,0,0,121,168,0,0,0,0,262,121,0,0,121,1225,581,644
360811227023,36, New York,081, Queens County,637,428,183,30,215,208,192,0,30,162,429,236,183,0,53,1420,522,898
360811227024,36, New York,081, Queens County,132,104,71,0,33,33,33,0,0,33,99,71,71,0,0,446,100,346
360811227025,36, New York,081, Queens County,53,8,8,0,0,24,0,0,0,0,29,8,8,0,0,170,83,87
360811227031,36, New York,081, Queens County,105,37,37,0,0,0,0,0,0,0,105,37,37,0,0,401,0,401
360811227032,36, New York,081, Queens County,880,612,475,70,67,31,31,0,0,31,849,581,475,70,36,1924,31,1893
360811227033,36, New York,081, Queens County,157,127,95,0,32,0,0,0,0,0,157,127,95,0,32,443,32,411
360811227034,36, New York,081, Queens County,681,198,145,0,53,32,32,0,0,32,649,166,145,0,21,1965,88,1877
360811227035,36, New York,081, Queens County,162,31,31,0,0,72,0,0,0,0,90,31,31,0,0,487,140,347
360811227041,36, New York,081, Queens County,309,144,86,0,58,24,24,24,0,0,285,120,62,0,58,1090,31,1059
360811227042,36, New York,081, Queens County,503,321,241,0,80,0,0,0,0,0,503,321,241,0,80,1780,31,1749
360811227043,36, New York,081, Queens County,270,84,71,0,13,30,3,3,0,0,240,81,68,0,13,724,126,598
360811241001,36, New York,081, Queens County,571,116,93,14,9,6,0,0,0,0,565,116,93,14,9,1220,55,1165
360811241002,36, New York,081, Queens County,265,91,58,0,33,31,18,18,0,0,234,73,40,0,33,604,26,578
360811241003,36, New York,081, Queens County,218,88,72,0,16,30,11,11,0,0,188,77,61,0,16,815,186,629
360811247001,36, New York,081, Queens County,167,58,41,8,9,10,0,0,0,0,157,58,41,8,9,484,43,441
360811247002,36, New York,081, Queens County,555,209,170,0,39,12,0,0,0,0,543,209,170,0,39,732,25,707
360811247003,36, New York,081, Queens County,379,98,98,0,0,5,0,0,0,0,374,98,98,0,0,951,5,946
360811257001,36, New York,081, Queens County,324,203,203,0,0,36,17,17,0,0,288,186,186,0,0,680,82,598
360811257002,36, New York,081, Queens County,192,71,71,0,0,0,0,0,0,0,192,71,71,0,0,766,33,733
360811257003,36, New York,081, Queens County,170,75,52,0,23,0,0,0,0,0,170,75,52,0,23,639,169,470
360811265001,36, New York,081, Queens County,233,45,45,0,0,0,0,0,0,0,233,45,45,0,0,649,53,596
360811265002,36, New York,081, Queens County,300,65,65,0,0,0,0,0,0,0,300,65,65,0,0,956,32,924
360811267001,36, New York,081, Queens County,195,137,131,6,0,0,0,0,0,0,195,137,131,6,0,517,118,399
360811267002,36, New York,081, Queens County,183,133,118,0,15,25,20,5,0,15,158,113,113,0,0,508,120,388
360811267003,36, New York,081, Queens County,203,61,46,0,15,46,46,32,0,14,157,15,14,0,1,602,75,527
360811277001,36, New York,081, Queens County,268,68,23,0,45,11,0,0,0,0,257,68,23,0,45,786,36,750
360811277002,36, New York,081, Queens County,226,41,29,0,12,12,12,0,0,12,214,29,29,0,0,473,12,461
360811277003,36, New York,081, Queens County,83,28,28,0,0,0,0,0,0,0,83,28,28,0,0,335,27,308
360811277004,36, New York,081, Queens County,321,124,95,0,29,0,0,0,0,0,321,124,95,0,29,832,0,832
360811283001,36, New York,081, Queens County,0,0,0,0,0,0,0,0,0,0,0,0,0,0,0,0,0,0
360811291021,36, New York,081, Queens County,257,74,74,0,0,0,0,0,0,0,257,74,74,0,0,606,0,606
360811291022,36, New York,081, Queens County,255,136,136,0,0,0,0,0,0,0,255,136,136,0,0,672,12,660
360811291023,36, New York,081, Queens County,217,103,103,0,0,1,0,0,0,0,216,103,103,0,0,554,3,551
360811291024,36, New York,081, Queens County,255,148,102,0,46,27,27,27,0,0,228,121,75,0,46,758,89,669
360811291031,36, New York,081, Queens County,412,197,181,10,6,0,0,0,0,0,412,197,181,10,6,1250,83,1167
360811291032,36, New York,081, Queens County,461,229,218,0,11,63,49,49,0,0,398,180,169,0,11,1277,161,1116
360811291033,36, New York,081, Queens County,221,105,105,0,0,28,28,28,0,0,193,77,77,0,0,574,72,502
360811291041,36, New York,081, Queens County,93,16,9,7,0,0,0,0,0,0,93,16,9,7,0,386,5,381
360811291042,36, New York,081, Queens County,239,69,58,0,11,7,0,0,0,0,232,69,58,0,11,899,32,867
360811291043,36, New York,081, Queens County,246,91,54,0,37,12,0,0,0,0,234,91,54,0,37,592,67,525
360811291044,36, New York,081, Queens County,183,71,65,0,6,0,0,0,0,0,183,71,65,0,6,439,1,438
360811291045,36, New York,081, Queens County,316,138,125,0,13,41,0,0,0,0,275,138,125,0,13,949,129,820
360811301001,36, New York,081, Queens County,298,78,66,0,12,69,0,0,0,0,229,78,66,0,12,537,21,516
360811301002,36, New York,081, Queens County,295,63,17,0,46,10,0,0,0,0,285,63,17,0,46,802,52,750
360811301003,36, New York,081, Queens County,100,66,55,0,11,0,0,0,0,0,100,66,55,0,11,290,0,290
360811301004,36, New York,081, Queens County,483,76,56,11,9,9,0,0,0,0,474,76,56,11,9,1470,77,1393
360811333001,36, New York,081, Queens County,265,127,117,10,0,32,0,0,0,0,233,127,117,10,0,766,101,665
360811333002,36, New York,081, Queens County,179,13,13,0,0,0,0,0,0,0,179,13,13,0,0,507,21,486
360811333003,36, New York,081, Queens County,211,55,54,1,0,1,1,0,1,0,210,54,54,0,0,640,52,588
360811333004,36, New York,081, Queens County,505,132,132,0,0,11,0,0,0,0,494,132,132,0,0,1059,31,1028
360811339001,36, New York,081, Queens County,366,150,122,15,13,20,10,10,0,0,346,140,112,15,13,934,61,873
360811341001,36, New York,081, Queens County,437,80,43,0,37,7,0,0,0,0,430,80,43,0,37,1122,55,1067
360811341002,36, New York,081, Queens County,194,121,97,0,24,18,18,0,0,18,176,103,97,0,6,431,18,413
360811341003,36, New York,081, Queens County,293,77,44,0,33,23,0,0,0,0,270,77,44,0,33,988,100,888
360811347011,36, New York,081, Queens County,697,347,218,20,109,111,32,0,0,32,586,315,218,20,77,1717,191,1526
360811347012,36, New York,081, Queens County,583,239,200,20,19,97,66,66,0,0,486,173,134,20,19,1558,263,1295
360811347013,36, New York,081, Queens County,114,68,39,0,29,0,0,0,0,0,114,68,39,0,29,253,0,253
360811347021,36, New York,081, Queens County,568,249,143,15,91,73,48,33,0,15,495,201,110,15,76,1374,159,1215
360811347022,36, New York,081, Queens County,528,268,255,0,13,60,0,0,0,0,468,268,255,0,13,1217,121,1096
360811347023,36, New York,081, Queens County,0,0,0,0,0,0,0,0,0,0,0,0,0,0,0,11,4,7
360811367001,36, New York,081, Queens County,121,46,23,0,23,0,0,0,0,0,121,46,23,0,23,361,0,361
360811367002,36, New York,081, Queens County,39,20,20,0,0,0,0,0,0,0,39,20,20,0,0,275,16,259
360811367003,36, New York,081, Queens County,167,59,42,0,17,0,0,0,0,0,167,59,42,0,17,849,7,842
360811367004,36, New York,081, Queens County,603,168,150,0,18,42,0,0,0,0,561,168,150,0,18,1490,94,1396
360811367005,36, New York,081, Queens County,255,204,204,0,0,0,0,0,0,0,255,204,204,0,0,400,16,384
360811367006,36, New York,081, Queens County,528,299,249,8,42,26,0,0,0,0,502,299,249,8,42,850,17,833
360811377001,36, New York,081, Queens County,457,95,37,44,14,0,0,0,0,0,457,95,37,44,14,1366,7,1359
360811377002,36, New York,081, Queens County,651,478,363,115,0,74,22,22,0,0,577,456,341,115,0,1742,42,1700
360811377003,36, New York,081, Queens County,454,204,204,0,0,22,22,22,0,0,432,182,182,0,0,1261,49,1212
360811377004,36, New York,081, Queens County,350,131,90,0,41,0,0,0,0,0,350,131,90,0,41,795,31,764
360811385011,36, New York,081, Queens County,190,66,66,0,0,48,28,28,0,0,142,38,38,0,0,353,38,315
360811385012,36, New York,081, Queens County,464,201,148,0,53,11,0,0,0,0,453,201,148,0,53,849,0,849
360811385013,36, New York,081, Queens County,288,135,124,0,11,29,29,29,0,0,259,106,95,0,11,575,0,575
360811385014,36, New York,081, Queens County,337,122,108,0,14,25,25,11,0,14,312,97,97,0,0,747,14,733
360811385021,36, New York,081, Queens County,0,0,0,0,0,0,0,0,0,0,0,0,0,0,0,67,30,37
360811399001,36, New York,081, Queens County,125,43,22,21,0,27,4,4,0,0,98,39,18,21,0,320,48,272
360811399002,36, New York,081, Queens County,313,110,83,11,16,10,4,4,0,0,303,106,79,11,16,816,18,798
360811403001,36, New York,081, Queens County,354,129,129,0,0,73,0,0,0,0,281,129,129,0,0,861,141,720
360811403002,36, New York,081, Queens County,340,95,76,19,0,8,0,0,0,0,332,95,76,19,0,992,22,970
360811409011,36, New York,081, Queens County,354,172,150,4,18,5,5,5,0,0,349,167,145,4,18,724,6,718
360811409021,36, New York,081, Queens County,320,92,59,18,15,69,4,0,0,4,251,88,59,18,11,829,58,771
360811409022,36, New York,081, Queens County,300,132,94,0,38,21,0,0,0,0,279,132,94,0,38,740,37,703
360811417001,36, New York,081, Queens County,279,84,68,16,0,140,56,56,0,0,139,28,12,16,0,728,402,326
360811417002,36, New York,081, Queens County,359,162,94,30,38,53,5,0,0,5,306,157,94,30,33,1009,232,777
360811417003,36, New York,081, Queens County,124,13,13,0,0,0,0,0,0,0,124,13,13,0,0,425,0,425
360811417004,36, New York,081, Queens County,432,173,148,0,25,37,0,0,0,0,395,173,148,0,25,989,84,905
360811417005,36, New York,081, Queens County,73,33,10,0,23,0,0,0,0,0,73,33,10,0,23,93,13,80
360811429001,36, New York,081, Queens County,213,97,97,0,0,0,0,0,0,0,213,97,97,0,0,401,0,401
360811429002,36, New York,081, Queens County,326,98,98,0,0,9,0,0,0,0,317,98,98,0,0,1031,16,1015
360811429003,36, New York,081, Queens County,268,126,118,8,0,0,0,0,0,0,268,126,118,8,0,484,26,458
360811429004,36, New York,081, Queens County,204,90,73,17,0,9,9,0,9,0,195,81,73,8,0,569,37,532
360811435001,36, New York,081, Queens County,299,101,65,11,25,11,11,7,0,4,288,90,58,11,21,761,50,711
360811435002,36, New York,081, Queens County,313,189,176,0,13,0,0,0,0,0,313,189,176,0,13,910,20,890
360811441001,36, New York,081, Queens County,331,29,29,0,0,34,0,0,0,0,297,29,29,0,0,663,107,556
360811441002,36, New York,081, Queens County,134,23,23,0,0,22,0,0,0,0,112,23,23,0,0,441,25,416
360811441003,36, New York,081, Queens County,157,74,63,0,11,30,30,30,0,0,127,44,33,0,11,515,69,446
360811441004,36, New York,081, Queens County,242,31,31,0,0,9,9,9,0,0,233,22,22,0,0,675,0,675
360811447001,36, New York,081, Queens County,265,122,95,5,22,18,1,0,0,1,247,121,95,5,21,867,294,573
360811447002,36, New York,081, Queens County,550,198,153,7,38,18,18,0,0,18,532,180,153,7,20,1234,86,1148
360811451011,36, New York,081, Queens County,272,100,83,17,0,12,4,4,0,0,260,96,79,17,0,709,70,639
360811451021,36, New York,081, Queens County,383,123,91,19,13,21,0,0,0,0,362,123,91,19,13,996,54,942
360811451022,36, New York,081, Queens County,390,186,89,13,84,27,22,0,0,22,363,164,89,13,62,862,82,780
360811459001,36, New York,081, Queens County,155,53,53,0,0,6,6,6,0,0,149,47,47,0,0,359,26,333
360811459002,36, New York,081, Queens County,332,72,56,8,8,24,24,8,8,8,308,48,48,0,0,887,43,844
360811459003,36, New York,081, Queens County,280,86,86,0,0,0,0,0,0,0,280,86,86,0,0,498,25,473
360811463001,36, New York,081, Queens County,273,68,45,1,22,29,0,0,0,0,244,68,45,1,22,1085,63,1022
360811463002,36, New York,081, Queens County,270,136,76,0,60,0,0,0,0,0,270,136,76,0,60,595,15,580
360811467001,36, New York,081, Queens County,242,50,33,17,0,10,1,1,0,0,232,49,32,17,0,719,74,645
360811467002,36, New York,081, Queens County,209,43,0,43,0,0,0,0,0,0,209,43,0,43,0,668,41,627
360811467003,36, New York,081, Queens County,278,79,71,0,8,0,0,0,0,0,278,79,71,0,8,701,35,666
360811471001,36, New York,081, Queens County,464,210,204,0,6,44,18,12,0,6,420,192,192,0,0,1626,124,1502
360811471002,36, New York,081, Queens County,331,78,22,10,46,39,6,0,0,6,292,72,22,10,40,1051,134,917
360811479001,36, New York,081, Queens County,353,127,105,0,22,24,24,24,0,0,329,103,81,0,22,829,60,769
360811479002,36, New York,081, Queens County,376,177,149,28,0,25,0,0,0,0,351,177,149,28,0,1295,130,1165
360811479003,36, New York,081, Queens County,433,189,82,0,107,107,98,0,0,98,326,91,82,0,9,947,127,820
360811483000,36, New York,081, Queens County,0,0,0,0,0,0,0,0,0,0,0,0,0,0,0,0,0,0
360811483001,36, New York,081, Queens County,277,99,69,0,30,67,1,1,0,0,210,98,68,0,30,582,135,447
360811483002,36, New York,081, Queens County,134,50,50,0,0,5,0,0,0,0,129,50,50,0,0,341,10,331
360811483003,36, New York,081, Queens County,300,95,95,0,0,7,0,0,0,0,293,95,95,0,0,677,13,664
360811483004,36, New York,081, Queens County,162,78,69,0,9,0,0,0,0,0,162,78,69,0,9,389,0,389
360811507011,36, New York,081, Queens County,308,165,156,0,9,0,0,0,0,0,308,165,156,0,9,765,9,756
360811507012,36, New York,081, Queens County,379,86,86,0,0,0,0,0,0,0,379,86,86,0,0,963,8,955
360811507013,36, New York,081, Queens County,180,73,48,3,22,31,0,0,0,0,149,73,48,3,22,462,87,375
360811507021,36, New York,081, Queens County,253,110,91,19,0,10,10,10,0,0,243,100,81,19,0,733,30,703
360811507022,36, New York,081, Queens County,148,63,57,0,6,0,0,0,0,0,148,63,57,0,6,422,29,393
360811507023,36, New York,081, Queens County,272,20,20,0,0,0,0,0,0,0,272,20,20,0,0,786,36,750
360811507024,36, New York,081, Queens County,89,47,37,10,0,1,0,0,0,0,88,47,37,10,0,276,25,251
360811529011,36, New York,081, Queens County,376,148,134,0,14,0,0,0,0,0,376,148,134,0,14,1015,124,891
360811529012,36, New York,081, Queens County,738,150,117,16,17,23,0,0,0,0,715,150,117,16,17,2363,150,2213
360811529013,36, New York,081, Queens County,456,136,122,0,14,85,69,69,0,0,371,67,53,0,14,1263,260,1003
360811529021,36, New York,081, Queens County,285,12,0,0,12,0,0,0,0,0,285,12,0,0,12,780,14,766
360811529022,36, New York,081, Queens County,265,27,27,0,0,0,0,0,0,0,265,27,27,0,0,814,12,802
360811529023,36, New York,081, Queens County,428,216,205,0,11,1,0,0,0,0,427,216,205,0,11,1681,73,1608
360811529024,36, New York,081, Queens County,695,387,369,18,0,0,0,0,0,0,695,387,369,18,0,1744,26,1718
360811551011,36, New York,081, Queens County,546,0,0,0,0,10,0,0,0,0,536,0,0,0,0,2174,139,2035
360811551031,36, New York,081, Queens County,159,28,28,0,0,0,0,0,0,0,159,28,28,0,0,547,29,518
360811551032,36, New York,081, Queens County,174,59,59,0,0,18,18,18,0,0,156,41,41,0,0,568,69,499
360811551033,36, New York,081, Queens County,474,167,167,0,0,18,0,0,0,0,456,167,167,0,0,1491,88,1403
360811551034,36, New York,081, Queens County,284,140,44,0,96,0,0,0,0,0,284,140,44,0,96,889,38,851
360811551041,36, New York,081, Queens County,371,245,218,27,0,27,27,0,27,0,344,218,218,0,0,1172,101,1071
360811551042,36, New York,081, Queens County,356,148,146,0,2,0,0,0,0,0,356,148,146,0,2,843,99,744
360811567001,36, New York,081, Queens County,195,70,59,0,11,32,32,21,0,11,163,38,38,0,0,1014,411,603
360811571011,36, New York,081, Queens County,245,17,17,0,0,30,0,0,0,0,215,17,17,0,0,638,84,554
360811571012,36, New York,081, Queens County,307,144,144,0,0,0,0,0,0,0,307,144,144,0,0,654,0,654
360811571013,36, New York,081, Queens County,205,151,88,0,63,0,0,0,0,0,205,151,88,0,63,519,0,519
360811571014,36, New York,081, Queens County,259,77,77,0,0,15,15,15,0,0,244,62,62,0,0,356,15,341
360811571015,36, New York,081, Queens County,255,35,35,0,0,0,0,0,0,0,255,35,35,0,0,763,0,763
360811571016,36, New York,081, Queens County,502,141,141,0,0,108,59,59,0,0,394,82,82,0,0,1758,259,1499
360811571017,36, New York,081, Queens County,181,36,22,0,14,0,0,0,0,0,181,36,22,0,14,514,0,514
360811571018,36, New York,081, Queens County,97,36,36,0,0,0,0,0,0,0,97,36,36,0,0,347,0,347
360811571021,36, New York,081, Queens County,241,107,79,11,17,14,7,7,0,0,227,100,72,11,17,710,45,665
360811571022,36, New York,081, Queens County,281,187,187,0,0,0,0,0,0,0,281,187,187,0,0,667,7,660
360811579011,36, New York,081, Queens County,280,57,57,0,0,0,0,0,0,0,280,57,57,0,0,716,0,716
360811579012,36, New York,081, Queens County,179,26,13,0,13,0,0,0,0,0,179,26,13,0,13,757,8,749
360811579013,36, New York,081, Queens County,240,76,76,0,0,91,0,0,0,0,149,76,76,0,0,762,276,486
360811579014,36, New York,081, Queens County,232,65,35,7,23,23,23,0,0,23,209,42,35,7,0,942,49,893
360811579015,36, New York,081, Queens County,118,37,37,0,0,6,6,6,0,0,112,31,31,0,0,382,54,328
360811579016,36, New York,081, Queens County,159,39,31,0,8,0,0,0,0,0,159,39,31,0,8,525,8,517
360811579021,36, New York,081, Queens County,133,99,98,1,0,16,1,0,1,0,117,98,98,0,0,400,37,363
360811579022,36, New York,081, Queens County,197,90,90,0,0,0,0,0,0,0,197,90,90,0,0,672,26,646
360811579023,36, New York,081, Queens County,133,35,26,9,0,0,0,0,0,0,133,35,26,9,0,422,0,422
360811579024,36, New York,081, Queens County,361,105,92,0,13,34,0,0,0,0,327,105,92,0,13,702,98,604
360811579025,36, New York,081, Queens County,240,53,41,0,12,0,0,0,0,0,240,53,41,0,12,669,0,669
360811579031,36, New York,081, Queens County,169,88,88,0,0,0,0,0,0,0,169,88,88,0,0,455,0,455
360811579032,36, New York,081, Queens County,253,118,90,0,28,1,0,0,0,0,252,118,90,0,28,771,2,769
360811579033,36, New York,081, Queens County,303,66,41,25,0,0,0,0,0,0,303,66,41,25,0,1049,12,1037
360811579034,36, New York,081, Queens County,238,165,155,0,10,0,0,0,0,0,238,165,155,0,10,767,41,726
360811617001,36, New York,081, Queens County,316,54,54,0,0,13,0,0,0,0,303,54,54,0,0,1182,45,1137
360811617002,36, New York,081, Queens County,272,106,105,0,1,1,1,0,0,1,271,105,105,0,0,696,9,687
360811617003,36, New York,081, Queens County,289,114,79,0,35,0,0,0,0,0,289,114,79,0,35,665,0,665
360811617004,36, New York,081, Queens County,415,197,197,0,0,29,21,21,0,0,386,176,176,0,0,933,63,870
360811621001,36, New York,081, Queens County,308,114,114,0,0,17,17,17,0,0,291,97,97,0,0,1192,120,1072
360811621002,36, New York,081, Queens County,410,166,113,0,53,0,0,0,0,0,410,166,113,0,53,1091,12,1079
360811621003,36, New York,081, Queens County,273,118,118,0,0,10,0,0,0,0,263,118,118,0,0,681,34,647
360811621004,36, New York,081, Queens County,194,62,62,0,0,0,0,0,0,0,194,62,62,0,0,485,0,485
360811621005,36, New York,081, Queens County,323,105,96,9,0,20,20,20,0,0,303,85,76,9,0,817,21,796
360819901000,36, New York,081, Queens County,0,0,0,0,0,0,0,0,0,0,0,0,0,0,0,0,0,0
360010001001,36, New York,001, Albany County,152,45,5,0,40,16,16,0,0,16,136,29,5,0,24,634,86,548
360010001002,36, New York,001, Albany County,348,287,125,30,132,89,89,42,23,24,259,198,83,7,108,935,301,634
360010002011,36, New York,001, Albany County,79,60,0,0,60,0,0,0,0,0,79,60,0,0,60,169,12,157
360010002012,36, New York,001, Albany County,390,162,42,28,92,177,120,0,28,92,213,42,42,0,0,1181,463,718
360010002013,36, New York,001, Albany County,188,50,0,17,33,0,0,0,0,0,188,50,0,17,33,598,117,481
360010002021,36, New York,001, Albany County,538,300,20,0,280,164,141,20,0,121,374,159,0,0,159,1139,272,867
360010002022,36, New York,001, Albany County,161,52,0,0,52,27,27,0,0,27,134,25,0,0,25,531,75,456
360010003011,36, New York,001, Albany County,259,148,101,0,47,120,87,40,0,47,139,61,61,0,0,1223,379,844
360010003012,36, New York,001, Albany County,265,141,14,61,66,62,61,0,61,0,203,80,14,0,66,754,131,623
360010003021,36, New York,001, Albany County,207,104,104,0,0,0,0,0,0,0,207,104,104,0,0,1348,206,1142
360010003022,36, New York,001, Albany County,389,205,117,0,88,82,82,0,0,82,307,123,117,0,6,1223,205,1018
360010004011,36, New York,001, Albany County,341,121,114,4,3,0,0,0,0,0,341,121,114,4,3,1567,144,1423
360010004031,36, New York,001, Albany County,163,32,0,0,32,32,32,0,0,32,131,0,0,0,0,630,79,551
360010004032,36, New York,001, Albany County,378,126,78,0,48,34,34,0,0,34,344,92,78,0,14,1286,377,909
360010004033,36, New York,001, Albany County,360,51,23,28,0,0,0,0,0,0,360,51,23,28,0,944,46,898
360010004034,36, New York,001, Albany County,201,66,66,0,0,0,0,0,0,0,201,66,66,0,0,689,49,640
360010004041,36, New York,001, Albany County,5,0,0,0,0,0,0,0,0,0,5,0,0,0,0,23,0,23
360010005011,36, New York,001, Albany County,111,43,16,9,18,27,18,0,0,18,84,25,16,9,0,935,570,365
360010005012,36, New York,001, Albany County,104,51,12,0,39,39,39,0,0,39,65,12,12,0,0,410,118,292
360010005013,36, New York,001, Albany County,287,245,84,0,161,245,245,84,0,161,42,0,0,0,0,634,294,340
360010005014,36, New York,001, Albany County,117,87,0,0,87,45,45,0,0,45,72,42,0,0,42,582,263,319
360010005021,36, New York,001, Albany County,5,0,0,0,0,0,0,0,0,0,5,0,0,0,0,227,34,193
360010005022,36, New York,001, Albany County,255,98,42,4,52,40,40,5,0,35,215,58,37,4,17,1446,457,989
360010006001,36, New York,001, Albany County,68,68,6,0,62,62,62,0,0,62,6,6,6,0,0,321,250,71
360010006002,36, New York,001, Albany County,171,88,83,0,5,23,5,0,0,5,148,83,83,0,0,453,271,182
360010006003,36, New York,001, Albany County,227,165,61,0,104,66,54,0,0,54,161,111,61,0,50,1502,687,815
360010007001,36, New York,001, Albany County,201,138,27,0,111,0,0,0,0,0,201,138,27,0,111,593,92,501
360010007002,36, New York,001, Albany County,270,204,23,23,158,94,65,23,0,42,176,139,0,23,116,641,228,413
360010007003,36, New York,001, Albany County,179,97,29,22,46,23,23,15,0,8,156,74,14,22,38,516,37,479
360010007004,36, New York,001, Albany County,173,120,0,19,101,87,87,0,19,68,86,33,0,0,33,439,201,238
360010008001,36, New York,001, Albany County,66,43,0,0,43,0,0,0,0,0,66,43,0,0,43,251,67,184
360010008002,36, New York,001, Albany County,208,159,0,0,159,106,92,0,0,92,102,67,0,0,67,568,210,358
360010008003,36, New York,001, Albany County,59,20,0,20,0,0,0,0,0,0,59,20,0,20,0,315,104,211
360010011001,36, New York,001, Albany County,235,142,48,0,94,0,0,0,0,0,235,142,48,0,94,1969,736,1233
360010014001,36, New York,001, Albany County,228,62,34,0,28,0,0,0,0,0,228,62,34,0,28,869,143,726
360010014002,36, New York,001, Albany County,100,51,0,0,51,0,0,0,0,0,100,51,0,0,51,1068,62,1006
360010014003,36, New York,001, Albany County,308,56,0,0,56,0,0,0,0,0,308,56,0,0,56,707,253,454
360010014004,36, New York,001, Albany County,35,0,0,0,0,0,0,0,0,0,35,0,0,0,0,779,103,676
360010015001,36, New York,001, Albany County,171,75,0,37,38,81,38,0,0,38,90,37,0,37,0,1239,391,848
360010015002,36, New York,001, Albany County,36,19,19,0,0,19,19,19,0,0,17,0,0,0,0,1502,1011,491
360010015003,36, New York,001, Albany County,170,120,103,0,17,17,0,0,0,0,153,120,103,0,17,1131,333,798
360010015004,36, New York,001, Albany County,93,63,63,0,0,0,0,0,0,0,93,63,63,0,0,319,0,319
360010016001,36, New York,001, Albany County,102,56,14,28,14,0,0,0,0,0,102,56,14,28,14,895,302,593
360010016002,36, New York,001, Albany County,177,117,47,0,70,0,0,0,0,0,177,117,47,0,70,908,85,823
360010016003,36, New York,001, Albany County,112,91,91,0,0,9,9,9,0,0,103,82,82,0,0,390,38,352
360010016004,36, New York,001, Albany County,405,196,143,0,53,62,62,62,0,0,343,134,81,0,53,1074,60,1014
360010017001,36, New York,001, Albany County,212,100,100,0,0,0,0,0,0,0,212,100,100,0,0,733,104,629
360010017002,36, New York,001, Albany County,275,142,68,23,51,0,0,0,0,0,275,142,68,23,51,791,84,707
360010017003,36, New York,001, Albany County,567,194,78,24,92,0,0,0,0,0,567,194,78,24,92,1686,166,1520
360010018021,36, New York,001, Albany County,187,46,11,35,0,18,18,0,18,0,169,28,11,17,0,702,100,602
360010018022,36, New York,001, Albany County,271,81,50,0,31,0,0,0,0,0,271,81,50,0,31,1080,135,945
360010018023,36, New York,001, Albany County,453,225,122,30,73,65,58,0,0,58,388,167,122,30,15,1626,267,1359
360010018031,36, New York,001, Albany County,155,58,22,36,0,0,0,0,0,0,155,58,22,36,0,937,92,845
360010018032,36, New York,001, Albany County,479,42,24,0,18,0,0,0,0,0,479,42,24,0,18,1592,21,1571
360010018033,36, New York,001, Albany County,205,7,7,0,0,0,0,0,0,0,205,7,7,0,0,863,35,828
360010018041,36, New York,001, Albany County,330,78,24,22,32,34,34,0,2,32,296,44,24,20,0,1042,140,902
360010018042,36, New York,001, Albany County,160,53,22,0,31,0,0,0,0,0,160,53,22,0,31,677,115,562
360010018043,36, New York,001, Albany County,340,70,49,21,0,18,0,0,0,0,322,70,49,21,0,1204,55,1149
360010019011,36, New York,001, Albany County,411,139,129,0,10,10,10,0,0,10,401,129,129,0,0,1292,29,1263
360010019012,36, New York,001, Albany County,211,86,40,12,34,0,0,0,0,0,211,86,40,12,34,854,80,774
360010019021,36, New York,001, Albany County,186,51,44,0,7,0,0,0,0,0,186,51,44,0,7,606,10,596
360010019022,36, New York,001, Albany County,155,0,0,0,0,0,0,0,0,0,155,0,0,0,0,769,0,769
360010019023,36, New York,001, Albany County,225,173,113,38,22,7,7,7,0,0,218,166,106,38,22,682,58,624
360010020001,36, New York,001, Albany County,486,240,159,0,81,20,20,20,0,0,466,220,139,0,81,2010,311,1699
360010020002,36, New York,001, Albany County,141,141,33,62,46,62,62,0,62,0,79,79,33,0,46,342,0,342
360010020003,36, New York,001, Albany County,209,177,98,0,79,0,0,0,0,0,209,177,98,0,79,467,20,447
360010020004,36, New York,001, Albany County,296,69,69,0,0,0,0,0,0,0,296,69,69,0,0,572,22,550
360010020005,36, New York,001, Albany County,281,201,129,0,72,16,16,0,0,16,265,185,129,0,56,903,182,721
360010021001,36, New York,001, Albany County,167,95,54,0,41,0,0,0,0,0,167,95,54,0,41,816,217,599
360010021002,36, New York,001, Albany County,26,17,17,0,0,0,0,0,0,0,26,17,17,0,0,99,11,88
360010021003,36, New York,001, Albany County,144,76,76,0,0,0,0,0,0,0,144,76,76,0,0,967,546,421
360010022001,36, New York,001, Albany County,186,78,16,0,62,9,0,0,0,0,177,78,16,0,62,1523,364,1159
360010022002,36, New York,001, Albany County,145,37,9,28,0,6,0,0,0,0,139,37,9,28,0,705,57,648
360010023001,36, New York,001, Albany County,103,0,0,0,0,10,0,0,0,0,93,0,0,0,0,494,64,430
360010023002,36, New York,001, Albany County,256,231,24,82,125,145,145,24,82,39,111,86,0,0,86,1174,323,851
360010025001,36, New York,001, Albany County,127,122,34,0,88,88,88,0,0,88,39,34,34,0,0,321,215,106
360010025002,36, New York,001, Albany County,426,409,208,0,201,82,82,0,0,82,344,327,208,0,119,551,198,353
360010025003,36, New York,001, Albany County,22,0,0,0,0,22,0,0,0,0,0,0,0,0,0,340,229,111
360010025004,36, New York,001, Albany County,113,97,0,25,72,48,48,0,0,48,65,49,0,25,24,513,166,347
360010026001,36, New York,001, Albany County,180,61,0,0,61,0,0,0,0,0,180,61,0,0,61,605,19,586
360010026002,36, New York,001, Albany County,519,302,70,25,207,26,25,0,25,0,493,277,70,0,207,1551,102,1449
360010026003,36, New York,001, Albany County,214,108,29,0,79,27,27,27,0,0,187,81,2,0,79,1084,257,827
360010026004,36, New York,001, Albany County,118,51,27,0,24,62,24,0,0,24,56,27,27,0,0,379,134,245
360010127001,36, New York,001, Albany County,279,68,42,0,26,19,19,19,0,0,260,49,23,0,26,1406,233,1173
360010127002,36, New York,001, Albany County,168,74,52,0,22,26,13,9,0,4,142,61,43,0,18,564,55,509
360010127003,36, New York,001, Albany County,309,185,79,7,99,79,79,9,0,70,230,106,70,7,29,806,107,699
360010128001,36, New York,001, Albany County,302,250,33,0,217,179,179,0,0,179,123,71,33,0,38,497,174,323
360010128002,36, New York,001, Albany County,105,72,28,0,44,29,29,0,0,29,76,43,28,0,15,394,44,350
360010128003,36, New York,001, Albany County,116,35,12,12,11,45,31,8,12,11,71,4,4,0,0,511,134,377
360010128004,36, New York,001, Albany County,316,262,69,11,182,125,125,0,0,125,191,137,69,11,57,1072,438,634
360010129001,36, New York,001, Albany County,309,243,8,93,142,22,22,8,0,14,287,221,0,93,128,1023,300,723
360010129002,36, New York,001, Albany County,64,40,0,0,40,0,0,0,0,0,64,40,0,0,40,649,187,462
360010129003,36, New York,001, Albany County,47,10,0,0,10,10,10,0,0,10,37,0,0,0,0,398,83,315
360010129004,36, New York,001, Albany County,266,89,26,0,63,0,0,0,0,0,266,89,26,0,63,727,0,727
360010130001,36, New York,001, Albany County,273,49,26,0,23,0,0,0,0,0,273,49,26,0,23,796,0,796
360010130002,36, New York,001, Albany County,481,88,56,0,32,18,18,0,0,18,463,70,56,0,14,1303,34,1269
360010130003,36, New York,001, Albany County,344,237,35,110,92,76,76,0,55,21,268,161,35,55,71,713,102,611
360010130004,36, New York,001, Albany County,619,160,149,0,11,0,0,0,0,0,619,160,149,0,11,1491,10,1481
360010130005,36, New York,001, Albany County,251,88,73,0,15,0,0,0,0,0,251,88,73,0,15,830,15,815
360010131001,36, New York,001, Albany County,166,67,40,21,6,0,0,0,0,0,166,67,40,21,6,853,55,798
360010131002,36, New York,001, Albany County,210,49,0,0,49,44,19,0,0,19,166,30,0,0,30,799,222,577
360010131003,36, New York,001, Albany County,198,67,0,25,42,42,42,0,0,42,156,25,0,25,0,760,128,632
360010132001,36, New York,001, Albany County,210,156,33,0,123,0,0,0,0,0,210,156,33,0,123,495,21,474
360010132002,36, New York,001, Albany County,252,114,23,11,80,50,50,0,11,39,202,64,23,0,41,1000,276,724
360010132003,36, New York,001, Albany County,380,227,19,58,150,146,137,19,0,118,234,90,0,58,32,1098,308,790
360010133001,36, New York,001, Albany County,535,203,76,0,127,15,0,0,0,0,520,203,76,0,127,1992,164,1828
360010133002,36, New York,001, Albany County,121,59,31,0,28,0,0,0,0,0,121,59,31,0,28,409,90,319
360010133003,36, New York,001, Albany County,273,192,71,19,102,31,31,0,0,31,242,161,71,19,71,794,175,619
360010134001,36, New York,001, Albany County,250,77,47,0,30,16,16,0,0,16,234,61,47,0,14,635,36,599
360010134002,36, New York,001, Albany County,176,71,57,0,14,42,28,14,0,14,134,43,43,0,0,636,94,542
360010134003,36, New York,001, Albany County,288,127,0,20,107,53,53,0,0,53,235,74,0,20,54,957,53,904
360010135031,36, New York,001, Albany County,347,103,60,25,18,26,0,0,0,0,321,103,60,25,18,1140,150,990
360010135032,36, New York,001, Albany County,451,299,199,0,100,14,14,0,0,14,437,285,199,0,86,952,46,906
360010135033,36, New York,001, Albany County,505,325,278,30,17,0,0,0,0,0,505,325,278,30,17,1247,61,1186
360010135051,36, New York,001, Albany County,302,114,55,35,24,5,0,0,0,0,297,114,55,35,24,695,10,685
360010135052,36, New York,001, Albany County,372,158,100,5,53,0,0,0,0,0,372,158,100,5,53,1571,281,1290
360010135071,36, New York,001, Albany County,371,149,56,24,69,75,69,0,0,69,296,80,56,24,0,1203,48,1155
360010135072,36, New York,001, Albany County,132,42,34,8,0,7,0,0,0,0,125,42,34,8,0,458,23,435
360010135091,36, New York,001, Albany County,229,155,98,10,47,6,6,0,0,6,223,149,98,10,41,650,21,629
360010135092,36, New York,001, Albany County,597,294,230,10,54,0,0,0,0,0,597,294,230,10,54,1896,34,1862
360010135101,36, New York,001, Albany County,470,269,194,0,75,0,0,0,0,0,470,269,194,0,75,1177,23,1154
360010135102,36, New York,001, Albany County,562,271,234,0,37,56,21,0,0,21,506,250,234,0,16,1575,116,1459
360010135111,36, New York,001, Albany County,830,369,306,25,38,26,15,0,0,15,804,354,306,25,23,1945,62,1883
360010135112,36, New York,001, Albany County,188,108,14,21,73,0,0,0,0,0,188,108,14,21,73,407,8,399
360010135121,36, New York,001, Albany County,624,243,193,0,50,0,0,0,0,0,624,243,193,0,50,1560,46,1514
360010135122,36, New York,001, Albany County,562,164,90,44,30,33,6,6,0,0,529,158,84,44,30,1258,67,1191
360010136021,36, New York,001, Albany County,320,122,89,0,33,0,0,0,0,0,320,122,89,0,33,1094,0,1094
360010136022,36, New York,001, Albany County,384,156,109,0,47,0,0,0,0,0,384,156,109,0,47,1118,85,1033
360010136023,36, New York,001, Albany County,343,185,112,29,44,44,44,0,0,44,299,141,112,29,0,1082,73,1009
360010136031,36, New York,001, Albany County,493,312,312,0,0,0,0,0,0,0,493,312,312,0,0,1146,45,1101
360010136032,36, New York,001, Albany County,336,68,27,0,41,0,0,0,0,0,336,68,27,0,41,1182,30,1152
360010136041,36, New York,001, Albany County,352,92,92,0,0,10,0,0,0,0,342,92,92,0,0,1198,40,1158
360010136042,36, New York,001, Albany County,429,217,188,0,29,25,0,0,0,0,404,217,188,0,29,1254,132,1122
360010136043,36, New York,001, Albany County,441,271,150,0,121,47,25,25,0,0,394,246,125,0,121,1344,145,1199
360010137031,36, New York,001, Albany County,439,166,166,0,0,36,0,0,0,0,403,166,166,0,0,1351,207,1144
360010137061,36, New York,001, Albany County,508,267,231,0,36,10,6,6,0,0,498,261,225,0,36,1575,22,1553
360010137071,36, New York,001, Albany County,481,204,184,0,20,0,0,0,0,0,481,204,184,0,20,1172,18,1154
360010137072,36, New York,001, Albany County,358,68,48,0,20,0,0,0,0,0,358,68,48,0,20,1069,0,1069
360010137073,36, New York,001, Albany County,309,112,59,53,0,53,53,0,53,0,256,59,59,0,0,912,101,811
360010137074,36, New York,001, Albany County,570,287,189,24,74,0,0,0,0,0,570,287,189,24,74,1401,20,1381
360010137081,36, New York,001, Albany County,345,117,97,0,20,13,0,0,0,0,332,117,97,0,20,1050,45,1005
360010137082,36, New York,001, Albany County,530,54,54,0,0,0,0,0,0,0,530,54,54,0,0,1889,68,1821
360010137091,36, New York,001, Albany County,519,295,295,0,0,0,0,0,0,0,519,295,295,0,0,1196,24,1172
360010137092,36, New York,001, Albany County,277,97,78,9,10,0,0,0,0,0,277,97,78,9,10,862,36,826
360010138021,36, New York,001, Albany County,531,153,106,17,30,13,0,0,0,0,518,153,106,17,30,1576,140,1436
360010138022,36, New York,001, Albany County,226,70,59,11,0,13,0,0,0,0,213,70,59,11,0,710,45,665
360010138023,36, New York,001, Albany County,468,160,154,6,0,11,0,0,0,0,457,160,154,6,0,1385,22,1363
360010138031,36, New York,001, Albany County,83,50,50,0,0,0,0,0,0,0,83,50,50,0,0,256,0,256
360010138032,36, New York,001, Albany County,307,106,95,0,11,15,15,15,0,0,292,91,80,0,11,1076,80,996
360010138033,36, New York,001, Albany County,412,201,142,32,27,0,0,0,0,0,412,201,142,32,27,1634,249,1385
360010138041,36, New York,001, Albany County,562,343,326,0,17,16,0,0,0,0,546,343,326,0,17,1463,117,1346
360010138042,36, New York,001, Albany County,101,80,36,0,44,0,0,0,0,0,101,80,36,0,44,301,10,291
360010138043,36, New York,001, Albany County,136,75,61,0,14,14,14,0,0,14,122,61,61,0,0,463,41,422
360010138044,36, New York,001, Albany County,205,39,39,0,0,0,0,0,0,0,205,39,39,0,0,908,33,875
360010139011,36, New York,001, Albany County,278,73,73,0,0,5,0,0,0,0,273,73,73,0,0,848,41,807
360010139012,36, New York,001, Albany County,373,120,93,18,9,7,0,0,0,0,366,120,93,18,9,1142,40,1102
360010139021,36, New York,001, Albany County,283,123,110,8,5,0,0,0,0,0,283,123,110,8,5,1011,76,935
360010139022,36, New York,001, Albany County,223,20,20,0,0,15,0,0,0,0,208,20,20,0,0,689,82,607
360010139023,36, New York,001, Albany County,436,248,79,97,72,0,0,0,0,0,436,248,79,97,72,1455,151,1304
360010139024,36, New York,001, Albany County,308,151,117,0,34,0,0,0,0,0,308,151,117,0,34,933,40,893
360010140011,36, New York,001, Albany County,119,82,43,0,39,0,0,0,0,0,119,82,43,0,39,416,32,384
360010140012,36, New York,001, Albany County,183,146,146,0,0,41,41,41,0,0,142,105,105,0,0,359,41,318
360010140013,36, New York,001, Albany County,375,121,82,0,39,0,0,0,0,0,375,121,82,0,39,1268,102,1166
360010140014,36, New York,001, Albany County,132,13,13,0,0,0,0,0,0,0,132,13,13,0,0,702,19,683
360010140021,36, New York,001, Albany County,247,185,79,0,106,7,0,0,0,0,240,185,79,0,106,611,32,579
360010140022,36, New York,001, Albany County,525,319,232,41,46,13,0,0,0,0,512,319,232,41,46,1427,104,1323
360010140023,36, New York,001, Albany County,329,105,60,45,0,0,0,0,0,0,329,105,60,45,0,954,1,953
360010140024,36, New York,001, Albany County,318,162,0,14,148,63,63,0,0,63,255,99,0,14,85,647,0,647
360010141001,36, New York,001, Albany County,452,232,232,0,0,0,0,0,0,0,452,232,232,0,0,1157,0,1157
360010141002,36, New York,001, Albany County,262,105,74,0,31,0,0,0,0,0,262,105,74,0,31,1051,73,978
360010141003,36, New York,001, Albany County,490,184,174,0,10,0,0,0,0,0,490,184,174,0,10,1609,10,1599
360010141004,36, New York,001, Albany County,328,120,120,0,0,0,0,0,0,0,328,120,120,0,0,817,0,817
360010142011,36, New York,001, Albany County,302,114,98,0,16,0,0,0,0,0,302,114,98,0,16,1169,34,1135
360010142012,36, New York,001, Albany County,318,177,139,28,10,10,10,0,0,10,308,167,139,28,0,897,10,887
360010142013,36, New York,001, Albany County,651,406,387,8,11,0,0,0,0,0,651,406,387,8,11,1495,47,1448
360010142014,36, New York,001, Albany County,153,91,81,10,0,10,10,0,10,0,143,81,81,0,0,631,80,551
360010142021,36, New York,001, Albany County,326,156,77,0,79,0,0,0,0,0,326,156,77,0,79,1225,63,1162
360010142022,36, New York,001, Albany County,241,70,53,0,17,22,0,0,0,0,219,70,53,0,17,712,70,642
360010142023,36, New York,001, Albany County,938,415,331,47,37,0,0,0,0,0,938,415,331,47,37,2005,41,1964
360010142024,36, New York,001, Albany County,322,110,110,0,0,0,0,0,0,0,322,110,110,0,0,832,10,822
360010142031,36, New York,001, Albany County,520,224,212,12,0,12,12,0,12,0,508,212,212,0,0,1592,112,1480
360010142032,36, New York,001, Albany County,612,301,217,0,84,0,0,0,0,0,612,301,217,0,84,1254,0,1254
360010142033,36, New York,001, Albany County,159,54,54,0,0,0,0,0,0,0,159,54,54,0,0,450,0,450
360010142034,36, New York,001, Albany County,213,45,20,0,25,0,0,0,0,0,213,45,20,0,25,623,0,623
360010142035,36, New York,001, Albany County,358,129,86,0,43,0,0,0,0,0,358,129,86,0,43,977,10,967
360010143011,36, New York,001, Albany County,167,94,67,17,10,0,0,0,0,0,167,94,67,17,10,593,31,562
360010143012,36, New York,001, Albany County,465,92,70,11,11,0,0,0,0,0,465,92,70,11,11,1923,398,1525
360010143031,36, New York,001, Albany County,448,250,250,0,0,0,0,0,0,0,448,250,250,0,0,1093,7,1086
360010143032,36, New York,001, Albany County,488,110,79,9,22,20,0,0,0,0,468,110,79,9,22,1193,55,1138
360010143033,36, New York,001, Albany County,497,276,201,75,0,20,20,20,0,0,477,256,181,75,0,1227,37,1190
360010143041,36, New York,001, Albany County,34,10,10,0,0,0,0,0,0,0,34,10,10,0,0,229,14,215
360010143042,36, New York,001, Albany County,889,280,180,42,58,58,58,0,0,58,831,222,180,42,0,2258,82,2176
360010144011,36, New York,001, Albany County,269,74,25,0,49,0,0,0,0,0,269,74,25,0,49,626,10,616
360010144012,36, New York,001, Albany County,633,183,144,0,39,71,28,0,0,28,562,155,144,0,11,1904,189,1715
360010144013,36, New York,001, Albany County,311,119,89,30,0,12,12,0,12,0,299,107,89,18,0,787,17,770
360010144021,36, New York,001, Albany County,386,183,97,20,66,36,36,0,0,36,350,147,97,20,30,1225,170,1055
360010144022,36, New York,001, Albany County,398,160,39,17,104,28,28,0,0,28,370,132,39,17,76,1411,165,1246
360010145011,36, New York,001, Albany County,547,136,136,0,0,32,13,13,0,0,515,123,123,0,0,1463,110,1353
360010145012,36, New York,001, Albany County,397,101,85,0,16,0,0,0,0,0,397,101,85,0,16,972,10,962
360010145021,36, New York,001, Albany County,310,145,145,0,0,0,0,0,0,0,310,145,145,0,0,690,0,690
360010145022,36, New York,001, Albany County,426,67,59,8,0,64,23,23,0,0,362,44,36,8,0,1441,151,1290
360010145023,36, New York,001, Albany County,235,95,71,0,24,11,11,0,0,11,224,84,71,0,13,688,14,674
360010145031,36, New York,001, Albany County,357,202,123,31,48,49,44,0,12,32,308,158,123,19,16,1077,96,981
360010145032,36, New York,001, Albany County,362,153,136,5,12,9,9,0,0,9,353,144,136,5,3,1056,18,1038
360010146061,36, New York,001, Albany County,225,122,104,0,18,0,0,0,0,0,225,122,104,0,18,615,13,602
360010146062,36, New York,001, Albany County,220,83,71,0,12,0,0,0,0,0,220,83,71,0,12,670,9,661
360010146063,36, New York,001, Albany County,622,298,251,8,39,0,0,0,0,0,622,298,251,8,39,1748,87,1661
360010146081,36, New York,001, Albany County,179,54,47,0,7,11,0,0,0,0,168,54,47,0,7,515,41,474
360010146082,36, New York,001, Albany County,426,178,121,29,28,46,25,25,0,0,380,153,96,29,28,1613,99,1514
360010146091,36, New York,001, Albany County,319,67,67,0,0,0,0,0,0,0,319,67,67,0,0,927,0,927
360010146092,36, New York,001, Albany County,543,204,140,19,45,0,0,0,0,0,543,204,140,19,45,1332,30,1302
360010146093,36, New York,001, Albany County,218,57,41,7,9,7,7,0,7,0,211,50,41,0,9,1426,219,1207
360010146111,36, New York,001, Albany County,227,96,88,0,8,0,0,0,0,0,227,96,88,0,8,600,8,592
360010146112,36, New York,001, Albany County,377,178,178,0,0,0,0,0,0,0,377,178,178,0,0,1217,41,1176
360010146121,36, New York,001, Albany County,401,178,104,0,74,11,11,0,0,11,390,167,104,0,63,1307,50,1257
360010146131,36, New York,001, Albany County,345,120,75,45,0,0,0,0,0,0,345,120,75,45,0,848,63,785
360010146132,36, New York,001, Albany County,346,183,162,21,0,0,0,0,0,0,346,183,162,21,0,905,11,894
360010146133,36, New York,001, Albany County,86,10,0,10,0,0,0,0,0,0,86,10,0,10,0,387,36,351
360010146141,36, New York,001, Albany County,398,166,166,0,0,0,0,0,0,0,398,166,166,0,0,1045,0,1045
360010146142,36, New York,001, Albany County,257,78,65,13,0,0,0,0,0,0,257,78,65,13,0,662,0,662
360010146143,36, New York,001, Albany County,404,271,145,72,54,14,14,0,0,14,390,257,145,72,40,880,14,866
360010146144,36, New York,001, Albany County,539,237,93,94,50,14,0,0,0,0,525,237,93,94,50,1283,70,1213
360010146151,36, New York,001, Albany County,454,318,307,6,5,71,71,71,0,0,383,247,236,6,5,810,118,692
360010146152,36, New York,001, Albany County,205,32,23,0,9,9,9,0,0,9,196,23,23,0,0,965,39,926
360010146161,36, New York,001, Albany County,530,268,188,0,80,28,28,21,0,7,502,240,167,0,73,1456,112,1344
360010146162,36, New York,001, Albany County,400,171,133,0,38,0,0,0,0,0,400,171,133,0,38,1049,0,1049
360010146163,36, New York,001, Albany County,743,391,196,80,115,20,9,0,0,9,723,382,196,80,106,2003,32,1971
360010146171,36, New York,001, Albany County,405,165,158,7,0,0,0,0,0,0,405,165,158,7,0,1124,78,1046
360010146172,36, New York,001, Albany County,289,52,43,0,9,21,0,0,0,0,268,52,43,0,9,788,47,741
360010147001,36, New York,001, Albany County,312,125,80,14,31,24,24,0,0,24,288,101,80,14,7,850,41,809
360010147002,36, New York,001, Albany County,522,148,116,0,32,25,4,4,0,0,497,144,112,0,32,1329,56,1273
360010148011,36, New York,001, Albany County,174,35,21,0,14,0,0,0,0,0,174,35,21,0,14,451,28,423
360010148012,36, New York,001, Albany County,357,68,48,6,14,22,22,22,0,0,335,46,26,6,14,901,51,850
360010148013,36, New York,001, Albany County,299,170,140,0,30,0,0,0,0,0,299,170,140,0,30,744,5,739
360010148021,36, New York,001, Albany County,192,54,32,5,17,8,8,0,0,8,184,46,32,5,9,782,28,754
360010148022,36, New York,001, Albany County,285,75,62,0,13,3,3,3,0,0,282,72,59,0,13,749,36,713
360010148031,36, New York,001, Albany County,531,93,48,45,0,34,17,0,17,0,497,76,48,28,0,1314,64,1250
360010148032,36, New York,001, Albany County,452,240,179,45,16,12,0,0,0,0,440,240,179,45,16,1175,73,1102
360390801001,36, New York,039, Greene County,365,54,54,0,0,0,0,0,0,0,365,54,54,0,0,1084,51,1033
360390801002,36, New York,039, Greene County,312,125,117,0,8,0,0,0,0,0,312,125,117,0,8,1065,112,953
360390801003,36, New York,039, Greene County,160,88,73,15,0,0,0,0,0,0,160,88,73,15,0,537,4,533
360390802011,36, New York,039, Greene County,232,85,62,0,23,0,0,0,0,0,232,85,62,0,23,646,26,620
360390802012,36, New York,039, Greene County,392,127,95,24,8,23,0,0,0,0,369,127,95,24,8,1322,67,1255
360390802013,36, New York,039, Greene County,356,123,119,0,4,0,0,0,0,0,356,123,119,0,4,990,0,990
360390802021,36, New York,039, Greene County,242,85,61,24,0,34,11,11,0,0,208,74,50,24,0,780,112,668
360390802022,36, New York,039, Greene County,419,201,79,28,94,63,56,0,0,56,356,145,79,28,38,1272,117,1155
360390803011,36, New York,039, Greene County,286,89,81,8,0,0,0,0,0,0,286,89,81,8,0,798,26,772
360390803012,36, New York,039, Greene County,138,50,50,0,0,0,0,0,0,0,138,50,50,0,0,463,12,451
360390803021,36, New York,039, Greene County,152,45,37,0,8,17,8,0,0,8,135,37,37,0,0,673,152,521
360390803022,36, New York,039, Greene County,161,29,22,0,7,6,2,2,0,0,155,27,20,0,7,520,47,473
360390804021,36, New York,039, Greene County,291,94,85,5,4,21,16,12,0,4,270,78,73,5,0,750,60,690
360390804022,36, New York,039, Greene County,202,27,20,0,7,24,7,0,0,7,178,20,20,0,0,938,83,855
360390804031,36, New York,039, Greene County,353,80,80,0,0,21,0,0,0,0,332,80,80,0,0,997,145,852
360390804041,36, New York,039, Greene County,158,102,73,16,13,18,18,10,0,8,140,84,63,16,5,931,205,726
360390804042,36, New York,039, Greene County,107,22,10,0,12,12,12,0,0,12,95,10,10,0,0,350,86,264
360390805011,36, New York,039, Greene County,300,119,57,25,37,13,0,0,0,0,287,119,57,25,37,1182,102,1080
360390805012,36, New York,039, Greene County,357,149,39,80,30,52,47,0,47,0,305,102,39,33,30,1059,199,860
360390805021,36, New York,039, Greene County,260,81,70,0,11,8,0,0,0,0,252,81,70,0,11,1062,90,972
360390805022,36, New York,039, Greene County,233,101,50,0,51,8,0,0,0,0,225,101,50,0,51,939,93,846
360390805023,36, New York,039, Greene County,257,128,78,0,50,0,0,0,0,0,257,128,78,0,50,701,39,662
360390805024,36, New York,039, Greene County,103,59,47,12,0,0,0,0,0,0,103,59,47,12,0,485,43,442
360390806001,36, New York,039, Greene County,574,146,87,59,0,11,11,0,11,0,563,135,87,48,0,1447,49,1398
360390806002,36, New York,039, Greene County,315,135,102,33,0,53,33,0,33,0,262,102,102,0,0,1065,170,895
360390806003,36, New York,039, Greene County,103,14,14,0,0,0,0,0,0,0,103,14,14,0,0,309,0,309
360390807001,36, New York,039, Greene County,146,82,22,12,48,33,33,0,12,21,113,49,22,0,27,604,73,531
360390807002,36, New York,039, Greene County,199,50,50,0,0,0,0,0,0,0,199,50,50,0,0,709,14,695
360390807003,36, New York,039, Greene County,316,156,86,12,58,0,0,0,0,0,316,156,86,12,58,955,0,955
360390808001,36, New York,039, Greene County,0,0,0,0,0,0,0,0,0,0,0,0,0,0,0,0,0,0
360390809001,36, New York,039, Greene County,145,4,4,0,0,7,0,0,0,0,138,4,4,0,0,526,51,475
360390809002,36, New York,039, Greene County,212,78,70,0,8,0,0,0,0,0,212,78,70,0,8,663,0,663
360390809003,36, New York,039, Greene County,190,44,31,7,6,31,2,0,0,2,159,42,31,7,4,639,127,512
360390809004,36, New York,039, Greene County,145,75,22,45,8,0,0,0,0,0,145,75,22,45,8,512,27,485
360390809005,36, New York,039, Greene County,350,62,62,0,0,8,0,0,0,0,342,62,62,0,0,994,25,969
360390810011,36, New York,039, Greene County,165,32,30,0,2,28,0,0,0,0,137,32,30,0,2,844,174,670
360390810012,36, New York,039, Greene County,178,39,28,0,11,30,11,0,0,11,148,28,28,0,0,946,282,664
360390810021,36, New York,039, Greene County,100,0,0,0,0,33,0,0,0,0,67,0,0,0,0,718,180,538
360390810022,36, New York,039, Greene County,338,132,103,0,29,0,0,0,0,0,338,132,103,0,29,1247,63,1184
360390811011,36, New York,039, Greene County,172,84,39,0,45,45,45,0,0,45,127,39,39,0,0,727,45,682
360390811012,36, New York,039, Greene County,376,166,121,10,35,47,25,0,0,25,329,141,121,10,10,1353,161,1192
360390811013,36, New York,039, Greene County,270,41,41,0,0,51,41,41,0,0,219,0,0,0,0,883,274,609
360390811014,36, New York,039, Greene County,139,61,61,0,0,0,0,0,0,0,139,61,61,0,0,655,73,582
360390811021,36, New York,039, Greene County,354,201,160,0,41,33,33,0,0,33,321,168,160,0,8,972,102,870
360390811022,36, New York,039, Greene County,124,49,49,0,0,0,0,0,0,0,124,49,49,0,0,309,0,309
360390811023,36, New York,039, Greene County,214,44,44,0,0,7,0,0,0,0,207,44,44,0,0,900,59,841
360910601021,36, New York,091, Saratoga County,833,361,145,77,139,202,113,0,46,67,631,248,145,31,72,2599,467,2132
360910601022,36, New York,091, Saratoga County,249,145,128,0,17,0,0,0,0,0,249,145,128,0,17,565,0,565
360910601023,36, New York,091, Saratoga County,165,59,59,0,0,0,0,0,0,0,165,59,59,0,0,470,0,470
360910601024,36, New York,091, Saratoga County,490,218,218,0,0,0,0,0,0,0,490,218,218,0,0,1460,77,1383
360910601031,36, New York,091, Saratoga County,196,130,81,42,7,0,0,0,0,0,196,130,81,42,7,612,3,609
360910601032,36, New York,091, Saratoga County,239,102,78,7,17,0,0,0,0,0,239,102,78,7,17,785,0,785
360910601041,36, New York,091, Saratoga County,326,75,75,0,0,0,0,0,0,0,326,75,75,0,0,1087,104,983
360910601042,36, New York,091, Saratoga County,176,101,24,77,0,0,0,0,0,0,176,101,24,77,0,683,122,561
360910601043,36, New York,091, Saratoga County,781,361,120,143,98,184,184,0,143,41,597,177,120,0,57,1996,297,1699
360910602001,36, New York,091, Saratoga County,308,177,65,35,77,9,9,0,9,0,299,168,65,26,77,864,39,825
360910602002,36, New York,091, Saratoga County,217,119,40,79,0,0,0,0,0,0,217,119,40,79,0,882,159,723
360910602003,36, New York,091, Saratoga County,382,155,62,67,26,13,13,0,13,0,369,142,62,54,26,1329,109,1220
360910603011,36, New York,091, Saratoga County,390,80,80,0,0,20,20,20,0,0,370,60,60,0,0,1030,77,953
360910603012,36, New York,091, Saratoga County,522,189,109,16,64,37,28,0,12,16,485,161,109,4,48,1589,60,1529
360910604001,36, New York,091, Saratoga County,277,158,106,9,43,14,14,0,0,14,263,144,106,9,29,929,38,891
360910604002,36, New York,091, Saratoga County,233,148,96,45,7,52,52,32,20,0,181,96,64,25,7,709,149,560
360910604003,36, New York,091, Saratoga County,116,72,37,0,35,25,21,0,0,21,91,51,37,0,14,282,30,252
360910605011,36, New York,091, Saratoga County,300,97,65,20,12,61,25,6,7,12,239,72,59,13,0,840,131,709
360910605012,36, New York,091, Saratoga County,350,69,62,7,0,0,0,0,0,0,350,69,62,7,0,937,11,926
360910605041,36, New York,091, Saratoga County,142,10,10,0,0,5,0,0,0,0,137,10,10,0,0,463,28,435
360910605042,36, New York,091, Saratoga County,177,65,43,3,19,30,30,25,0,5,147,35,18,3,14,472,82,390
360910605051,36, New York,091, Saratoga County,145,26,20,0,6,3,0,0,0,0,142,26,20,0,6,441,19,422
360910605052,36, New York,091, Saratoga County,132,3,3,0,0,15,0,0,0,0,117,3,3,0,0,472,123,349
360910605061,36, New York,091, Saratoga County,326,110,90,3,17,96,14,0,0,14,230,96,90,3,3,772,160,612
360910605062,36, New York,091, Saratoga County,186,76,50,13,13,4,4,4,0,0,182,72,46,13,13,583,23,560
360910605071,36, New York,091, Saratoga County,92,27,27,0,0,4,0,0,0,0,88,27,27,0,0,328,37,291
360910606011,36, New York,091, Saratoga County,280,111,110,0,1,29,13,13,0,0,251,98,97,0,1,944,106,838
360910606012,36, New York,091, Saratoga County,207,132,87,33,12,29,12,0,0,12,178,120,87,33,0,665,107,558
360910606013,36, New York,091, Saratoga County,185,85,82,0,3,3,3,0,0,3,182,82,82,0,0,833,141,692
360910606021,36, New York,091, Saratoga County,453,251,141,87,23,58,58,39,19,0,395,193,102,68,23,1180,110,1070
360910606022,36, New York,091, Saratoga County,799,308,234,0,74,47,47,0,0,47,752,261,234,0,27,1903,129,1774
360910606023,36, New York,091, Saratoga County,199,139,74,4,61,0,0,0,0,0,199,139,74,4,61,699,2,697
360910607031,36, New York,091, Saratoga County,402,161,161,0,0,0,0,0,0,0,402,161,161,0,0,1149,6,1143
360910607032,36, New York,091, Saratoga County,441,208,176,12,20,12,12,0,12,0,429,196,176,0,20,1454,104,1350
360910607041,36, New York,091, Saratoga County,330,84,0,53,31,0,0,0,0,0,330,84,0,53,31,984,44,940
360910607042,36, New York,091, Saratoga County,489,159,156,0,3,0,0,0,0,0,489,159,156,0,3,1293,10,1283
360910607043,36, New York,091, Saratoga County,278,54,16,0,38,16,0,0,0,0,262,54,16,0,38,1212,107,1105
360910607051,36, New York,091, Saratoga County,165,138,138,0,0,0,0,0,0,0,165,138,138,0,0,749,38,711
360910607052,36, New York,091, Saratoga County,267,120,67,0,53,0,0,0,0,0,267,120,67,0,53,1005,63,942
360910607053,36, New York,091, Saratoga County,596,315,268,0,47,0,0,0,0,0,596,315,268,0,47,1536,16,1520
360910607061,36, New York,091, Saratoga County,802,318,247,12,59,18,0,0,0,0,784,318,247,12,59,2098,51,2047
360910607062,36, New York,091, Saratoga County,456,246,209,0,37,0,0,0,0,0,456,246,209,0,37,1134,0,1134
360910607063,36, New York,091, Saratoga County,362,129,99,0,30,16,0,0,0,0,346,129,99,0,30,976,69,907
360910608001,36, New York,091, Saratoga County,700,342,236,16,90,0,0,0,0,0,700,342,236,16,90,1729,78,1651
360910608002,36, New York,091, Saratoga County,564,230,170,25,35,25,11,0,0,11,539,219,170,25,24,1701,140,1561
360910608003,36, New York,091, Saratoga County,191,85,45,15,25,9,9,9,0,0,182,76,36,15,25,577,56,521
360910609011,36, New York,091, Saratoga County,465,246,173,21,52,0,0,0,0,0,465,246,173,21,52,1428,55,1373
360910609012,36, New York,091, Saratoga County,276,96,87,0,9,0,0,0,0,0,276,96,87,0,9,747,0,747
360910609013,36, New York,091, Saratoga County,321,97,97,0,0,0,0,0,0,0,321,97,97,0,0,868,13,855
360910609021,36, New York,091, Saratoga County,277,147,90,16,41,21,21,11,0,10,256,126,79,16,31,974,92,882
360910609022,36, New York,091, Saratoga County,223,132,78,6,48,28,26,16,0,10,195,106,62,6,38,583,63,520
360910610011,36, New York,091, Saratoga County,174,0,0,0,0,0,0,0,0,0,174,0,0,0,0,918,36,882
360910610012,36, New York,091, Saratoga County,165,18,18,0,0,38,0,0,0,0,127,18,18,0,0,694,146,548
360910610013,36, New York,091, Saratoga County,340,161,73,0,88,0,0,0,0,0,340,161,73,0,88,951,26,925
360910610021,36, New York,091, Saratoga County,224,55,0,0,55,0,0,0,0,0,224,55,0,0,55,818,71,747
360910610022,36, New York,091, Saratoga County,136,72,0,0,72,0,0,0,0,0,136,72,0,0,72,866,218,648
360910611011,36, New York,091, Saratoga County,157,48,0,0,48,38,38,0,0,38,119,10,0,0,10,273,63,210
360910611012,36, New York,091, Saratoga County,278,172,128,0,44,23,23,23,0,0,255,149,105,0,44,941,118,823
360910611013,36, New York,091, Saratoga County,146,0,0,0,0,0,0,0,0,0,146,0,0,0,0,519,57,462
360910611021,36, New York,091, Saratoga County,362,118,53,0,65,8,0,0,0,0,354,118,53,0,65,811,16,795
360910611022,36, New York,091, Saratoga County,331,226,203,23,0,0,0,0,0,0,331,226,203,23,0,857,0,857
360910611023,36, New York,091, Saratoga County,203,66,51,0,15,0,0,0,0,0,203,66,51,0,15,617,59,558
360910611024,36, New York,091, Saratoga County,175,56,42,0,14,0,0,0,0,0,175,56,42,0,14,504,4,500
360910612011,36, New York,091, Saratoga County,79,0,0,0,0,0,0,0,0,0,79,0,0,0,0,417,117,300
360910612012,36, New York,091, Saratoga County,210,82,66,0,16,16,16,0,0,16,194,66,66,0,0,698,44,654
360910612013,36, New York,091, Saratoga County,189,75,75,0,0,0,0,0,0,0,189,75,75,0,0,531,0,531
360910612021,36, New York,091, Saratoga County,221,39,25,0,14,0,0,0,0,0,221,39,25,0,14,788,84,704
360910612022,36, New York,091, Saratoga County,173,67,50,0,17,0,0,0,0,0,173,67,50,0,17,865,84,781
360910612023,36, New York,091, Saratoga County,188,46,25,0,21,21,21,0,0,21,167,25,25,0,0,1217,344,873
360910613011,36, New York,091, Saratoga County,311,72,54,18,0,29,5,5,0,0,282,67,49,18,0,719,68,651
360910613012,36, New York,091, Saratoga County,341,100,32,20,48,66,48,0,0,48,275,52,32,20,0,1093,167,926
360910613013,36, New York,091, Saratoga County,474,250,231,19,0,46,37,29,8,0,428,213,202,11,0,1122,84,1038
360910613031,36, New York,091, Saratoga County,3,0,0,0,0,0,0,0,0,0,3,0,0,0,0,10,0,10
360910613041,36, New York,091, Saratoga County,323,33,33,0,0,32,0,0,0,0,291,33,33,0,0,832,105,727
360910613042,36, New York,091, Saratoga County,295,148,148,0,0,0,0,0,0,0,295,148,148,0,0,649,4,645
360910613043,36, New York,091, Saratoga County,431,281,250,0,31,0,0,0,0,0,431,281,250,0,31,1031,0,1031
360910613051,36, New York,091, Saratoga County,528,217,199,0,18,40,0,0,0,0,488,217,199,0,18,1374,122,1252
360910613052,36, New York,091, Saratoga County,325,140,73,4,63,0,0,0,0,0,325,140,73,4,63,1020,106,914
360910613053,36, New York,091, Saratoga County,68,0,0,0,0,0,0,0,0,0,68,0,0,0,0,398,51,347
360910614011,36, New York,091, Saratoga County,370,165,67,55,43,9,9,9,0,0,361,156,58,55,43,1023,97,926
360910614012,36, New York,091, Saratoga County,242,114,67,8,39,0,0,0,0,0,242,114,67,8,39,620,25,595
360910614013,36, New York,091, Saratoga County,530,196,140,0,56,17,8,0,0,8,513,188,140,0,48,1651,121,1530
360910614031,36, New York,091, Saratoga County,714,239,111,26,102,0,0,0,0,0,714,239,111,26,102,2222,37,2185
360910614032,36, New York,091, Saratoga County,347,140,42,52,46,46,46,0,0,46,301,94,42,52,0,1107,95,1012
360910614033,36, New York,091, Saratoga County,218,47,34,13,0,0,0,0,0,0,218,47,34,13,0,670,31,639
360910614034,36, New York,091, Saratoga County,649,296,252,0,44,12,12,0,0,12,637,284,252,0,32,1560,42,1518
360910614041,36, New York,091, Saratoga County,235,104,100,0,4,4,4,0,0,4,231,100,100,0,0,606,13,593
360910614042,36, New York,091, Saratoga County,680,283,238,29,16,29,29,0,29,0,651,254,238,0,16,1858,36,1822
360910615001,36, New York,091, Saratoga County,502,201,175,11,15,14,11,0,0,11,488,190,175,11,4,1417,26,1391
360910615002,36, New York,091, Saratoga County,213,66,50,0,16,9,9,0,0,9,204,57,50,0,7,592,14,578
360910615003,36, New York,091, Saratoga County,303,137,127,1,9,57,50,43,0,7,246,87,84,1,2,865,143,722
360910616001,36, New York,091, Saratoga County,295,128,128,0,0,9,0,0,0,0,286,128,128,0,0,786,49,737
360910616002,36, New York,091, Saratoga County,199,65,52,0,13,9,0,0,0,0,190,65,52,0,13,658,46,612
360910616003,36, New York,091, Saratoga County,281,130,82,48,0,0,0,0,0,0,281,130,82,48,0,777,52,725
360910616004,36, New York,091, Saratoga County,396,168,133,14,21,0,0,0,0,0,396,168,133,14,21,1132,16,1116
360910617011,36, New York,091, Saratoga County,678,279,232,0,47,0,0,0,0,0,678,279,232,0,47,1588,36,1552
360910617012,36, New York,091, Saratoga County,756,394,328,0,66,0,0,0,0,0,756,394,328,0,66,2320,265,2055
360910617013,36, New York,091, Saratoga County,270,112,87,0,25,0,0,0,0,0,270,112,87,0,25,841,0,841
360910617021,36, New York,091, Saratoga County,521,255,227,12,16,9,9,0,0,9,512,246,227,12,7,1590,68,1522
360910617022,36, New York,091, Saratoga County,249,113,81,9,23,0,0,0,0,0,249,113,81,9,23,804,39,765
360910617023,36, New York,091, Saratoga County,502,252,82,42,128,0,0,0,0,0,502,252,82,42,128,1169,54,1115
360910618001,36, New York,091, Saratoga County,642,224,147,16,61,15,15,15,0,0,627,209,132,16,61,2157,164,1993
360910618002,36, New York,091, Saratoga County,234,98,57,0,41,24,24,0,0,24,210,74,57,0,17,779,24,755
360910618003,36, New York,091, Saratoga County,406,199,185,0,14,0,0,0,0,0,406,199,185,0,14,1245,48,1197
360910619041,36, New York,091, Saratoga County,433,83,21,0,62,0,0,0,0,0,433,83,21,0,62,1619,149,1470
360910619042,36, New York,091, Saratoga County,187,26,26,0,0,0,0,0,0,0,187,26,26,0,0,549,9,540
360910619043,36, New York,091, Saratoga County,457,157,121,0,36,33,0,0,0,0,424,157,121,0,36,1210,68,1142
360910619044,36, New York,091, Saratoga County,377,141,141,0,0,0,0,0,0,0,377,141,141,0,0,1203,0,1203
360910619051,36, New York,091, Saratoga County,256,84,63,0,21,0,0,0,0,0,256,84,63,0,21,798,0,798
360910619052,36, New York,091, Saratoga County,183,109,109,0,0,0,0,0,0,0,183,109,109,0,0,522,53,469
360910619053,36, New York,091, Saratoga County,401,158,133,0,25,33,0,0,0,0,368,158,133,0,25,1433,222,1211
360910619061,36, New York,091, Saratoga County,570,269,223,46,0,118,118,72,46,0,452,151,151,0,0,1906,351,1555
360910619062,36, New York,091, Saratoga County,228,98,83,8,7,0,0,0,0,0,228,98,83,8,7,767,25,742
360910619071,36, New York,091, Saratoga County,464,156,95,0,61,0,0,0,0,0,464,156,95,0,61,1372,49,1323
360910619072,36, New York,091, Saratoga County,880,292,233,23,36,0,0,0,0,0,880,292,233,23,36,2417,25,2392
360910620011,36, New York,091, Saratoga County,502,176,101,0,75,74,39,0,0,39,428,137,101,0,36,1058,117,941
360910620012,36, New York,091, Saratoga County,559,356,350,0,6,42,30,24,0,6,517,326,326,0,0,1794,196,1598
360910620013,36, New York,091, Saratoga County,329,35,35,0,0,0,0,0,0,0,329,35,35,0,0,891,0,891
360910620021,36, New York,091, Saratoga County,556,129,98,31,0,20,0,0,0,0,536,129,98,31,0,1561,59,1502
360910620022,36, New York,091, Saratoga County,250,126,64,30,32,30,30,0,30,0,220,96,64,0,32,653,104,549
360910621001,36, New York,091, Saratoga County,547,214,72,90,52,33,28,5,0,23,514,186,67,90,29,1438,197,1241
360910622001,36, New York,091, Saratoga County,143,98,57,34,7,24,0,0,0,0,119,98,57,34,7,901,125,776
360910622002,36, New York,091, Saratoga County,198,131,103,0,28,15,15,0,0,15,183,116,103,0,13,764,162,602
360910622003,36, New York,091, Saratoga County,280,174,107,7,60,56,56,0,0,56,224,118,107,7,4,820,199,621
360910623001,36, New York,091, Saratoga County,234,83,20,41,22,28,8,0,0,8,206,75,20,41,14,759,86,673
360910623002,36, New York,091, Saratoga County,382,211,76,30,105,112,68,0,14,54,270,143,76,16,51,952,228,724
360910624041,36, New York,091, Saratoga County,927,225,191,0,34,4,0,0,0,0,923,225,191,0,34,2585,69,2516
360910624061,36, New York,091, Saratoga County,234,111,104,0,7,7,7,0,0,7,227,104,104,0,0,772,12,760
360910624062,36, New York,091, Saratoga County,206,101,81,0,20,0,0,0,0,0,206,101,81,0,20,460,19,441
360910624063,36, New York,091, Saratoga County,569,313,256,24,33,17,9,0,0,9,552,304,256,24,24,1700,52,1648
360910624071,36, New York,091, Saratoga County,399,127,116,0,11,45,11,0,0,11,354,116,116,0,0,988,100,888
360910624072,36, New York,091, Saratoga County,335,115,59,33,23,0,0,0,0,0,335,115,59,33,23,1107,19,1088
360910624073,36, New York,091, Saratoga County,319,138,68,0,70,27,27,0,0,27,292,111,68,0,43,1467,86,1381
360910624081,36, New York,091, Saratoga County,186,68,44,0,24,0,0,0,0,0,186,68,44,0,24,849,70,779
360910624082,36, New York,091, Saratoga County,557,213,172,19,22,0,0,0,0,0,557,213,172,19,22,1602,0,1602
360910624091,36, New York,091, Saratoga County,118,0,0,0,0,0,0,0,0,0,118,0,0,0,0,484,46,438
360910624092,36, New York,091, Saratoga County,186,91,87,0,4,0,0,0,0,0,186,91,87,0,4,652,12,640
360910624093,36, New York,091, Saratoga County,479,233,157,23,53,0,0,0,0,0,479,233,157,23,53,1217,40,1177
360910624101,36, New York,091, Saratoga County,724,422,277,106,39,24,4,0,0,4,700,418,277,106,35,1667,96,1571
360910624102,36, New York,091, Saratoga County,356,61,33,0,28,17,17,0,0,17,339,44,33,0,11,1009,20,989
360910625011,36, New York,091, Saratoga County,506,248,229,0,19,14,0,0,0,0,492,248,229,0,19,1570,52,1518
360910625012,36, New York,091, Saratoga County,597,342,263,0,79,0,0,0,0,0,597,342,263,0,79,1616,15,1601
360910625013,36, New York,091, Saratoga County,262,120,99,21,0,0,0,0,0,0,262,120,99,21,0,588,0,588
360910625031,36, New York,091, Saratoga County,486,216,216,0,0,0,0,0,0,0,486,216,216,0,0,1374,0,1374
360910625032,36, New York,091, Saratoga County,587,318,272,0,46,0,0,0,0,0,587,318,272,0,46,1494,0,1494
360910625033,36, New York,091, Saratoga County,588,309,239,22,48,0,0,0,0,0,588,309,239,22,48,1129,0,1129
360910625034,36, New York,091, Saratoga County,56,24,24,0,0,0,0,0,0,0,56,24,24,0,0,275,16,259
360910625051,36, New York,091, Saratoga County,763,467,444,17,6,0,0,0,0,0,763,467,444,17,6,1760,38,1722
360910625052,36, New York,091, Saratoga County,453,180,152,0,28,9,9,0,0,9,444,171,152,0,19,1419,85,1334
360910625061,36, New York,091, Saratoga County,632,189,189,0,0,0,0,0,0,0,632,189,189,0,0,1542,11,1531
360910625062,36, New York,091, Saratoga County,356,163,115,31,17,0,0,0,0,0,356,163,115,31,17,953,11,942
360910625063,36, New York,091, Saratoga County,406,173,137,12,24,0,0,0,0,0,406,173,137,12,24,1365,6,1359
360910625071,36, New York,091, Saratoga County,508,262,156,30,76,11,0,0,0,0,497,262,156,30,76,1633,124,1509
360910625072,36, New York,091, Saratoga County,534,303,272,9,22,0,0,0,0,0,534,303,272,9,22,1353,9,1344
360910625081,36, New York,091, Saratoga County,474,200,167,21,12,0,0,0,0,0,474,200,167,21,12,1262,56,1206
360910625082,36, New York,091, Saratoga County,152,71,0,38,33,0,0,0,0,0,152,71,0,38,33,587,41,546
360910625083,36, New York,091, Saratoga County,626,315,245,23,47,23,12,12,0,0,603,303,233,23,47,1508,60,1448
360910625091,36, New York,091, Saratoga County,541,266,236,0,30,0,0,0,0,0,541,266,236,0,30,1355,28,1327
360910625092,36, New York,091, Saratoga County,324,127,60,10,57,0,0,0,0,0,324,127,60,10,57,1079,48,1031
360910626011,36, New York,091, Saratoga County,664,405,367,5,33,0,0,0,0,0,664,405,367,5,33,1399,17,1382
360910626012,36, New York,091, Saratoga County,329,131,65,0,66,0,0,0,0,0,329,131,65,0,66,794,0,794
360910626021,36, New York,091, Saratoga County,491,246,215,14,17,0,0,0,0,0,491,246,215,14,17,1018,18,1000
360910626022,36, New York,091, Saratoga County,1421,687,625,6,56,24,0,0,0,0,1397,687,625,6,56,3807,148,3659
360910627001,36, New York,091, Saratoga County,531,310,217,73,20,0,0,0,0,0,531,310,217,73,20,1350,38,1312
360910627002,36, New York,091, Saratoga County,659,283,217,0,66,0,0,0,0,0,659,283,217,0,66,2019,85,1934
360910627003,36, New York,091, Saratoga County,529,263,50,0,213,32,0,0,0,0,497,263,50,0,213,1438,154,1284
360910628001,36, New York,091, Saratoga County,138,39,13,0,26,0,0,0,0,0,138,39,13,0,26,575,36,539
360910628002,36, New York,091, Saratoga County,326,104,74,12,18,12,12,6,0,6,314,92,68,12,12,1249,128,1121
360910629001,36, New York,091, Saratoga County,213,61,29,32,0,0,0,0,0,0,213,61,29,32,0,600,0,600
360930201011,36, New York,093, Schenectady County,114,33,33,0,0,0,0,0,0,0,114,33,33,0,0,886,49,837
360930201012,36, New York,093, Schenectady County,302,122,94,0,28,0,0,0,0,0,302,122,94,0,28,1113,24,1089
360930201021,36, New York,093, Schenectady County,208,126,102,11,13,23,23,12,11,0,185,103,90,0,13,648,150,498
360930201022,36, New York,093, Schenectady County,360,163,15,56,92,32,22,0,0,22,328,141,15,56,70,1292,251,1041
360930202001,36, New York,093, Schenectady County,148,47,24,0,23,53,24,24,0,0,95,23,0,0,23,561,86,475
360930202002,36, New York,093, Schenectady County,301,126,79,20,27,37,37,37,0,0,264,89,42,20,27,1414,431,983
360930203001,36, New York,093, Schenectady County,73,8,0,0,8,0,0,0,0,0,73,8,0,0,8,540,104,436
360930203002,36, New York,093, Schenectady County,100,71,33,0,38,0,0,0,0,0,100,71,33,0,38,488,59,429
360930205001,36, New York,093, Schenectady County,363,207,207,0,0,11,11,11,0,0,352,196,196,0,0,994,53,941
360930205002,36, New York,093, Schenectady County,144,75,56,0,19,0,0,0,0,0,144,75,56,0,19,582,0,582
360930205003,36, New York,093, Schenectady County,225,165,99,28,38,28,28,0,28,0,197,137,99,0,38,580,83,497
360930205004,36, New York,093, Schenectady County,198,31,31,0,0,20,0,0,0,0,178,31,31,0,0,512,20,492
360930205005,36, New York,093, Schenectady County,253,185,185,0,0,0,0,0,0,0,253,185,185,0,0,651,27,624
360930205006,36, New York,093, Schenectady County,184,74,20,26,28,28,28,0,0,28,156,46,20,26,0,545,103,442
360930206001,36, New York,093, Schenectady County,461,242,188,0,54,0,0,0,0,0,461,242,188,0,54,1421,34,1387
360930206002,36, New York,093, Schenectady County,417,139,99,0,40,62,36,34,0,2,355,103,65,0,38,1265,220,1045
360930207001,36, New York,093, Schenectady County,219,114,88,26,0,0,0,0,0,0,219,114,88,26,0,568,0,568
360930207002,36, New York,093, Schenectady County,342,276,200,20,56,170,170,114,0,56,172,106,86,20,0,931,432,499
360930207003,36, New York,093, Schenectady County,151,119,49,28,42,0,0,0,0,0,151,119,49,28,42,581,23,558
360930207004,36, New York,093, Schenectady County,158,117,48,0,69,0,0,0,0,0,158,117,48,0,69,426,90,336
360930207005,36, New York,093, Schenectady County,435,220,47,21,152,209,148,0,0,148,226,72,47,21,4,1183,349,834
360930208001,36, New York,093, Schenectady County,208,80,24,14,42,42,42,0,0,42,166,38,24,14,0,1093,216,877
360930208002,36, New York,093, Schenectady County,137,64,0,0,64,37,37,0,0,37,100,27,0,0,27,481,93,388
360930208003,36, New York,093, Schenectady County,327,112,112,0,0,12,0,0,0,0,315,112,112,0,0,682,97,585
360930208004,36, New York,093, Schenectady County,66,66,26,0,40,25,25,0,0,25,41,41,26,0,15,306,109,197
360930209001,36, New York,093, Schenectady County,234,142,30,0,112,114,114,30,0,84,120,28,0,0,28,614,211,403
360930209002,36, New York,093, Schenectady County,268,108,30,0,78,43,26,0,0,26,225,82,30,0,52,550,245,305
360930209003,36, New York,093, Schenectady County,68,43,0,23,20,0,0,0,0,0,68,43,0,23,20,253,42,211
360930209004,36, New York,093, Schenectady County,329,20,20,0,0,5,5,5,0,0,324,15,15,0,0,802,78,724
360930210011,36, New York,093, Schenectady County,165,116,0,8,108,0,0,0,0,0,165,116,0,8,108,941,199,742
360930210021,36, New York,093, Schenectady County,106,59,0,0,59,32,32,0,0,32,74,27,0,0,27,643,390,253
360930210022,36, New York,093, Schenectady County,223,147,45,68,34,94,85,0,53,32,129,62,45,15,2,712,261,451
360930210023,36, New York,093, Schenectady County,114,79,2,0,77,89,77,0,0,77,25,2,2,0,0,571,386,185
360930212001,36, New York,093, Schenectady County,168,98,56,0,42,9,0,0,0,0,159,98,56,0,42,946,47,899
360930212002,36, New York,093, Schenectady County,302,112,74,0,38,23,23,0,0,23,279,89,74,0,15,918,118,800
360930212003,36, New York,093, Schenectady County,150,13,0,13,0,0,0,0,0,0,150,13,0,13,0,622,111,511
360930214001,36, New York,093, Schenectady County,185,95,36,59,0,75,59,0,59,0,110,36,36,0,0,569,210,359
360930214002,36, New York,093, Schenectady County,206,62,0,0,62,71,42,0,0,42,135,20,0,0,20,679,161,518
360930214003,36, New York,093, Schenectady County,161,31,13,18,0,18,18,0,18,0,143,13,13,0,0,377,70,307
360930214004,36, New York,093, Schenectady County,218,128,7,11,110,126,86,0,11,75,92,42,7,0,35,635,339,296
360930215001,36, New York,093, Schenectady County,114,74,0,21,53,31,21,0,21,0,83,53,0,0,53,621,229,392
360930215002,36, New York,093, Schenectady County,473,208,36,28,144,241,91,0,28,63,232,117,36,0,81,1128,591,537
360930215003,36, New York,093, Schenectady County,154,126,45,0,81,0,0,0,0,0,154,126,45,0,81,318,31,287
360930216001,36, New York,093, Schenectady County,83,33,33,0,0,24,0,0,0,0,59,33,33,0,0,458,214,244
360930216002,36, New York,093, Schenectady County,133,95,56,26,13,20,0,0,0,0,113,95,56,26,13,413,110,303
360930216003,36, New York,093, Schenectady County,212,21,8,0,13,47,13,0,0,13,165,8,8,0,0,664,97,567
360930216004,36, New York,093, Schenectady County,284,49,6,0,43,22,10,0,0,10,262,39,6,0,33,917,83,834
360930217001,36, New York,093, Schenectady County,156,25,16,0,9,16,16,16,0,0,140,9,0,0,9,553,74,479
360930217002,36, New York,093, Schenectady County,169,38,33,0,5,0,0,0,0,0,169,38,33,0,5,693,43,650
360930217003,36, New York,093, Schenectady County,420,203,121,0,82,35,35,24,0,11,385,168,97,0,71,1237,102,1135
360930217004,36, New York,093, Schenectady County,159,109,0,0,109,98,98,0,0,98,61,11,0,0,11,455,216,239
360930218011,36, New York,093, Schenectady County,170,57,44,13,0,0,0,0,0,0,170,57,44,13,0,831,6,825
360930218012,36, New York,093, Schenectady County,293,122,76,10,36,46,12,12,0,0,247,110,64,10,36,835,119,716
360930218021,36, New York,093, Schenectady County,201,144,105,16,23,89,89,89,0,0,112,55,16,16,23,1328,234,1094
360930218022,36, New York,093, Schenectady County,120,0,0,0,0,0,0,0,0,0,120,0,0,0,0,588,40,548
360930218023,36, New York,093, Schenectady County,221,66,66,0,0,0,0,0,0,0,221,66,66,0,0,729,0,729
360930218024,36, New York,093, Schenectady County,355,121,98,23,0,0,0,0,0,0,355,121,98,23,0,1027,85,942
360930319011,36, New York,093, Schenectady County,721,409,391,0,18,0,0,0,0,0,721,409,391,0,18,1862,62,1800
360930319012,36, New York,093, Schenectady County,635,344,344,0,0,0,0,0,0,0,635,344,344,0,0,1650,36,1614
360930319021,36, New York,093, Schenectady County,85,61,47,0,14,0,0,0,0,0,85,61,47,0,14,463,8,455
360930319022,36, New York,093, Schenectady County,392,130,105,17,8,6,0,0,0,0,386,130,105,17,8,1185,55,1130
360930319023,36, New York,093, Schenectady County,219,81,73,0,8,0,0,0,0,0,219,81,73,0,8,688,0,688
360930320001,36, New York,093, Schenectady County,282,129,129,0,0,0,0,0,0,0,282,129,129,0,0,735,0,735
360930320002,36, New York,093, Schenectady County,153,84,84,0,0,0,0,0,0,0,153,84,84,0,0,645,0,645
360930320003,36, New York,093, Schenectady County,280,109,109,0,0,0,0,0,0,0,280,109,109,0,0,668,0,668
360930320004,36, New York,093, Schenectady County,218,48,48,0,0,11,0,0,0,0,207,48,48,0,0,500,37,463
360930320005,36, New York,093, Schenectady County,370,146,57,89,0,0,0,0,0,0,370,146,57,89,0,868,31,837
360930320006,36, New York,093, Schenectady County,302,195,147,16,32,0,0,0,0,0,302,195,147,16,32,648,37,611
360930320007,36, New York,093, Schenectady County,199,158,97,0,61,28,12,0,0,12,171,146,97,0,49,767,119,648
360930321011,36, New York,093, Schenectady County,235,182,182,0,0,0,0,0,0,0,235,182,182,0,0,473,2,471
360930321012,36, New York,093, Schenectady County,265,86,74,0,12,0,0,0,0,0,265,86,74,0,12,646,17,629
360930321013,36, New York,093, Schenectady County,177,82,82,0,0,0,0,0,0,0,177,82,82,0,0,544,5,539
360930321014,36, New York,093, Schenectady County,376,161,161,0,0,0,0,0,0,0,376,161,161,0,0,877,23,854
360930321015,36, New York,093, Schenectady County,534,250,243,0,7,0,0,0,0,0,534,250,243,0,7,1356,6,1350
360930321021,36, New York,093, Schenectady County,259,95,89,0,6,0,0,0,0,0,259,95,89,0,6,741,24,717
360930321022,36, New York,093, Schenectady County,346,152,138,7,7,6,0,0,0,0,340,152,138,7,7,803,17,786
360930322001,36, New York,093, Schenectady County,241,187,134,0,53,0,0,0,0,0,241,187,134,0,53,930,116,814
360930322002,36, New York,093, Schenectady County,492,298,233,47,18,18,18,0,0,18,474,280,233,47,0,1493,36,1457
360930322003,36, New York,093, Schenectady County,159,67,0,0,67,0,0,0,0,0,159,67,0,0,67,502,5,497
360930322004,36, New York,093, Schenectady County,219,83,72,0,11,11,11,0,0,11,208,72,72,0,0,563,32,531
360930323001,36, New York,093, Schenectady County,143,47,12,11,24,0,0,0,0,0,143,47,12,11,24,648,33,615
360930323002,36, New York,093, Schenectady County,197,54,27,10,17,2,2,0,0,2,195,52,27,10,15,607,10,597
360930323003,36, New York,093, Schenectady County,247,125,92,0,33,12,12,0,0,12,235,113,92,0,21,824,17,807
360930324021,36, New York,093, Schenectady County,164,103,103,0,0,8,0,0,0,0,156,103,103,0,0,434,19,415
360930324022,36, New York,093, Schenectady County,430,201,149,0,52,36,22,0,0,22,394,179,149,0,30,1246,88,1158
360930324023,36, New York,093, Schenectady County,148,45,25,20,0,30,20,0,20,0,118,25,25,0,0,877,65,812
360930324031,36, New York,093, Schenectady County,206,95,66,7,22,11,5,0,0,5,195,90,66,7,17,843,24,819
360930324032,36, New York,093, Schenectady County,354,165,144,0,21,0,0,0,0,0,354,165,144,0,21,1088,5,1083
360930324041,36, New York,093, Schenectady County,302,88,68,20,0,0,0,0,0,0,302,88,68,20,0,960,23,937
360930324042,36, New York,093, Schenectady County,615,166,64,93,9,37,37,0,37,0,578,129,64,56,9,2144,121,2023
360930324043,36, New York,093, Schenectady County,249,117,49,18,50,0,0,0,0,0,249,117,49,18,50,626,12,614
360930324044,36, New York,093, Schenectady County,504,161,146,0,15,0,0,0,0,0,504,161,146,0,15,1393,26,1367
360930325021,36, New York,093, Schenectady County,325,127,115,12,0,0,0,0,0,0,325,127,115,12,0,874,7,867
360930325022,36, New York,093, Schenectady County,355,183,164,12,7,0,0,0,0,0,355,183,164,12,7,1068,19,1049
360930325031,36, New York,093, Schenectady County,438,180,101,12,67,0,0,0,0,0,438,180,101,12,67,1004,0,1004
360930325032,36, New York,093, Schenectady County,436,154,134,11,9,37,20,0,11,9,399,134,134,0,0,1534,166,1368
360930325033,36, New York,093, Schenectady County,306,124,103,10,11,0,0,0,0,0,306,124,103,10,11,860,50,810
360930325041,36, New York,093, Schenectady County,221,41,41,0,0,11,4,4,0,0,210,37,37,0,0,597,22,575
360930325042,36, New York,093, Schenectady County,438,158,150,4,4,4,4,0,0,4,434,154,150,4,0,1116,22,1094
360930326011,36, New York,093, Schenectady County,285,123,91,4,28,0,0,0,0,0,285,123,91,4,28,801,25,776
360930326012,36, New York,093, Schenectady County,331,146,65,23,58,24,21,0,5,16,307,125,65,18,42,1029,78,951
360930326021,36, New York,093, Schenectady County,412,194,74,81,39,0,0,0,0,0,412,194,74,81,39,1277,52,1225
360930326022,36, New York,093, Schenectady County,179,83,42,5,36,36,36,0,0,36,143,47,42,5,0,387,52,335
360930326023,36, New York,093, Schenectady County,375,99,89,0,10,0,0,0,0,0,375,99,89,0,10,1711,86,1625
360930327001,36, New York,093, Schenectady County,301,93,71,0,22,0,0,0,0,0,301,93,71,0,22,937,0,937
360930327002,36, New York,093, Schenectady County,165,90,66,0,24,39,33,11,0,22,126,57,55,0,2,619,92,527
360930327003,36, New York,093, Schenectady County,301,104,75,14,15,34,14,0,14,0,267,90,75,0,15,1206,133,1073
360930327004,36, New York,093, Schenectady County,147,113,60,0,53,23,23,0,0,23,124,90,60,0,30,428,76,352
360930329011,36, New York,093, Schenectady County,266,109,99,0,10,10,10,0,0,10,256,99,99,0,0,818,23,795
360930329012,36, New York,093, Schenectady County,315,112,88,12,12,0,0,0,0,0,315,112,88,12,12,946,8,938
360930329013,36, New York,093, Schenectady County,294,117,37,0,80,0,0,0,0,0,294,117,37,0,80,658,33,625
360930329014,36, New York,093, Schenectady County,116,37,37,0,0,7,0,0,0,0,109,37,37,0,0,351,31,320
360930329021,36, New York,093, Schenectady County,144,42,29,0,13,0,0,0,0,0,144,42,29,0,13,485,0,485
360930329022,36, New York,093, Schenectady County,203,102,90,7,5,0,0,0,0,0,203,102,90,7,5,529,0,529
360930329023,36, New York,093, Schenectady County,373,236,160,0,76,0,0,0,0,0,373,236,160,0,76,1128,73,1055
360930329024,36, New York,093, Schenectady County,246,57,40,17,0,6,0,0,0,0,240,57,40,17,0,809,12,797
360930329025,36, New York,093, Schenectady County,131,69,19,10,40,0,0,0,0,0,131,69,19,10,40,376,15,361
360930330021,36, New York,093, Schenectady County,704,351,229,25,97,5,5,5,0,0,699,346,224,25,97,1800,41,1759
360930330031,36, New York,093, Schenectady County,461,214,204,10,0,14,0,0,0,0,447,214,204,10,0,1645,55,1590
360930330032,36, New York,093, Schenectady County,202,45,39,0,6,26,18,18,0,0,176,27,21,0,6,740,81,659
360930330033,36, New York,093, Schenectady County,154,66,39,11,16,0,0,0,0,0,154,66,39,11,16,736,36,700
360930330041,36, New York,093, Schenectady County,291,108,96,0,12,0,0,0,0,0,291,108,96,0,12,986,15,971
360930330042,36, New York,093, Schenectady County,138,54,39,0,15,0,0,0,0,0,138,54,39,0,15,393,0,393
360930330043,36, New York,093, Schenectady County,217,67,50,17,0,17,17,0,17,0,200,50,50,0,0,679,36,643
360930330044,36, New York,093, Schenectady County,111,58,7,0,51,7,7,7,0,0,104,51,0,0,51,323,9,314
360930331011,36, New York,093, Schenectady County,160,47,38,9,0,4,4,0,4,0,156,43,38,5,0,493,4,489
360930331012,36, New York,093, Schenectady County,359,124,87,5,32,14,4,0,0,4,345,120,87,5,28,1130,56,1074
360930331021,36, New York,093, Schenectady County,351,120,120,0,0,0,0,0,0,0,351,120,120,0,0,1182,202,980
360930331022,36, New York,093, Schenectady County,381,204,179,0,25,11,11,0,0,11,370,193,179,0,14,849,11,838
360930331023,36, New York,093, Schenectady County,339,117,26,19,72,52,52,4,4,44,287,65,22,15,28,1066,107,959
360930331024,36, New York,093, Schenectady County,183,55,52,0,3,0,0,0,0,0,183,55,52,0,3,656,17,639
360930331025,36, New York,093, Schenectady County,302,128,128,0,0,13,0,0,0,0,289,128,128,0,0,938,43,895
360930332001,36, New York,093, Schenectady County,354,183,74,42,67,67,67,0,0,67,287,116,74,42,0,1084,134,950
360930332002,36, New York,093, Schenectady County,199,89,18,34,37,28,21,0,0,21,171,68,18,34,16,683,66,617
360930332003,36, New York,093, Schenectady County,89,65,53,12,0,12,12,0,12,0,77,53,53,0,0,321,35,286
360930332004,36, New York,093, Schenectady County,251,107,20,0,87,34,9,0,0,9,217,98,20,0,78,554,83,471
360930333001,36, New York,093, Schenectady County,402,133,77,0,56,0,0,0,0,0,402,133,77,0,56,1227,46,1181
360930333002,36, New York,093, Schenectady County,245,134,75,48,11,0,0,0,0,0,245,134,75,48,11,607,15,592
360930334001,36, New York,093, Schenectady County,138,29,0,0,29,9,9,0,0,9,129,20,0,0,20,432,55,377
360930334002,36, New York,093, Schenectady County,199,73,35,0,38,4,0,0,0,0,195,73,35,0,38,935,121,814
360930334003,36, New York,093, Schenectady County,0,0,0,0,0,0,0,0,0,0,0,0,0,0,0,0,0,0
360930335001,36, New York,093, Schenectady County,439,93,93,0,0,49,0,0,0,0,390,93,93,0,0,2412,297,2115
360730402001,36, New York,073, Orleans County,404,105,77,0,28,25,0,0,0,0,379,105,77,0,28,931,95,836
360730402002,36, New York,073, Orleans County,464,206,198,0,8,23,17,9,0,8,441,189,189,0,0,1594,122,1472
360730403001,36, New York,073, Orleans County,323,136,116,9,11,15,15,7,0,8,308,121,109,9,3,889,115,774
360730403002,36, New York,073, Orleans County,376,116,63,5,48,19,5,0,5,0,357,111,63,0,48,897,63,834
360730404001,36, New York,073, Orleans County,276,170,98,20,52,18,18,0,0,18,258,152,98,20,34,593,31,562
360730404002,36, New York,073, Orleans County,238,84,34,0,50,0,0,0,0,0,238,84,34,0,50,736,106,630
360730404003,36, New York,073, Orleans County,380,159,97,48,14,7,7,0,0,7,373,152,97,48,7,1285,70,1215
360730405001,36, New York,073, Orleans County,255,117,48,11,58,57,49,0,0,49,198,68,48,11,9,759,186,573
360730405002,36, New York,073, Orleans County,298,209,92,85,32,85,85,0,85,0,213,124,92,0,32,955,203,752
360730406011,36, New York,073, Orleans County,347,104,85,3,16,29,29,29,0,0,318,75,56,3,16,935,134,801
360730406012,36, New York,073, Orleans County,169,54,27,9,18,16,10,0,6,4,153,44,27,3,14,484,78,406
360730406021,36, New York,073, Orleans County,0,0,0,0,0,0,0,0,0,0,0,0,0,0,0,0,0,0
360730406031,36, New York,073, Orleans County,307,123,92,0,31,20,20,0,0,20,287,103,92,0,11,962,22,940
360730406032,36, New York,073, Orleans County,328,60,23,37,0,37,37,0,37,0,291,23,23,0,0,1216,195,1021
360730406033,36, New York,073, Orleans County,219,70,34,21,15,24,8,0,0,8,195,62,34,21,7,760,220,540
360730407011,36, New York,073, Orleans County,264,114,23,0,91,25,25,0,0,25,239,89,23,0,66,1014,84,930
360730407012,36, New York,073, Orleans County,433,251,33,15,203,156,156,12,15,129,277,95,21,0,74,1131,327,804
360730407021,36, New York,073, Orleans County,64,28,18,0,10,0,0,0,0,0,64,28,18,0,10,509,138,371
360730407022,36, New York,073, Orleans County,275,116,44,0,72,16,0,0,0,0,259,116,44,0,72,989,182,807
360730407023,36, New York,073, Orleans County,329,113,19,94,0,19,19,19,0,0,310,94,0,94,0,832,62,770
360730408011,36, New York,073, Orleans County,595,211,104,53,54,19,19,0,12,7,576,192,104,41,47,1677,128,1549
360730408012,36, New York,073, Orleans County,356,136,47,47,42,33,33,0,0,33,323,103,47,47,9,898,55,843
360730408021,36, New York,073, Orleans County,304,46,27,0,19,15,15,9,0,6,289,31,18,0,13,793,37,756
360730408022,36, New York,073, Orleans County,323,193,103,58,32,32,32,0,0,32,291,161,103,58,0,773,108,665
360730408023,36, New York,073, Orleans County,385,176,116,8,52,15,9,9,0,0,370,167,107,8,52,1181,55,1126
360730408024,36, New York,073, Orleans County,354,97,53,8,36,34,0,0,0,0,320,97,53,8,36,1005,128,877
360734012001,36, New York,073, Orleans County,503,283,116,96,71,106,99,10,53,36,397,184,106,43,35,1203,177,1026
360734012002,36, New York,073, Orleans County,240,22,22,0,0,8,0,0,0,0,232,22,22,0,0,841,98,743
360734012003,36, New York,073, Orleans County,253,101,71,10,20,46,19,12,7,0,207,82,59,3,20,683,121,562
360734013001,36, New York,073, Orleans County,626,293,223,29,41,18,3,0,0,3,608,290,223,29,38,1579,70,1509
360734013002,36, New York,073, Orleans County,445,168,110,0,58,7,7,0,0,7,438,161,110,0,51,1091,26,1065
360734013003,36, New York,073, Orleans County,335,75,62,0,13,18,13,0,0,13,317,62,62,0,0,948,48,900
360739900000,36, New York,073, Orleans County,0,0,0,0,0,0,0,0,0,0,0,0,0,0,0,0,0,0
360270100001,36, New York,027, Dutchess County,234,49,16,7,26,26,26,0,0,26,208,23,16,7,0,443,0,443
360270100002,36, New York,027, Dutchess County,262,148,113,0,35,37,37,9,0,28,225,111,104,0,7,820,74,746
360270100003,36, New York,027, Dutchess County,341,136,78,37,21,9,0,0,0,0,332,136,78,37,21,852,84,768
360270100004,36, New York,027, Dutchess County,146,100,71,0,29,42,42,34,0,8,104,58,37,0,21,535,82,453
360270200031,36, New York,027, Dutchess County,215,81,33,0,48,16,10,10,0,0,199,71,23,0,48,592,28,564
360270200032,36, New York,027, Dutchess County,269,161,63,61,37,38,38,0,38,0,231,123,63,23,37,624,8,616
360270200033,36, New York,027, Dutchess County,379,229,206,23,0,23,23,0,23,0,356,206,206,0,0,866,59,807
360270200034,36, New York,027, Dutchess County,384,120,117,0,3,12,0,0,0,0,372,120,117,0,3,1105,23,1082
360270200041,36, New York,027, Dutchess County,66,39,39,0,0,0,0,0,0,0,66,39,39,0,0,250,15,235
360270200042,36, New York,027, Dutchess County,340,107,86,18,3,13,13,0,13,0,327,94,86,5,3,910,36,874
360270200043,36, New York,027, Dutchess County,287,103,103,0,0,10,10,10,0,0,277,93,93,0,0,864,24,840
360270200051,36, New York,027, Dutchess County,442,232,126,24,82,55,55,0,0,55,387,177,126,24,27,1471,112,1359
360270200052,36, New York,027, Dutchess County,320,135,135,0,0,0,0,0,0,0,320,135,135,0,0,773,10,763
360270200053,36, New York,027, Dutchess County,203,69,69,0,0,0,0,0,0,0,203,69,69,0,0,763,22,741
360270200054,36, New York,027, Dutchess County,341,199,177,22,0,0,0,0,0,0,341,199,177,22,0,864,18,846
360270300001,36, New York,027, Dutchess County,316,48,35,0,13,0,0,0,0,0,316,48,35,0,13,785,11,774
360270300002,36, New York,027, Dutchess County,294,69,69,0,0,0,0,0,0,0,294,69,69,0,0,1075,201,874
360270300003,36, New York,027, Dutchess County,276,141,125,7,9,0,0,0,0,0,276,141,125,7,9,678,10,668
360270300004,36, New York,027, Dutchess County,258,110,55,3,52,0,0,0,0,0,258,110,55,3,52,756,31,725
360270400011,36, New York,027, Dutchess County,179,109,72,0,37,13,0,0,0,0,166,109,72,0,37,511,31,480
360270400012,36, New York,027, Dutchess County,764,162,127,0,35,28,18,0,0,18,736,144,127,0,17,2118,151,1967
360270400013,36, New York,027, Dutchess County,208,65,65,0,0,39,0,0,0,0,169,65,65,0,0,624,128,496
360270400014,36, New York,027, Dutchess County,169,45,10,0,35,70,35,0,0,35,99,10,10,0,0,573,200,373
360270400031,36, New York,027, Dutchess County,500,122,58,0,64,22,22,0,0,22,478,100,58,0,42,1331,172,1159
360270400032,36, New York,027, Dutchess County,354,113,32,54,27,48,48,11,10,27,306,65,21,44,0,1089,225,864
360270400033,36, New York,027, Dutchess County,226,129,104,0,25,0,0,0,0,0,226,129,104,0,25,604,29,575
360270501021,36, New York,027, Dutchess County,370,243,170,11,62,20,11,0,11,0,350,232,170,0,62,870,49,821
360270501022,36, New York,027, Dutchess County,615,273,218,5,50,24,24,24,0,0,591,249,194,5,50,1930,83,1847
360270501031,36, New York,027, Dutchess County,126,52,52,0,0,0,0,0,0,0,126,52,52,0,0,349,0,349
360270501032,36, New York,027, Dutchess County,460,246,145,20,81,6,0,0,0,0,454,246,145,20,81,1284,64,1220
360270501033,36, New York,027, Dutchess County,333,225,225,0,0,0,0,0,0,0,333,225,225,0,0,945,6,939
360270501034,36, New York,027, Dutchess County,385,258,229,0,29,0,0,0,0,0,385,258,229,0,29,870,0,870
360270501035,36, New York,027, Dutchess County,315,114,114,0,0,43,43,43,0,0,272,71,71,0,0,861,57,804
360270501041,36, New York,027, Dutchess County,210,55,31,0,24,0,0,0,0,0,210,55,31,0,24,587,7,580
360270501042,36, New York,027, Dutchess County,233,45,13,32,0,0,0,0,0,0,233,45,13,32,0,667,0,667
360270501043,36, New York,027, Dutchess County,663,386,386,0,0,0,0,0,0,0,663,386,386,0,0,1679,22,1657
360270501044,36, New York,027, Dutchess County,360,178,178,0,0,0,0,0,0,0,360,178,178,0,0,1070,16,1054
360270501045,36, New York,027, Dutchess County,224,75,75,0,0,0,0,0,0,0,224,75,75,0,0,488,14,474
360270502031,36, New York,027, Dutchess County,230,113,105,0,8,8,8,0,0,8,222,105,105,0,0,778,8,770
360270502032,36, New York,027, Dutchess County,384,162,121,9,32,8,8,8,0,0,376,154,113,9,32,1210,45,1165
360270502033,36, New York,027, Dutchess County,395,137,118,15,4,0,0,0,0,0,395,137,118,15,4,1205,31,1174
360270502034,36, New York,027, Dutchess County,319,149,149,0,0,0,0,0,0,0,319,149,149,0,0,942,13,929
360270502041,36, New York,027, Dutchess County,525,259,231,0,28,0,0,0,0,0,525,259,231,0,28,1192,13,1179
360270502042,36, New York,027, Dutchess County,306,86,68,0,18,6,0,0,0,0,300,86,68,0,18,885,32,853
360270502051,36, New York,027, Dutchess County,721,379,326,0,53,63,53,0,0,53,658,326,326,0,0,1938,161,1777
360270502052,36, New York,027, Dutchess County,255,70,70,0,0,0,0,0,0,0,255,70,70,0,0,571,0,571
360270502053,36, New York,027, Dutchess County,438,143,143,0,0,11,0,0,0,0,427,143,143,0,0,974,22,952
360270502054,36, New York,027, Dutchess County,270,75,65,0,10,10,0,0,0,0,260,75,65,0,10,718,20,698
360270601001,36, New York,027, Dutchess County,242,110,91,0,19,0,0,0,0,0,242,110,91,0,19,1286,114,1172
360270601002,36, New York,027, Dutchess County,344,51,51,0,0,0,0,0,0,0,344,51,51,0,0,1011,69,942
360270601003,36, New York,027, Dutchess County,7,0,0,0,0,0,0,0,0,0,7,0,0,0,0,167,4,163
360270601004,36, New York,027, Dutchess County,544,174,174,0,0,0,0,0,0,0,544,174,174,0,0,1609,233,1376
360270601005,36, New York,027, Dutchess County,0,0,0,0,0,0,0,0,0,0,0,0,0,0,0,0,0,0
360270602011,36, New York,027, Dutchess County,290,105,59,5,41,14,0,0,0,0,276,105,59,5,41,747,82,665
360270602012,36, New York,027, Dutchess County,451,131,78,0,53,0,0,0,0,0,451,131,78,0,53,1112,0,1112
360270602013,36, New York,027, Dutchess County,328,75,65,0,10,0,0,0,0,0,328,75,65,0,10,918,18,900
360270602021,36, New York,027, Dutchess County,308,73,73,0,0,0,0,0,0,0,308,73,73,0,0,1435,78,1357
360270602022,36, New York,027, Dutchess County,422,116,116,0,0,35,0,0,0,0,387,116,116,0,0,1323,141,1182
360270602023,36, New York,027, Dutchess County,243,131,65,0,66,46,46,0,0,46,197,85,65,0,20,599,56,543
360270602024,36, New York,027, Dutchess County,109,72,40,18,14,0,0,0,0,0,109,72,40,18,14,310,0,310
360270603011,36, New York,027, Dutchess County,392,250,240,0,10,0,0,0,0,0,392,250,240,0,10,912,8,904
360270603012,36, New York,027, Dutchess County,260,124,82,34,8,0,0,0,0,0,260,124,82,34,8,600,0,600
360270603013,36, New York,027, Dutchess County,296,87,53,19,15,30,0,0,0,0,266,87,53,19,15,816,84,732
360270603014,36, New York,027, Dutchess County,216,28,28,0,0,0,0,0,0,0,216,28,28,0,0,763,33,730
360270603021,36, New York,027, Dutchess County,657,273,224,29,20,47,11,0,0,11,610,262,224,29,9,1869,76,1793
360270604001,36, New York,027, Dutchess County,185,50,34,9,7,0,0,0,0,0,185,50,34,9,7,576,27,549
360270604002,36, New York,027, Dutchess County,374,191,119,32,40,26,9,0,0,9,348,182,119,32,31,1161,80,1081
360270701011,36, New York,027, Dutchess County,120,44,29,0,15,0,0,0,0,0,120,44,29,0,15,461,52,409
360270701012,36, New York,027, Dutchess County,403,143,94,0,49,50,50,16,0,34,353,93,78,0,15,1069,74,995
360270701013,36, New York,027, Dutchess County,652,267,267,0,0,58,0,0,0,0,594,267,267,0,0,1715,168,1547
360270701021,36, New York,027, Dutchess County,104,36,0,15,21,13,13,0,0,13,91,23,0,15,8,323,13,310
360270701022,36, New York,027, Dutchess County,602,235,182,39,14,103,49,23,26,0,499,186,159,13,14,1439,228,1211
360270701023,36, New York,027, Dutchess County,366,42,42,0,0,39,0,0,0,0,327,42,42,0,0,1112,180,932
360270702011,36, New York,027, Dutchess County,375,157,51,41,65,34,17,0,17,0,341,140,51,24,65,1260,197,1063
360270702012,36, New York,027, Dutchess County,172,18,0,0,18,0,0,0,0,0,172,18,0,0,18,593,50,543
360270702013,36, New York,027, Dutchess County,132,68,28,0,40,0,0,0,0,0,132,68,28,0,40,406,40,366
360270703011,36, New York,027, Dutchess County,445,135,135,0,0,0,0,0,0,0,445,135,135,0,0,1341,16,1325
360270703012,36, New York,027, Dutchess County,415,190,127,43,20,82,82,39,43,0,333,108,88,0,20,1089,246,843
360270703013,36, New York,027, Dutchess County,403,176,97,28,51,21,21,21,0,0,382,155,76,28,51,1035,79,956
360270703014,36, New York,027, Dutchess County,481,77,77,0,0,17,0,0,0,0,464,77,77,0,0,1327,120,1207
360270704011,36, New York,027, Dutchess County,273,147,97,18,32,18,18,0,18,0,255,129,97,0,32,692,41,651
360270704012,36, New York,027, Dutchess County,593,196,132,21,43,0,0,0,0,0,593,196,132,21,43,1497,39,1458
360270801031,36, New York,027, Dutchess County,317,96,87,0,9,0,0,0,0,0,317,96,87,0,9,1060,45,1015
360270801032,36, New York,027, Dutchess County,573,308,282,7,19,27,0,0,0,0,546,308,282,7,19,1661,283,1378
360270801033,36, New York,027, Dutchess County,305,141,114,12,15,15,15,0,0,15,290,126,114,12,0,775,15,760
360270801041,36, New York,027, Dutchess County,447,249,228,0,21,0,0,0,0,0,447,249,228,0,21,1227,11,1216
360270801042,36, New York,027, Dutchess County,284,135,135,0,0,0,0,0,0,0,284,135,135,0,0,696,21,675
360270801043,36, New York,027, Dutchess County,440,199,152,10,37,49,49,49,0,0,391,150,103,10,37,1160,17,1143
360270802011,36, New York,027, Dutchess County,453,212,196,14,2,0,0,0,0,0,453,212,196,14,2,1199,14,1185
360270802012,36, New York,027, Dutchess County,188,77,60,17,0,0,0,0,0,0,188,77,60,17,0,586,42,544
360270802013,36, New York,027, Dutchess County,144,58,46,12,0,8,0,0,0,0,136,58,46,12,0,447,26,421
360270802014,36, New York,027, Dutchess County,382,182,131,22,29,0,0,0,0,0,382,182,131,22,29,1021,0,1021
360270802021,36, New York,027, Dutchess County,196,122,84,7,31,0,0,0,0,0,196,122,84,7,31,466,24,442
360270802022,36, New York,027, Dutchess County,335,113,68,0,45,17,0,0,0,0,318,113,68,0,45,838,41,797
360270802023,36, New York,027, Dutchess County,298,127,120,0,7,0,0,0,0,0,298,127,120,0,7,868,20,848
360270900001,36, New York,027, Dutchess County,263,107,43,15,49,32,32,0,0,32,231,75,43,15,17,817,102,715
360270900002,36, New York,027, Dutchess County,403,116,64,48,4,26,21,0,17,4,377,95,64,31,0,1172,68,1104
360271000001,36, New York,027, Dutchess County,374,83,54,0,29,6,6,0,0,6,368,77,54,0,23,883,37,846
360271000002,36, New York,027, Dutchess County,255,121,50,30,41,53,34,0,0,34,202,87,50,30,7,700,204,496
360271000003,36, New York,027, Dutchess County,201,59,33,18,8,0,0,0,0,0,201,59,33,18,8,527,25,502
360271100031,36, New York,027, Dutchess County,691,331,230,71,30,10,10,0,0,10,681,321,230,71,20,1744,68,1676
360271100032,36, New York,027, Dutchess County,152,38,38,0,0,0,0,0,0,0,152,38,38,0,0,540,24,516
360271100033,36, New York,027, Dutchess County,239,120,105,0,15,0,0,0,0,0,239,120,105,0,15,657,0,657
360271100041,36, New York,027, Dutchess County,192,90,49,6,35,0,0,0,0,0,192,90,49,6,35,469,11,458
360271100042,36, New York,027, Dutchess County,336,64,60,0,4,8,4,0,0,4,328,60,60,0,0,1082,51,1031
360271100051,36, New York,027, Dutchess County,336,177,123,6,48,19,19,0,6,13,317,158,123,0,35,800,32,768
360271100052,36, New York,027, Dutchess County,187,85,50,35,0,12,12,0,12,0,175,73,50,23,0,637,51,586
360271200001,36, New York,027, Dutchess County,333,118,77,0,41,19,19,0,0,19,314,99,77,0,22,962,130,832
360271200002,36, New York,027, Dutchess County,259,52,19,19,14,8,8,0,0,8,251,44,19,19,6,774,89,685
360271300031,36, New York,027, Dutchess County,336,117,73,0,44,0,0,0,0,0,336,117,73,0,44,833,34,799
360271300032,36, New York,027, Dutchess County,448,161,144,0,17,9,0,0,0,0,439,161,144,0,17,1455,138,1317
360271300033,36, New York,027, Dutchess County,675,269,190,24,55,11,11,0,0,11,664,258,190,24,44,1736,75,1661
360271300041,36, New York,027, Dutchess County,185,50,50,0,0,13,0,0,0,0,172,50,50,0,0,520,28,492
360271300042,36, New York,027, Dutchess County,337,154,136,5,13,14,4,0,0,4,323,150,136,5,9,882,55,827
360271300051,36, New York,027, Dutchess County,409,147,135,12,0,39,0,0,0,0,370,147,135,12,0,1208,85,1123
360271300052,36, New York,027, Dutchess County,306,117,74,14,29,11,11,0,0,11,295,106,74,14,18,984,109,875
360271401011,36, New York,027, Dutchess County,236,105,77,12,16,0,0,0,0,0,236,105,77,12,16,1203,467,736
360271401012,36, New York,027, Dutchess County,214,104,62,0,42,1,0,0,0,0,213,104,62,0,42,429,15,414
360271401013,36, New York,027, Dutchess County,310,159,137,0,22,25,0,0,0,0,285,159,137,0,22,948,234,714
360271401014,36, New York,027, Dutchess County,298,103,77,19,7,9,0,0,0,0,289,103,77,19,7,1316,243,1073
360271401015,36, New York,027, Dutchess County,0,0,0,0,0,0,0,0,0,0,0,0,0,0,0,0,0,0
360271402011,36, New York,027, Dutchess County,234,122,90,0,32,0,0,0,0,0,234,122,90,0,32,747,0,747
360271402012,36, New York,027, Dutchess County,358,168,154,14,0,0,0,0,0,0,358,168,154,14,0,1261,129,1132
360271402021,36, New York,027, Dutchess County,456,252,198,0,54,0,0,0,0,0,456,252,198,0,54,1484,7,1477
360271402022,36, New York,027, Dutchess County,280,196,159,37,0,0,0,0,0,0,280,196,159,37,0,1113,93,1020
360271402023,36, New York,027, Dutchess County,456,51,29,0,22,13,0,0,0,0,443,51,29,0,22,1064,47,1017
360271403011,36, New York,027, Dutchess County,263,120,98,0,22,22,22,0,0,22,241,98,98,0,0,480,38,442
360271403012,36, New York,027, Dutchess County,183,39,0,0,39,101,0,0,0,0,82,39,0,0,39,595,213,382
360271403013,36, New York,027, Dutchess County,416,137,0,27,110,0,0,0,0,0,416,137,0,27,110,1418,111,1307
360271403021,36, New York,027, Dutchess County,256,228,126,40,62,16,16,0,0,16,240,212,126,40,46,620,16,604
360271403022,36, New York,027, Dutchess County,183,45,45,0,0,0,0,0,0,0,183,45,45,0,0,699,81,618
360271403023,36, New York,027, Dutchess County,90,0,0,0,0,0,0,0,0,0,90,0,0,0,0,336,0,336
360271404001,36, New York,027, Dutchess County,506,175,157,0,18,0,0,0,0,0,506,175,157,0,18,1236,18,1218
360271404002,36, New York,027, Dutchess County,569,239,123,49,67,0,0,0,0,0,569,239,123,49,67,1676,61,1615
360271404003,36, New York,027, Dutchess County,517,219,158,35,26,18,18,0,0,18,499,201,158,35,8,1025,56,969
360271405001,36, New York,027, Dutchess County,253,100,81,0,19,19,19,0,0,19,234,81,81,0,0,1005,131,874
360271405002,36, New York,027, Dutchess County,222,170,158,0,12,0,0,0,0,0,222,170,158,0,12,448,15,433
360271405003,36, New York,027, Dutchess County,139,72,11,16,45,26,26,0,0,26,113,46,11,16,19,492,61,431
360271406021,36, New York,027, Dutchess County,399,272,229,36,7,15,0,0,0,0,384,272,229,36,7,1362,88,1274
360271406022,36, New York,027, Dutchess County,274,88,80,0,8,5,0,0,0,0,269,88,80,0,8,876,15,861
360271407001,36, New York,027, Dutchess County,445,263,252,11,0,0,0,0,0,0,445,263,252,11,0,1282,71,1211
360271407002,36, New York,027, Dutchess County,134,48,48,0,0,0,0,0,0,0,134,48,48,0,0,408,0,408
360271407003,36, New York,027, Dutchess County,475,154,154,0,0,38,0,0,0,0,437,154,154,0,0,1406,111,1295
360271407004,36, New York,027, Dutchess County,606,339,303,20,16,0,0,0,0,0,606,339,303,20,16,1454,0,1454
360271407005,36, New York,027, Dutchess County,315,139,79,0,60,0,0,0,0,0,315,139,79,0,60,748,15,733
360271408011,36, New York,027, Dutchess County,172,55,32,0,23,0,0,0,0,0,172,55,32,0,23,429,27,402
360271408012,36, New York,027, Dutchess County,392,154,135,0,19,0,0,0,0,0,392,154,135,0,19,1011,16,995
360271408013,36, New York,027, Dutchess County,224,71,41,0,30,30,30,0,0,30,194,41,41,0,0,597,85,512
360271500031,36, New York,027, Dutchess County,139,77,62,4,11,13,7,3,4,0,126,70,59,0,11,598,181,417
360271500032,36, New York,027, Dutchess County,91,32,28,4,0,0,0,0,0,0,91,32,28,4,0,183,0,183
360271500033,36, New York,027, Dutchess County,107,51,27,14,10,5,0,0,0,0,102,51,27,14,10,328,28,300
360271500041,36, New York,027, Dutchess County,191,127,103,0,24,4,0,0,0,0,187,127,103,0,24,559,31,528
360271500042,36, New York,027, Dutchess County,373,188,162,0,26,17,17,17,0,0,356,171,145,0,26,1031,51,980
360271500043,36, New York,027, Dutchess County,199,74,45,7,22,20,9,9,0,0,179,65,36,7,22,645,125,520
360271500051,36, New York,027, Dutchess County,246,100,79,0,21,0,0,0,0,0,246,100,79,0,21,798,0,798
360271500052,36, New York,027, Dutchess County,436,166,118,6,42,22,22,0,0,22,414,144,118,6,20,1055,82,973
360271500061,36, New York,027, Dutchess County,255,149,73,8,68,10,0,0,0,0,245,149,73,8,68,709,48,661
360271500062,36, New York,027, Dutchess County,143,48,32,7,9,3,0,0,0,0,140,48,32,7,9,657,62,595
360271600031,36, New York,027, Dutchess County,256,80,69,0,11,0,0,0,0,0,256,80,69,0,11,896,15,881
360271600032,36, New York,027, Dutchess County,144,17,17,0,0,9,0,0,0,0,135,17,17,0,0,585,159,426
360271600033,36, New York,027, Dutchess County,218,81,74,0,7,12,7,7,0,0,206,74,67,0,7,604,29,575
360271600041,36, New York,027, Dutchess County,283,20,20,0,0,15,7,7,0,0,268,13,13,0,0,820,60,760
360271600042,36, New York,027, Dutchess County,354,130,130,0,0,0,0,0,0,0,354,130,130,0,0,1116,123,993
360271600051,36, New York,027, Dutchess County,303,76,63,0,13,10,0,0,0,0,293,76,63,0,13,888,22,866
360271600052,36, New York,027, Dutchess County,158,41,0,29,12,0,0,0,0,0,158,41,0,29,12,656,23,633
360271600053,36, New York,027, Dutchess County,261,60,19,18,23,0,0,0,0,0,261,60,19,18,23,646,28,618
360271700001,36, New York,027, Dutchess County,243,74,55,0,19,19,19,0,0,19,224,55,55,0,0,594,31,563
360271700002,36, New York,027, Dutchess County,455,137,87,7,43,23,23,0,0,23,432,114,87,7,20,1155,63,1092
360271700003,36, New York,027, Dutchess County,167,30,16,14,0,26,14,0,14,0,141,16,16,0,0,452,82,370
360271700004,36, New York,027, Dutchess County,150,83,37,26,20,0,0,0,0,0,150,83,37,26,20,682,135,547
360271800011,36, New York,027, Dutchess County,278,67,32,0,35,31,14,14,0,0,247,53,18,0,35,1060,195,865
360271800012,36, New York,027, Dutchess County,247,60,60,0,0,54,13,13,0,0,193,47,47,0,0,731,100,631
360271800013,36, New York,027, Dutchess County,306,176,164,7,5,12,12,0,7,5,294,164,164,0,0,746,20,726
360271800014,36, New York,027, Dutchess County,308,242,205,37,0,11,11,11,0,0,297,231,194,37,0,776,34,742
360271901011,36, New York,027, Dutchess County,252,85,78,7,0,0,0,0,0,0,252,85,78,7,0,768,13,755
360271901012,36, New York,027, Dutchess County,351,118,118,0,0,0,0,0,0,0,351,118,118,0,0,867,0,867
360271901013,36, New York,027, Dutchess County,400,110,94,0,16,10,1,1,0,0,390,109,93,0,16,1029,73,956
360271901021,36, New York,027, Dutchess County,298,196,138,25,33,9,9,9,0,0,289,187,129,25,33,990,36,954
360271901022,36, New York,027, Dutchess County,219,51,46,0,5,12,12,7,0,5,207,39,39,0,0,606,29,577
360271902031,36, New York,027, Dutchess County,396,178,87,20,71,9,9,0,0,9,387,169,87,20,62,1124,79,1045
360271902032,36, New York,027, Dutchess County,230,106,84,0,22,0,0,0,0,0,230,106,84,0,22,769,18,751
360271902041,36, New York,027, Dutchess County,390,107,52,18,37,40,37,0,0,37,350,70,52,18,0,1554,91,1463
360271902042,36, New York,027, Dutchess County,330,173,130,0,43,0,0,0,0,0,330,173,130,0,43,786,9,777
360271902043,36, New York,027, Dutchess County,518,133,102,0,31,0,0,0,0,0,518,133,102,0,31,1213,33,1180
360271902044,36, New York,027, Dutchess County,336,127,100,0,27,30,22,8,0,14,306,105,92,0,13,822,76,746
360271903011,36, New York,027, Dutchess County,231,95,95,0,0,0,0,0,0,0,231,95,95,0,0,620,27,593
360271903012,36, New York,027, Dutchess County,151,58,48,0,10,36,24,24,0,0,115,34,24,0,10,735,51,684
360271903013,36, New York,027, Dutchess County,514,178,103,29,46,0,0,0,0,0,514,178,103,29,46,1402,64,1338
360271904011,36, New York,027, Dutchess County,442,126,110,0,16,5,0,0,0,0,437,126,110,0,16,1145,83,1062
360271904012,36, New York,027, Dutchess County,298,142,59,16,67,20,10,0,0,10,278,132,59,16,57,660,73,587
360271904021,36, New York,027, Dutchess County,355,174,110,22,42,0,0,0,0,0,355,174,110,22,42,1404,77,1327
360271904022,36, New York,027, Dutchess County,352,129,121,0,8,0,0,0,0,0,352,129,121,0,8,1144,25,1119
360272000011,36, New York,027, Dutchess County,232,69,69,0,0,0,0,0,0,0,232,69,69,0,0,685,45,640
360272000012,36, New York,027, Dutchess County,133,31,31,0,0,5,0,0,0,0,128,31,31,0,0,555,14,541
360272000013,36, New York,027, Dutchess County,429,171,91,6,74,15,15,0,0,15,414,156,91,6,59,1275,147,1128
360272000021,36, New York,027, Dutchess County,337,74,56,4,14,13,1,1,0,0,324,73,55,4,14,1221,162,1059
360272101011,36, New York,027, Dutchess County,320,204,130,0,74,74,74,0,0,74,246,130,130,0,0,1042,165,877
360272101012,36, New York,027, Dutchess County,94,31,0,0,31,0,0,0,0,0,94,31,0,0,31,443,117,326
360272101013,36, New York,027, Dutchess County,553,326,177,108,41,0,0,0,0,0,553,326,177,108,41,1388,0,1388
360272101014,36, New York,027, Dutchess County,194,66,30,0,36,36,36,0,0,36,158,30,30,0,0,477,129,348
360272101015,36, New York,027, Dutchess County,154,55,0,0,55,28,0,0,0,0,126,55,0,0,55,326,49,277
360272102011,36, New York,027, Dutchess County,209,132,89,0,43,15,15,15,0,0,194,117,74,0,43,610,41,569
360272102012,36, New York,027, Dutchess County,125,55,38,8,9,0,0,0,0,0,125,55,38,8,9,693,66,627
360272102013,36, New York,027, Dutchess County,274,163,77,13,73,50,50,0,0,50,224,113,77,13,23,691,38,653
360272102014,36, New York,027, Dutchess County,307,144,135,0,9,0,0,0,0,0,307,144,135,0,9,737,54,683
360272102015,36, New York,027, Dutchess County,105,26,26,0,0,0,0,0,0,0,105,26,26,0,0,375,26,349
360272103011,36, New York,027, Dutchess County,357,141,71,27,43,0,0,0,0,0,357,141,71,27,43,1227,25,1202
360272103012,36, New York,027, Dutchess County,157,45,22,9,14,0,0,0,0,0,157,45,22,9,14,499,22,477
360272103013,36, New York,027, Dutchess County,469,244,203,41,0,16,0,0,0,0,453,244,203,41,0,1294,53,1241
360272103014,36, New York,027, Dutchess County,198,104,104,0,0,0,0,0,0,0,198,104,104,0,0,468,1,467
360272201011,36, New York,027, Dutchess County,160,49,0,0,49,0,0,0,0,0,160,49,0,0,49,802,179,623
360272201012,36, New York,027, Dutchess County,235,125,102,23,0,72,28,28,0,0,163,97,74,23,0,493,93,400
360272201013,36, New York,027, Dutchess County,94,77,0,0,77,0,0,0,0,0,94,77,0,0,77,749,206,543
360272201014,36, New York,027, Dutchess County,127,47,5,0,42,5,5,5,0,0,122,42,0,0,42,730,95,635
360272201021,36, New York,027, Dutchess County,186,112,0,0,112,131,112,0,0,112,55,0,0,0,0,697,282,415
360272201022,36, New York,027, Dutchess County,42,0,0,0,0,0,0,0,0,0,42,0,0,0,0,85,0,85
360272202011,36, New York,027, Dutchess County,75,67,67,0,0,17,17,17,0,0,58,50,50,0,0,297,151,146
360272202012,36, New York,027, Dutchess County,223,116,0,16,100,57,0,0,0,0,166,116,0,16,100,604,108,496
360272202013,36, New York,027, Dutchess County,384,319,202,30,87,42,30,0,0,30,342,289,202,30,57,957,180,777
360272202014,36, New York,027, Dutchess County,226,166,117,49,0,6,0,0,0,0,220,166,117,49,0,586,85,501
360272203001,36, New York,027, Dutchess County,409,338,37,19,282,178,178,0,0,178,231,160,37,19,104,849,219,630
360272203002,36, New York,027, Dutchess County,295,163,12,0,151,126,126,0,0,126,169,37,12,0,25,681,266,415
360272203003,36, New York,027, Dutchess County,296,210,29,0,181,44,44,0,0,44,252,166,29,0,137,631,115,516
360272203004,36, New York,027, Dutchess County,65,13,13,0,0,0,0,0,0,0,65,13,13,0,0,450,76,374
360272207001,36, New York,027, Dutchess County,118,43,0,0,43,3,0,0,0,0,115,43,0,0,43,569,87,482
360272207002,36, New York,027, Dutchess County,128,113,79,0,34,0,0,0,0,0,128,113,79,0,34,719,89,630
360272207003,36, New York,027, Dutchess County,97,34,0,0,34,0,0,0,0,0,97,34,0,0,34,816,73,743
360272208011,36, New York,027, Dutchess County,184,32,32,0,0,0,0,0,0,0,184,32,32,0,0,733,3,730
360272208012,36, New York,027, Dutchess County,97,90,0,0,90,16,16,0,0,16,81,74,0,0,74,316,193,123
360272208013,36, New York,027, Dutchess County,168,76,46,0,30,0,0,0,0,0,168,76,46,0,30,545,0,545
360272208014,36, New York,027, Dutchess County,157,84,0,0,84,89,84,0,0,84,68,0,0,0,0,512,124,388
360272208015,36, New York,027, Dutchess County,120,49,49,0,0,0,0,0,0,0,120,49,49,0,0,654,63,591
360272209011,36, New York,027, Dutchess County,184,115,35,0,80,0,0,0,0,0,184,115,35,0,80,774,31,743
360272209012,36, New York,027, Dutchess County,146,0,0,0,0,0,0,0,0,0,146,0,0,0,0,524,89,435
360272209013,36, New York,027, Dutchess County,170,46,14,0,32,103,32,0,0,32,67,14,14,0,0,763,384,379
360272209014,36, New York,027, Dutchess County,439,203,137,13,53,48,38,17,13,8,391,165,120,0,45,1248,107,1141
360272210011,36, New York,027, Dutchess County,159,58,42,10,6,10,0,0,0,0,149,58,42,10,6,713,72,641
360272210012,36, New York,027, Dutchess County,297,149,124,11,14,0,0,0,0,0,297,149,124,11,14,1018,56,962
360272210013,36, New York,027, Dutchess County,320,102,35,0,67,0,0,0,0,0,320,102,35,0,67,1011,20,991
360272210014,36, New York,027, Dutchess County,195,25,0,14,11,0,0,0,0,0,195,25,0,14,11,573,30,543
360272211001,36, New York,027, Dutchess County,262,162,0,70,92,3,3,0,0,3,259,159,0,70,89,664,30,634
360272211002,36, New York,027, Dutchess County,277,156,43,0,113,89,71,0,0,71,188,85,43,0,42,685,169,516
360272211003,36, New York,027, Dutchess County,299,257,192,0,65,0,0,0,0,0,299,257,192,0,65,721,49,672
360272211004,36, New York,027, Dutchess County,76,32,0,0,32,19,0,0,0,0,57,32,0,0,32,401,145,256
360273000001,36, New York,027, Dutchess County,128,44,23,0,21,0,0,0,0,0,128,44,23,0,21,515,6,509
360273000002,36, New York,027, Dutchess County,96,9,9,0,0,0,0,0,0,0,96,9,9,0,0,606,85,521
360273000003,36, New York,027, Dutchess County,314,129,129,0,0,0,0,0,0,0,314,129,129,0,0,1037,36,1001
360273000004,36, New York,027, Dutchess County,453,262,173,0,89,54,0,0,0,0,399,262,173,0,89,1230,132,1098
360273000005,36, New York,027, Dutchess County,290,96,37,0,59,4,0,0,0,0,286,96,37,0,59,1229,78,1151
360274100001,36, New York,027, Dutchess County,51,41,36,0,5,0,0,0,0,0,51,41,36,0,5,285,150,135
360274100002,36, New York,027, Dutchess County,285,77,42,25,10,0,0,0,0,0,285,77,42,25,10,703,14,689
360274100003,36, New York,027, Dutchess County,179,39,31,0,8,15,15,15,0,0,164,24,16,0,8,577,56,521
360276100001,36, New York,027, Dutchess County,40,40,40,0,0,0,0,0,0,0,40,40,40,0,0,49,0,49
360276400011,36, New York,027, Dutchess County,0,0,0,0,0,0,0,0,0,0,0,0,0,0,0,0,0,0
360276400021,36, New York,027, Dutchess County,0,0,0,0,0,0,0,0,0,0,0,0,0,0,0,29,23,6
360179701011,36, New York,017, Chenango County,114,60,38,2,20,10,10,10,0,0,104,50,28,2,20,309,21,288
360179701012,36, New York,017, Chenango County,423,139,104,26,9,22,6,0,0,6,401,133,104,26,3,1136,60,1076
360179701013,36, New York,017, Chenango County,224,84,50,5,29,12,9,0,1,8,212,75,50,4,21,648,34,614
360179701021,36, New York,017, Chenango County,344,169,116,12,41,46,14,0,0,14,298,155,116,12,27,910,129,781
360179701022,36, New York,017, Chenango County,522,283,206,6,71,5,3,0,0,3,517,280,206,6,68,1301,25,1276
360179702011,36, New York,017, Chenango County,226,73,32,12,29,7,5,0,0,5,219,68,32,12,24,644,44,600
360179702012,36, New York,017, Chenango County,215,70,48,2,20,20,18,7,0,11,195,52,41,2,9,611,64,547
360179702013,36, New York,017, Chenango County,134,35,26,5,4,8,4,2,0,2,126,31,24,5,2,354,35,319
360179702021,36, New York,017, Chenango County,189,76,45,11,20,12,4,0,3,1,177,72,45,8,19,532,51,481
360179702022,36, New York,017, Chenango County,217,89,61,19,9,16,16,12,2,2,201,73,49,17,7,683,73,610
360179702023,36, New York,017, Chenango County,148,43,18,4,21,17,10,0,0,10,131,33,18,4,11,379,40,339
360179703001,36, New York,017, Chenango County,155,76,52,13,11,0,0,0,0,0,155,76,52,13,11,479,25,454
360179703002,36, New York,017, Chenango County,120,46,12,0,34,13,0,0,0,0,107,46,12,0,34,439,160,279
360179703003,36, New York,017, Chenango County,286,125,105,0,20,0,0,0,0,0,286,125,105,0,20,741,22,719
360179703004,36, New York,017, Chenango County,137,79,49,21,9,0,0,0,0,0,137,79,49,21,9,425,18,407
360179703005,36, New York,017, Chenango County,265,171,68,49,54,61,54,0,0,54,204,117,68,49,0,737,91,646
360179704001,36, New York,017, Chenango County,51,0,0,0,0,0,0,0,0,0,51,0,0,0,0,293,125,168
360179704002,36, New York,017, Chenango County,302,69,57,0,12,51,26,26,0,0,251,43,31,0,12,824,154,670
360179704003,36, New York,017, Chenango County,211,136,121,0,15,59,53,47,0,6,152,83,74,0,9,719,154,565
360179704004,36, New York,017, Chenango County,160,26,7,19,0,32,19,0,19,0,128,7,7,0,0,551,142,409
360179705011,36, New York,017, Chenango County,346,143,73,61,9,37,16,5,11,0,309,127,68,50,9,827,116,711
360179705012,36, New York,017, Chenango County,204,95,49,25,21,50,30,8,22,0,154,65,41,3,21,489,102,387
360179705013,36, New York,017, Chenango County,60,30,9,21,0,0,0,0,0,0,60,30,9,21,0,295,35,260
360179705021,36, New York,017, Chenango County,363,112,112,0,0,0,0,0,0,0,363,112,112,0,0,965,23,942
360179705022,36, New York,017, Chenango County,350,93,44,5,44,17,0,0,0,0,333,93,44,5,44,985,78,907
360179705023,36, New York,017, Chenango County,226,82,31,37,14,18,18,4,0,14,208,64,27,37,0,543,101,442
360179706011,36, New York,017, Chenango County,207,68,27,11,30,0,0,0,0,0,207,68,27,11,30,580,17,563
360179706012,36, New York,017, Chenango County,186,98,98,0,0,0,0,0,0,0,186,98,98,0,0,709,92,617
360179706013,36, New York,017, Chenango County,366,183,123,26,34,34,22,0,18,4,332,161,123,8,30,982,134,848
360179706014,36, New York,017, Chenango County,249,112,95,0,17,8,8,0,0,8,241,104,95,0,9,667,22,645
360179706021,36, New York,017, Chenango County,334,165,51,23,91,69,61,12,0,49,265,104,39,23,42,854,154,700
360179706022,36, New York,017, Chenango County,227,97,69,14,14,24,21,17,0,4,203,76,52,14,10,671,125,546
360179706023,36, New York,017, Chenango County,162,39,28,11,0,9,0,0,0,0,153,39,28,11,0,570,62,508
360179706024,36, New York,017, Chenango County,218,136,126,0,10,0,0,0,0,0,218,136,126,0,10,804,80,724
360179707001,36, New York,017, Chenango County,170,72,43,4,25,4,1,0,0,1,166,71,43,4,24,467,39,428
360179707002,36, New York,017, Chenango County,222,44,22,7,15,10,8,3,0,5,212,36,19,7,10,624,120,504
360179707003,36, New York,017, Chenango County,283,136,47,53,36,85,65,0,37,28,198,71,47,16,8,776,136,640
360179708011,36, New York,017, Chenango County,145,73,41,10,22,24,24,0,10,14,121,49,41,0,8,456,41,415
360179708012,36, New York,017, Chenango County,313,137,60,33,44,13,13,0,2,11,300,124,60,31,33,1011,99,912
360179708013,36, New York,017, Chenango County,163,45,36,5,4,4,4,0,0,4,159,41,36,5,0,477,52,425
360179708014,36, New York,017, Chenango County,278,47,28,19,0,0,0,0,0,0,278,47,28,19,0,893,147,746
360179708021,36, New York,017, Chenango County,291,144,124,0,20,3,3,0,0,3,288,141,124,0,17,740,12,728
360179708022,36, New York,017, Chenango County,280,93,73,11,9,18,15,6,0,9,262,78,67,11,0,842,111,731
360179708023,36, New York,017, Chenango County,179,92,65,10,17,25,13,0,6,7,154,79,65,4,10,441,51,390
360179708024,36, New York,017, Chenango County,210,73,43,3,27,10,4,0,0,4,200,69,43,3,23,611,70,541
360179709011,36, New York,017, Chenango County,235,94,22,15,57,4,0,0,0,0,231,94,22,15,57,626,75,551
360179709012,36, New York,017, Chenango County,399,139,64,29,46,37,37,0,4,33,362,102,64,25,13,1422,136,1286
360179709021,36, New York,017, Chenango County,272,150,75,25,50,55,44,4,0,40,217,106,71,25,10,947,100,847
360179709022,36, New York,017, Chenango County,334,113,51,34,28,18,12,3,3,6,316,101,48,31,22,950,75,875
360179710001,36, New York,017, Chenango County,242,103,45,41,17,8,4,4,0,0,234,99,41,41,17,573,40,533
360179710002,36, New York,017, Chenango County,300,148,65,16,67,32,25,0,14,11,268,123,65,2,56,917,97,820
360179710003,36, New York,017, Chenango County,380,202,142,20,40,21,21,0,0,21,359,181,142,20,19,1066,91,975
361090001001,36, New York,109, Tompkins County,85,30,15,0,15,0,0,0,0,0,85,30,15,0,15,753,119,634
361090001002,36, New York,109, Tompkins County,60,7,0,0,7,7,7,0,0,7,53,0,0,0,0,553,80,473
361090002011,36, New York,109, Tompkins County,28,0,0,0,0,28,0,0,0,0,0,0,0,0,0,1645,1051,594
361090002012,36, New York,109, Tompkins County,0,0,0,0,0,0,0,0,0,0,0,0,0,0,0,750,492,258
361090002021,36, New York,109, Tompkins County,36,0,0,0,0,0,0,0,0,0,36,0,0,0,0,1015,704,311
361090002022,36, New York,109, Tompkins County,60,0,0,0,0,0,0,0,0,0,60,0,0,0,0,423,223,200
361090003001,36, New York,109, Tompkins County,68,5,5,0,0,6,0,0,0,0,62,5,5,0,0,246,107,139
361090004001,36, New York,109, Tompkins County,170,118,84,0,34,5,5,5,0,0,165,113,79,0,34,238,27,211
361090005001,36, New York,109, Tompkins County,422,182,156,15,11,25,25,0,15,10,397,157,156,0,1,818,49,769
361090005002,36, New York,109, Tompkins County,273,104,104,0,0,7,0,0,0,0,266,104,104,0,0,892,18,874
361090005003,36, New York,109, Tompkins County,395,162,155,7,0,18,0,0,0,0,377,162,155,7,0,989,50,939
361090006001,36, New York,109, Tompkins County,394,64,64,0,0,0,0,0,0,0,394,64,64,0,0,1050,70,980
361090006002,36, New York,109, Tompkins County,277,71,64,0,7,10,10,10,0,0,267,61,54,0,7,586,57,529
361090006003,36, New York,109, Tompkins County,59,41,41,0,0,0,0,0,0,0,59,41,41,0,0,457,292,165
361090006004,36, New York,109, Tompkins County,279,165,165,0,0,0,0,0,0,0,279,165,165,0,0,844,62,782
361090007001,36, New York,109, Tompkins County,109,32,0,32,0,18,18,0,18,0,91,14,0,14,0,978,620,358
361090007002,36, New York,109, Tompkins County,398,179,88,91,0,0,0,0,0,0,398,179,88,91,0,1173,118,1055
361090007003,36, New York,109, Tompkins County,282,124,77,0,47,12,12,0,0,12,270,112,77,0,35,925,76,849
361090008001,36, New York,109, Tompkins County,131,81,22,0,59,9,9,0,0,9,122,72,22,0,50,832,117,715
361090008002,36, New York,109, Tompkins County,339,91,31,0,60,14,14,0,0,14,325,77,31,0,46,1161,183,978
361090009001,36, New York,109, Tompkins County,449,223,78,15,130,30,30,0,0,30,419,193,78,15,100,1167,159,1008
361090009002,36, New York,109, Tompkins County,677,301,261,0,40,25,10,0,0,10,652,291,261,0,30,1655,127,1528
361090009003,36, New York,109, Tompkins County,174,30,11,0,19,7,0,0,0,0,167,30,11,0,19,545,37,508
361090010001,36, New York,109, Tompkins County,253,86,39,0,47,47,47,0,0,47,206,39,39,0,0,873,90,783
361090010002,36, New York,109, Tompkins County,289,149,142,0,7,0,0,0,0,0,289,149,142,0,7,1074,37,1037
361090010003,36, New York,109, Tompkins County,366,240,182,0,58,58,58,0,0,58,308,182,182,0,0,1573,386,1187
361090011001,36, New York,109, Tompkins County,261,97,97,0,0,0,0,0,0,0,261,97,97,0,0,2272,1032,1240
361090011002,36, New York,109, Tompkins County,518,154,154,0,0,8,0,0,0,0,510,154,154,0,0,1999,479,1520
361090012001,36, New York,109, Tompkins County,23,9,0,9,0,0,0,0,0,0,23,9,0,9,0,76,12,64
361090013011,36, New York,109, Tompkins County,101,66,51,15,0,0,0,0,0,0,101,66,51,15,0,919,377,542
361090013012,36, New York,109, Tompkins County,536,209,209,0,0,0,0,0,0,0,536,209,209,0,0,1307,214,1093
361090013021,36, New York,109, Tompkins County,401,65,49,0,16,16,0,0,0,0,385,65,49,0,16,1285,203,1082
361090013022,36, New York,109, Tompkins County,196,136,0,0,136,0,0,0,0,0,196,136,0,0,136,432,31,401
361090013023,36, New York,109, Tompkins County,309,157,51,26,80,0,0,0,0,0,309,157,51,26,80,668,79,589
361090014001,36, New York,109, Tompkins County,223,97,75,0,22,27,8,0,0,8,196,89,75,0,14,746,191,555
361090014002,36, New York,109, Tompkins County,253,40,7,33,0,0,0,0,0,0,253,40,7,33,0,1025,126,899
361090014003,36, New York,109, Tompkins County,422,161,95,43,23,14,0,0,0,0,408,161,95,43,23,966,68,898
361090015001,36, New York,109, Tompkins County,547,177,100,8,69,59,59,0,4,55,488,118,100,4,14,1618,320,1298
361090015002,36, New York,109, Tompkins County,503,174,133,25,16,0,0,0,0,0,503,174,133,25,16,1986,121,1865
361090015003,36, New York,109, Tompkins County,324,136,111,0,25,0,0,0,0,0,324,136,111,0,25,837,1,836
361090016001,36, New York,109, Tompkins County,490,94,47,1,46,4,4,0,0,4,486,90,47,1,42,1284,15,1269
361090016002,36, New York,109, Tompkins County,408,173,116,9,48,0,0,0,0,0,408,173,116,9,48,1084,41,1043
361090016003,36, New York,109, Tompkins County,514,115,85,0,30,12,7,7,0,0,502,108,78,0,30,1406,148,1258
361090017001,36, New York,109, Tompkins County,288,118,63,24,31,41,41,0,24,17,247,77,63,0,14,880,103,777
361090017002,36, New York,109, Tompkins County,343,84,34,21,29,11,11,11,0,0,332,73,23,21,29,1041,132,909
361090017003,36, New York,109, Tompkins County,302,195,108,18,69,23,9,9,0,0,279,186,99,18,69,779,46,733
361090018001,36, New York,109, Tompkins County,672,225,115,48,62,34,34,0,0,34,638,191,115,48,28,1427,100,1327
361090018002,36, New York,109, Tompkins County,530,266,95,16,155,18,0,0,0,0,512,266,95,16,155,1421,129,1292
361090018003,36, New York,109, Tompkins County,334,73,15,0,58,14,14,0,0,14,320,59,15,0,44,997,86,911
361090019011,36, New York,109, Tompkins County,364,106,86,0,20,0,0,0,0,0,364,106,86,0,20,1032,30,1002
361090019012,36, New York,109, Tompkins County,444,273,132,94,47,14,0,0,0,0,430,273,132,94,47,1276,52,1224
361090019021,36, New York,109, Tompkins County,324,119,64,20,35,23,23,0,0,23,301,96,64,20,12,950,43,907
361090019022,36, New York,109, Tompkins County,573,288,212,0,76,16,0,0,0,0,557,288,212,0,76,1527,95,1432
361090020001,36, New York,109, Tompkins County,364,137,40,9,88,93,86,6,0,80,271,51,34,9,8,998,219,779
361090020002,36, New York,109, Tompkins County,431,197,137,32,28,23,23,11,0,12,408,174,126,32,16,1052,88,964
361090020003,36, New York,109, Tompkins County,331,115,68,26,21,25,14,0,0,14,306,101,68,26,7,888,134,754
361090021001,36, New York,109, Tompkins County,458,175,104,56,15,44,44,29,0,15,414,131,75,56,0,1194,134,1060
361090021002,36, New York,109, Tompkins County,353,128,100,0,28,1,0,0,0,0,352,128,100,0,28,940,38,902
361090021003,36, New York,109, Tompkins County,412,178,99,0,79,39,39,8,0,31,373,139,91,0,48,1597,208,1389
361090022001,36, New York,109, Tompkins County,459,289,242,13,34,26,17,11,6,0,433,272,231,7,34,1213,73,1140
361090022002,36, New York,109, Tompkins County,303,190,120,25,45,11,11,7,0,4,292,179,113,25,41,838,71,767
361090022003,36, New York,109, Tompkins County,397,158,129,7,22,5,0,0,0,0,392,158,129,7,22,1160,87,1073
361090023001,36, New York,109, Tompkins County,785,393,230,35,128,51,51,39,12,0,734,342,191,23,128,1995,295,1700
361090023002,36, New York,109, Tompkins County,539,212,50,0,162,57,41,0,0,41,482,171,50,0,121,1093,88,1005
361090023003,36, New York,109, Tompkins County,398,181,158,0,23,1,1,1,0,0,397,180,157,0,23,1140,83,1057
360550002001,36, New York,055, Monroe County,118,81,11,0,70,41,41,0,0,41,77,40,11,0,29,355,152,203
360550002002,36, New York,055, Monroe County,68,51,2,0,49,2,2,2,0,0,66,49,0,0,49,393,107,286
360550002003,36, New York,055, Monroe County,241,183,41,0,142,64,27,27,0,0,177,156,14,0,142,875,296,579
360550007001,36, New York,055, Monroe County,188,139,0,11,128,67,67,0,0,67,121,72,0,11,61,535,149,386
360550007002,36, New York,055, Monroe County,205,113,20,27,66,82,65,0,27,38,123,48,20,0,28,790,228,562
360550010001,36, New York,055, Monroe County,142,39,21,0,18,65,18,0,0,18,77,21,21,0,0,1251,233,1018
360550010002,36, New York,055, Monroe County,57,0,0,0,0,19,0,0,0,0,38,0,0,0,0,903,233,670
360550010003,36, New York,055, Monroe County,140,95,15,8,72,72,72,0,0,72,68,23,15,8,0,637,173,464
360550013001,36, New York,055, Monroe County,312,244,61,0,183,139,132,0,0,132,173,112,61,0,51,956,283,673
360550016001,36, New York,055, Monroe County,210,101,15,5,81,65,49,0,5,44,145,52,15,0,37,580,131,449
360550016002,36, New York,055, Monroe County,307,175,21,20,134,161,137,12,0,125,146,38,9,20,9,761,282,479
360550016003,36, New York,055, Monroe County,182,135,50,0,85,84,84,11,0,73,98,51,39,0,12,532,211,321
360550018001,36, New York,055, Monroe County,227,100,0,0,100,26,26,0,0,26,201,74,0,0,74,853,57,796
360550018002,36, New York,055, Monroe County,162,109,0,0,109,32,32,0,0,32,130,77,0,0,77,319,112,207
360550018003,36, New York,055, Monroe County,281,90,0,32,58,58,58,0,0,58,223,32,0,32,0,1024,146,878
360550018004,36, New York,055, Monroe County,163,72,0,0,72,0,0,0,0,0,163,72,0,0,72,518,128,390
360550018005,36, New York,055, Monroe County,470,297,13,0,284,97,57,5,0,52,373,240,8,0,232,955,225,730
360550018006,36, New York,055, Monroe County,0,0,0,0,0,0,0,0,0,0,0,0,0,0,0,0,0,0
360550019001,36, New York,055, Monroe County,265,81,38,15,28,41,14,0,0,14,224,67,38,15,14,807,155,652
360550019002,36, New York,055, Monroe County,89,18,18,0,0,15,15,15,0,0,74,3,3,0,0,522,253,269
360550019003,36, New York,055, Monroe County,241,183,0,27,156,131,80,0,0,80,110,103,0,27,76,718,269,449
360550020001,36, New York,055, Monroe County,353,261,43,13,205,58,58,15,13,30,295,203,28,0,175,871,91,780
360550020002,36, New York,055, Monroe County,284,98,27,0,71,31,20,0,0,20,253,78,27,0,51,1005,83,922
360550020003,36, New York,055, Monroe County,180,142,11,0,131,91,86,0,0,86,89,56,11,0,45,575,200,375
360550020004,36, New York,055, Monroe County,384,278,225,36,17,19,19,19,0,0,365,259,206,36,17,902,155,747
360550021001,36, New York,055, Monroe County,340,181,68,0,113,77,25,0,0,25,263,156,68,0,88,914,260,654
360550021002,36, New York,055, Monroe County,265,227,26,14,187,57,57,0,0,57,208,170,26,14,130,461,125,336
360550021003,36, New York,055, Monroe County,173,160,12,63,85,73,73,0,11,62,100,87,12,52,23,395,177,218
360550021004,36, New York,055, Monroe County,191,113,33,3,77,36,36,33,3,0,155,77,0,0,77,730,40,690
360550022001,36, New York,055, Monroe County,124,32,0,0,32,27,18,0,0,18,97,14,0,0,14,628,107,521
360550022002,36, New York,055, Monroe County,218,170,124,0,46,19,6,0,0,6,199,164,124,0,40,546,109,437
360550022003,36, New York,055, Monroe County,214,128,35,0,93,57,12,0,0,12,157,116,35,0,81,461,197,264
360550022004,36, New York,055, Monroe County,413,363,15,53,295,258,235,0,0,235,155,128,15,53,60,229,48,181
360550023001,36, New York,055, Monroe County,141,50,35,0,15,58,30,15,0,15,83,20,20,0,0,905,410,495
360550023002,36, New York,055, Monroe County,229,195,24,51,120,117,108,0,51,57,112,87,24,0,63,810,307,503
360550023003,36, New York,055, Monroe County,100,87,0,49,38,24,24,0,0,24,76,63,0,49,14,222,94,128
360550023004,36, New York,055, Monroe County,270,224,26,0,198,202,170,26,0,144,68,54,0,0,54,711,398,313
360550024001,36, New York,055, Monroe County,219,170,8,36,126,38,30,0,0,30,181,140,8,36,96,524,178,346
360550024002,36, New York,055, Monroe County,197,197,48,22,127,78,78,21,0,57,119,119,27,22,70,687,294,393
360550024003,36, New York,055, Monroe County,135,135,0,0,135,47,47,0,0,47,88,88,0,0,88,617,429,188
360550024004,36, New York,055, Monroe County,70,13,0,0,13,14,0,0,0,0,56,13,0,0,13,302,141,161
360550027001,36, New York,055, Monroe County,154,68,12,0,56,48,42,12,0,30,106,26,0,0,26,471,111,360
360550027002,36, New York,055, Monroe County,95,43,0,22,21,43,43,0,22,21,52,0,0,0,0,488,85,403
360550029001,36, New York,055, Monroe County,159,30,0,30,0,0,0,0,0,0,159,30,0,30,0,874,161,713
360550029002,36, New York,055, Monroe County,89,0,0,0,0,0,0,0,0,0,89,0,0,0,0,604,85,519
360550029003,36, New York,055, Monroe County,199,72,0,0,72,44,0,0,0,0,155,72,0,0,72,1979,362,1617
360550030001,36, New York,055, Monroe County,117,41,0,0,41,16,16,0,0,16,101,25,0,0,25,582,141,441
360550030002,36, New York,055, Monroe County,237,109,6,61,42,28,28,6,0,22,209,81,0,61,20,1195,205,990
360550031011,36, New York,055, Monroe County,236,11,11,0,0,0,0,0,0,0,236,11,11,0,0,1024,19,1005
360550031012,36, New York,055, Monroe County,221,44,44,0,0,33,0,0,0,0,188,44,44,0,0,1323,168,1155
360550031021,36, New York,055, Monroe County,206,40,25,0,15,20,0,0,0,0,186,40,25,0,15,1975,376,1599
360550032001,36, New York,055, Monroe County,137,31,15,6,10,0,0,0,0,0,137,31,15,6,10,938,271,667
360550032002,36, New York,055, Monroe County,143,110,35,57,18,61,61,0,43,18,82,49,35,14,0,657,270,387
360550033001,36, New York,055, Monroe County,137,57,15,3,39,9,9,9,0,0,128,48,6,3,39,674,24,650
360550033002,36, New York,055, Monroe County,25,16,7,0,9,9,9,0,0,9,16,7,7,0,0,686,497,189
360550034001,36, New York,055, Monroe County,330,35,0,7,28,0,0,0,0,0,330,35,0,7,28,1245,167,1078
360550034002,36, New York,055, Monroe County,203,45,11,12,22,25,14,0,4,10,178,31,11,8,12,967,231,736
360550035001,36, New York,055, Monroe County,118,47,47,0,0,0,0,0,0,0,118,47,47,0,0,286,0,286
360550035002,36, New York,055, Monroe County,152,50,43,0,7,0,0,0,0,0,152,50,43,0,7,586,43,543
360550036001,36, New York,055, Monroe County,310,205,120,0,85,0,0,0,0,0,310,205,120,0,85,1409,143,1266
360550036002,36, New York,055, Monroe County,292,101,88,13,0,0,0,0,0,0,292,101,88,13,0,1175,46,1129
360550037001,36, New York,055, Monroe County,274,8,0,0,8,16,0,0,0,0,258,8,0,0,8,1042,79,963
360550037002,36, New York,055, Monroe County,290,123,95,0,28,15,15,7,0,8,275,108,88,0,20,1317,71,1246
360550038061,36, New York,055, Monroe County,0,0,0,0,0,0,0,0,0,0,0,0,0,0,0,64,31,33
360550038062,36, New York,055, Monroe County,296,172,0,0,172,124,90,0,0,90,172,82,0,0,82,1082,489,593
360550038063,36, New York,055, Monroe County,0,0,0,0,0,0,0,0,0,0,0,0,0,0,0,179,144,35
360550038064,36, New York,055, Monroe County,197,67,67,0,0,71,0,0,0,0,126,67,67,0,0,826,265,561
360550038065,36, New York,055, Monroe County,33,0,0,0,0,0,0,0,0,0,33,0,0,0,0,259,123,136
360550038066,36, New York,055, Monroe County,24,0,0,0,0,10,0,0,0,0,14,0,0,0,0,0,0,0
360550038071,36, New York,055, Monroe County,185,39,39,0,0,18,0,0,0,0,167,39,39,0,0,1256,197,1059
360550038072,36, New York,055, Monroe County,0,0,0,0,0,0,0,0,0,0,0,0,0,0,0,0,0,0
360550038073,36, New York,055, Monroe County,0,0,0,0,0,0,0,0,0,0,0,0,0,0,0,0,0,0
360550039001,36, New York,055, Monroe County,174,71,12,0,59,72,30,0,0,30,102,41,12,0,29,523,251,272
360550039002,36, New York,055, Monroe County,247,109,23,38,48,35,35,0,0,35,212,74,23,38,13,810,114,696
360550040001,36, New York,055, Monroe County,151,115,0,29,86,70,70,0,29,41,81,45,0,0,45,380,169,211
360550040002,36, New York,055, Monroe County,243,154,56,19,79,68,58,0,0,58,175,96,56,19,21,597,206,391
360550041001,36, New York,055, Monroe County,230,177,48,18,111,70,59,0,0,59,160,118,48,18,52,483,142,341
360550041002,36, New York,055, Monroe County,172,164,33,14,117,71,71,33,0,38,101,93,0,14,79,300,118,182
360550046021,36, New York,055, Monroe County,92,71,18,0,53,0,0,0,0,0,92,71,18,0,53,324,61,263
360550046022,36, New York,055, Monroe County,60,19,0,0,19,19,19,0,0,19,41,0,0,0,0,691,163,528
360550046023,36, New York,055, Monroe County,200,100,14,16,70,75,33,0,0,33,125,67,14,16,37,459,227,232
360550047011,36, New York,055, Monroe County,211,113,43,45,25,45,45,0,38,7,166,68,43,7,18,666,60,606
360550047012,36, New York,055, Monroe County,29,12,12,0,0,0,0,0,0,0,29,12,12,0,0,245,146,99
360550047013,36, New York,055, Monroe County,256,146,68,35,43,117,82,18,35,29,139,64,50,0,14,1256,718,538
360550047021,36, New York,055, Monroe County,146,54,25,0,29,0,0,0,0,0,146,54,25,0,29,637,88,549
360550047022,36, New York,055, Monroe County,324,186,62,14,110,47,47,21,0,26,277,139,41,14,84,691,126,565
360550047023,36, New York,055, Monroe County,166,118,0,25,93,41,41,0,7,34,125,77,0,18,59,332,112,220
360550048001,36, New York,055, Monroe County,301,216,105,0,111,117,92,68,0,24,184,124,37,0,87,647,267,380
360550048002,36, New York,055, Monroe County,141,90,10,12,68,45,45,0,0,45,96,45,10,12,23,473,152,321
360550048003,36, New York,055, Monroe County,112,91,42,0,49,31,31,0,0,31,81,60,42,0,18,334,68,266
360550049001,36, New York,055, Monroe County,245,200,61,35,104,86,86,23,0,63,159,114,38,35,41,617,243,374
360550049002,36, New York,055, Monroe County,278,163,55,0,108,130,130,37,0,93,148,33,18,0,15,719,432,287
360550050001,36, New York,055, Monroe County,191,128,85,0,43,49,49,28,0,21,142,79,57,0,22,398,138,260
360550050002,36, New York,055, Monroe County,241,59,2,0,57,106,57,0,0,57,135,2,2,0,0,849,391,458
360550051001,36, New York,055, Monroe County,176,64,0,0,64,60,36,0,0,36,116,28,0,0,28,454,173,281
360550051002,36, New York,055, Monroe County,235,169,11,0,158,137,99,0,0,99,98,70,11,0,59,518,289,229
360550052001,36, New York,055, Monroe County,92,45,0,0,45,22,9,0,0,9,70,36,0,0,36,310,120,190
360550052002,36, New York,055, Monroe County,205,144,3,0,141,32,32,0,0,32,173,112,3,0,109,680,187,493
360550054001,36, New York,055, Monroe County,193,127,53,0,74,43,43,4,0,39,150,84,49,0,35,536,58,478
360550054002,36, New York,055, Monroe County,204,74,34,0,40,0,0,0,0,0,204,74,34,0,40,600,38,562
360550054003,36, New York,055, Monroe County,179,113,47,44,22,66,66,0,44,22,113,47,47,0,0,544,137,407
360550054004,36, New York,055, Monroe County,238,100,0,0,100,20,0,0,0,0,218,100,0,0,100,690,42,648
360550054005,36, New York,055, Monroe County,128,77,0,58,19,0,0,0,0,0,128,77,0,58,19,514,0,514
360550055001,36, New York,055, Monroe County,129,110,48,25,37,40,40,33,0,7,89,70,15,25,30,415,110,305
360550055002,36, New York,055, Monroe County,107,104,14,0,90,75,75,0,0,75,32,29,14,0,15,391,200,191
360550055003,36, New York,055, Monroe County,73,29,0,0,29,21,21,0,0,21,52,8,0,0,8,284,71,213
360550056001,36, New York,055, Monroe County,275,128,27,0,101,179,117,27,0,90,96,11,0,0,11,572,283,289
360550056002,36, New York,055, Monroe County,206,159,47,0,112,102,80,20,0,60,104,79,27,0,52,547,211,336
360550056003,36, New York,055, Monroe County,113,85,9,17,59,78,70,0,17,53,35,15,9,0,6,498,180,318
360550057001,36, New York,055, Monroe County,190,118,35,0,83,66,66,7,0,59,124,52,28,0,24,376,75,301
360550057002,36, New York,055, Monroe County,261,191,129,0,62,80,58,13,0,45,181,133,116,0,17,668,176,492
360550058001,36, New York,055, Monroe County,352,219,39,15,165,95,95,9,0,86,257,124,30,15,79,877,215,662
360550058002,36, New York,055, Monroe County,121,35,0,7,28,30,7,0,7,0,91,28,0,0,28,377,96,281
360550058003,36, New York,055, Monroe County,252,200,20,0,180,225,180,0,0,180,27,20,20,0,0,696,393,303
360550058004,36, New York,055, Monroe County,120,86,22,0,64,26,26,0,0,26,94,60,22,0,38,402,96,306
360550059001,36, New York,055, Monroe County,118,61,8,0,53,4,4,4,0,0,114,57,4,0,53,482,45,437
360550059002,36, New York,055, Monroe County,233,109,33,6,70,57,47,2,6,39,176,62,31,0,31,658,95,563
360550060001,36, New York,055, Monroe County,100,67,65,0,2,0,0,0,0,0,100,67,65,0,2,611,77,534
360550060002,36, New York,055, Monroe County,201,54,9,0,45,0,0,0,0,0,201,54,9,0,45,611,0,611
360550060003,36, New York,055, Monroe County,274,83,83,0,0,0,0,0,0,0,274,83,83,0,0,1008,24,984
360550060004,36, New York,055, Monroe County,90,56,0,0,56,0,0,0,0,0,90,56,0,0,56,651,276,375
360550061001,36, New York,055, Monroe County,228,118,54,23,41,64,64,0,23,41,164,54,54,0,0,974,140,834
360550061002,36, New York,055, Monroe County,365,75,58,0,17,8,0,0,0,0,357,75,58,0,17,1048,55,993
360550062001,36, New York,055, Monroe County,115,96,15,35,46,20,20,0,20,0,95,76,15,15,46,561,94,467
360550062002,36, New York,055, Monroe County,156,74,52,0,22,0,0,0,0,0,156,74,52,0,22,535,71,464
360550062003,36, New York,055, Monroe County,285,210,112,0,98,40,40,0,0,40,245,170,112,0,58,985,56,929
360550063001,36, New York,055, Monroe County,225,111,26,47,38,26,26,26,0,0,199,85,0,47,38,574,101,473
360550063002,36, New York,055, Monroe County,283,189,50,17,122,0,0,0,0,0,283,189,50,17,122,719,67,652
360550063003,36, New York,055, Monroe County,342,179,44,13,122,59,48,0,0,48,283,131,44,13,74,951,130,821
360550064001,36, New York,055, Monroe County,104,33,0,0,33,10,10,0,0,10,94,23,0,0,23,284,10,274
360550064002,36, New York,055, Monroe County,211,133,39,0,94,46,46,0,0,46,165,87,39,0,48,536,121,415
360550064003,36, New York,055, Monroe County,280,178,42,0,136,124,124,0,0,124,156,54,42,0,12,771,248,523
360550065001,36, New York,055, Monroe County,184,147,41,0,106,152,122,41,0,81,32,25,0,0,25,383,280,103
360550065002,36, New York,055, Monroe County,187,118,21,0,97,115,86,0,0,86,72,32,21,0,11,638,315,323
360550066001,36, New York,055, Monroe County,128,110,0,0,110,17,17,0,0,17,111,93,0,0,93,405,83,322
360550066002,36, New York,055, Monroe County,308,158,13,23,122,108,100,13,0,87,200,58,0,23,35,1036,261,775
360550067001,36, New York,055, Monroe County,273,154,96,26,32,0,0,0,0,0,273,154,96,26,32,942,47,895
360550067002,36, New York,055, Monroe County,224,141,40,71,30,30,30,0,0,30,194,111,40,71,0,616,54,562
360550067003,36, New York,055, Monroe County,118,36,0,0,36,36,36,0,0,36,82,0,0,0,0,372,49,323
360550068001,36, New York,055, Monroe County,340,255,28,0,227,22,22,0,0,22,318,233,28,0,205,765,47,718
360550068002,36, New York,055, Monroe County,233,52,5,2,45,45,45,0,0,45,188,7,5,2,0,684,141,543
360550068003,36, New York,055, Monroe County,297,191,81,0,110,8,8,0,0,8,289,183,81,0,102,664,46,618
360550069001,36, New York,055, Monroe County,130,45,0,29,16,27,16,0,0,16,103,29,0,29,0,540,169,371
360550069002,36, New York,055, Monroe County,234,148,64,0,84,106,70,7,0,63,128,78,57,0,21,869,368,501
360550070001,36, New York,055, Monroe County,274,228,137,13,78,50,50,0,13,37,224,178,137,0,41,717,161,556
360550070002,36, New York,055, Monroe County,441,125,0,44,81,71,41,0,0,41,370,84,0,44,40,1262,436,826
360550070003,36, New York,055, Monroe County,80,0,0,0,0,0,0,0,0,0,80,0,0,0,0,400,65,335
360550071001,36, New York,055, Monroe County,111,0,0,0,0,29,0,0,0,0,82,0,0,0,0,501,121,380
360550071002,36, New York,055, Monroe County,363,114,0,0,114,114,114,0,0,114,249,0,0,0,0,1159,197,962
360550071003,36, New York,055, Monroe County,169,120,17,48,55,7,7,7,0,0,162,113,10,48,55,532,155,377
360550071004,36, New York,055, Monroe County,86,18,18,0,0,30,0,0,0,0,56,18,18,0,0,430,62,368
360550075001,36, New York,055, Monroe County,307,256,66,30,160,82,82,0,0,82,225,174,66,30,78,743,166,577
360550075002,36, New York,055, Monroe County,150,124,39,0,85,46,46,0,0,46,104,78,39,0,39,472,137,335
360550075003,36, New York,055, Monroe County,133,60,19,0,41,6,0,0,0,0,127,60,19,0,41,546,56,490
360550076001,36, New York,055, Monroe County,181,43,43,0,0,0,0,0,0,0,181,43,43,0,0,535,17,518
360550076002,36, New York,055, Monroe County,321,43,43,0,0,0,0,0,0,0,321,43,43,0,0,1278,79,1199
360550076003,36, New York,055, Monroe County,163,49,36,0,13,0,0,0,0,0,163,49,36,0,13,821,59,762
360550077001,36, New York,055, Monroe County,168,103,68,16,19,35,20,1,0,19,133,83,67,16,0,731,172,559
360550077002,36, New York,055, Monroe County,215,102,66,10,26,23,15,0,0,15,192,87,66,10,11,665,39,626
360550077003,36, New York,055, Monroe County,234,107,72,20,15,57,0,0,0,0,177,107,72,20,15,847,207,640
360550078011,36, New York,055, Monroe County,295,80,63,0,17,0,0,0,0,0,295,80,63,0,17,1666,99,1567
360550078012,36, New York,055, Monroe County,71,0,0,0,0,0,0,0,0,0,71,0,0,0,0,767,111,656
360550078021,36, New York,055, Monroe County,159,96,88,4,4,0,0,0,0,0,159,96,88,4,4,596,21,575
360550078022,36, New York,055, Monroe County,226,68,58,0,10,0,0,0,0,0,226,68,58,0,10,708,17,691
360550079001,36, New York,055, Monroe County,228,133,19,12,102,55,55,10,12,33,173,78,9,0,69,997,290,707
360550079002,36, New York,055, Monroe County,104,64,0,0,64,55,55,0,0,55,49,9,0,0,9,292,88,204
360550080001,36, New York,055, Monroe County,125,80,52,0,28,31,21,11,0,10,94,59,41,0,18,519,112,407
360550080002,36, New York,055, Monroe County,258,166,81,0,85,85,85,0,0,85,173,81,81,0,0,780,225,555
360550081001,36, New York,055, Monroe County,334,202,70,68,64,46,11,0,0,11,288,191,70,68,53,885,129,756
360550081002,36, New York,055, Monroe County,694,224,36,0,188,137,83,7,0,76,557,141,29,0,112,2191,470,1721
360550082001,36, New York,055, Monroe County,131,60,22,14,24,16,10,0,0,10,115,50,22,14,14,459,31,428
360550082002,36, New York,055, Monroe County,235,46,0,20,26,72,14,0,0,14,163,32,0,20,12,892,401,491
360550082003,36, New York,055, Monroe County,328,201,64,0,137,41,41,0,0,41,287,160,64,0,96,792,120,672
360550083011,36, New York,055, Monroe County,507,269,102,13,154,203,197,62,13,122,304,72,40,0,32,1698,349,1349
360550083012,36, New York,055, Monroe County,603,394,147,11,236,62,62,0,0,62,541,332,147,11,174,1635,344,1291
360550084001,36, New York,055, Monroe County,215,112,8,39,65,65,44,0,27,17,150,68,8,12,48,542,178,364
360550084002,36, New York,055, Monroe County,156,120,37,0,83,36,36,0,0,36,120,84,37,0,47,644,173,471
360550084003,36, New York,055, Monroe County,279,190,19,9,162,148,141,0,9,132,131,49,19,0,30,571,228,343
360550085001,36, New York,055, Monroe County,203,46,32,0,14,14,14,0,0,14,189,32,32,0,0,1050,149,901
360550085002,36, New York,055, Monroe County,239,129,13,0,116,0,0,0,0,0,239,129,13,0,116,1004,164,840
360550085003,36, New York,055, Monroe County,302,116,71,0,45,0,0,0,0,0,302,116,71,0,45,941,141,800
360550086001,36, New York,055, Monroe County,243,102,85,0,17,23,0,0,0,0,220,102,85,0,17,1079,164,915
360550086002,36, New York,055, Monroe County,262,150,90,29,31,17,17,0,0,17,245,133,90,29,14,706,55,651
360550086003,36, New York,055, Monroe County,583,318,73,80,165,89,78,0,7,71,494,240,73,73,94,1585,333,1252
360550087021,36, New York,055, Monroe County,371,244,11,0,233,180,164,0,0,164,191,80,11,0,69,994,351,643
360550088011,36, New York,055, Monroe County,554,326,182,61,83,59,44,8,36,0,495,282,174,25,83,1705,142,1563
360550088012,36, New York,055, Monroe County,212,107,67,0,40,48,26,0,0,26,164,81,67,0,14,591,135,456
360550088013,36, New York,055, Monroe County,128,83,36,5,42,44,44,17,5,22,84,39,19,0,20,559,145,414
360550088014,36, New York,055, Monroe County,518,223,19,24,180,206,168,0,0,168,312,55,19,24,12,1904,534,1370
360550092001,36, New York,055, Monroe County,76,69,0,0,69,69,69,0,0,69,7,0,0,0,0,426,305,121
360550092002,36, New York,055, Monroe County,144,63,18,0,45,34,34,5,0,29,110,29,13,0,16,406,157,249
360550093011,36, New York,055, Monroe County,188,179,0,0,179,81,72,0,0,72,107,107,0,0,107,488,237,251
360550093012,36, New York,055, Monroe County,89,44,44,0,0,0,0,0,0,0,89,44,44,0,0,597,171,426
360550093013,36, New York,055, Monroe County,134,97,19,0,78,78,78,0,0,78,56,19,19,0,0,328,152,176
360550093021,36, New York,055, Monroe County,118,39,21,11,7,18,7,0,0,7,100,32,21,11,0,1878,327,1551
360550094011,36, New York,055, Monroe County,85,0,0,0,0,0,0,0,0,0,85,0,0,0,0,282,87,195
360550094012,36, New York,055, Monroe County,183,92,0,0,92,0,0,0,0,0,183,92,0,0,92,1485,398,1087
360550094021,36, New York,055, Monroe County,456,267,267,0,0,0,0,0,0,0,456,267,267,0,0,1654,265,1389
360550094031,36, New York,055, Monroe County,0,0,0,0,0,0,0,0,0,0,0,0,0,0,0,0,0,0
360550094041,36, New York,055, Monroe County,59,19,19,0,0,0,0,0,0,0,59,19,19,0,0,446,114,332
360550095001,36, New York,055, Monroe County,182,66,66,0,0,0,0,0,0,0,182,66,66,0,0,1019,81,938
360550095002,36, New York,055, Monroe County,195,68,9,0,59,44,33,0,0,33,151,35,9,0,26,995,245,750
360550095003,36, New York,055, Monroe County,165,98,21,0,77,107,88,21,0,67,58,10,0,0,10,451,133,318
360550096011,36, New York,055, Monroe County,121,102,0,45,57,28,28,0,0,28,93,74,0,45,29,567,201,366
360550096012,36, New York,055, Monroe County,181,102,33,0,69,41,34,0,0,34,140,68,33,0,35,700,287,413
360550096021,36, New York,055, Monroe County,145,109,7,12,90,63,63,7,12,44,82,46,0,0,46,432,211,221
360550096022,36, New York,055, Monroe County,152,113,57,0,56,61,61,32,0,29,91,52,25,0,27,386,156,230
360550096051,36, New York,055, Monroe County,312,251,120,18,113,111,111,70,12,29,201,140,50,6,84,697,258,439
360550096052,36, New York,055, Monroe County,450,280,47,16,217,239,208,24,16,168,211,72,23,0,49,966,387,579
360550101001,36, New York,055, Monroe County,451,191,139,0,52,0,0,0,0,0,451,191,139,0,52,1202,50,1152
360550101002,36, New York,055, Monroe County,167,72,47,13,12,24,13,0,13,0,143,59,47,0,12,478,107,371
360550101003,36, New York,055, Monroe County,229,100,35,17,48,13,13,0,8,5,216,87,35,9,43,946,75,871
360550102001,36, New York,055, Monroe County,284,145,112,0,33,0,0,0,0,0,284,145,112,0,33,713,15,698
360550102002,36, New York,055, Monroe County,348,151,126,0,25,18,18,0,0,18,330,133,126,0,7,825,18,807
360550102003,36, New York,055, Monroe County,366,89,69,7,13,13,13,0,0,13,353,76,69,7,0,835,25,810
360550102004,36, New York,055, Monroe County,306,68,68,0,0,0,0,0,0,0,306,68,68,0,0,767,0,767
360550103001,36, New York,055, Monroe County,675,314,221,9,84,0,0,0,0,0,675,314,221,9,84,1641,21,1620
360550103002,36, New York,055, Monroe County,546,227,148,29,50,12,12,0,0,12,534,215,148,29,38,1385,56,1329
360550104001,36, New York,055, Monroe County,695,289,186,25,78,0,0,0,0,0,695,289,186,25,78,1828,4,1824
360550104002,36, New York,055, Monroe County,546,335,105,0,230,92,92,17,0,75,454,243,88,0,155,1868,276,1592
360550105001,36, New York,055, Monroe County,514,248,205,34,9,13,0,0,0,0,501,248,205,34,9,1311,85,1226
360550105002,36, New York,055, Monroe County,200,61,53,0,8,7,7,7,0,0,193,54,46,0,8,512,23,489
360550105003,36, New York,055, Monroe County,384,193,149,24,20,24,15,15,0,0,360,178,134,24,20,882,59,823
360550105004,36, New York,055, Monroe County,217,111,78,0,33,16,0,0,0,0,201,111,78,0,33,575,85,490
360550106011,36, New York,055, Monroe County,133,64,30,0,34,0,0,0,0,0,133,64,30,0,34,775,91,684
360550106012,36, New York,055, Monroe County,216,65,40,8,17,37,37,29,8,0,179,28,11,0,17,577,70,507
360550106013,36, New York,055, Monroe County,107,36,36,0,0,20,20,20,0,0,87,16,16,0,0,292,66,226
360550106014,36, New York,055, Monroe County,214,34,14,20,0,0,0,0,0,0,214,34,14,20,0,666,25,641
360550106021,36, New York,055, Monroe County,253,92,37,0,55,0,0,0,0,0,253,92,37,0,55,680,64,616
360550106022,36, New York,055, Monroe County,363,134,76,22,36,13,13,0,0,13,350,121,76,22,23,1377,203,1174
360550106023,36, New York,055, Monroe County,410,151,121,17,13,9,0,0,0,0,401,151,121,17,13,1148,58,1090
360550107001,36, New York,055, Monroe County,395,246,186,46,14,14,14,0,0,14,381,232,186,46,0,941,24,917
360550107002,36, New York,055, Monroe County,172,35,14,0,21,9,0,0,0,0,163,35,14,0,21,649,27,622
360550107003,36, New York,055, Monroe County,374,121,100,0,21,57,52,52,0,0,317,69,48,0,21,1111,158,953
360550108001,36, New York,055, Monroe County,143,41,28,0,13,0,0,0,0,0,143,41,28,0,13,493,0,493
360550108002,36, New York,055, Monroe County,320,96,85,0,11,0,0,0,0,0,320,96,85,0,11,810,0,810
360550108003,36, New York,055, Monroe County,296,87,87,0,0,0,0,0,0,0,296,87,87,0,0,929,50,879
360550108004,36, New York,055, Monroe County,129,48,13,11,24,9,0,0,0,0,120,48,13,11,24,457,47,410
360550109011,36, New York,055, Monroe County,344,148,48,0,100,100,100,0,0,100,244,48,48,0,0,959,219,740
360550109012,36, New York,055, Monroe County,87,28,0,0,28,0,0,0,0,0,87,28,0,0,28,553,127,426
360550109013,36, New York,055, Monroe County,454,261,19,0,242,62,55,0,0,55,392,206,19,0,187,1277,190,1087
360550109021,36, New York,055, Monroe County,165,51,12,18,21,18,18,0,18,0,147,33,12,0,21,505,18,487
360550109022,36, New York,055, Monroe County,162,32,32,0,0,33,15,15,0,0,129,17,17,0,0,427,80,347
360550109023,36, New York,055, Monroe County,321,202,65,9,128,128,128,0,0,128,193,74,65,9,0,996,268,728
360550109024,36, New York,055, Monroe County,181,58,41,11,6,31,0,0,0,0,150,58,41,11,6,679,121,558
360550110001,36, New York,055, Monroe County,218,27,27,0,0,0,0,0,0,0,218,27,27,0,0,750,15,735
360550110002,36, New York,055, Monroe County,259,31,9,0,22,0,0,0,0,0,259,31,9,0,22,769,29,740
360550110003,36, New York,055, Monroe County,497,266,255,0,11,24,0,0,0,0,473,266,255,0,11,1114,58,1056
360550110004,36, New York,055, Monroe County,435,181,108,73,0,0,0,0,0,0,435,181,108,73,0,1505,77,1428
360550111001,36, New York,055, Monroe County,451,70,44,10,16,0,0,0,0,0,451,70,44,10,16,1388,19,1369
360550111002,36, New York,055, Monroe County,729,292,98,76,118,27,27,0,0,27,702,265,98,76,91,2498,158,2340
360550112011,36, New York,055, Monroe County,494,118,110,0,8,9,0,0,0,0,485,118,110,0,8,1309,49,1260
360550112012,36, New York,055, Monroe County,206,69,48,11,10,21,21,0,11,10,185,48,48,0,0,583,39,544
360550112013,36, New York,055, Monroe County,336,181,61,12,108,79,68,0,0,68,257,113,61,12,40,914,112,802
360550112031,36, New York,055, Monroe County,151,32,32,0,0,0,0,0,0,0,151,32,32,0,0,429,7,422
360550112032,36, New York,055, Monroe County,491,216,131,49,36,0,0,0,0,0,491,216,131,49,36,1200,10,1190
360550112051,36, New York,055, Monroe County,446,137,92,45,0,0,0,0,0,0,446,137,92,45,0,1124,25,1099
360550112052,36, New York,055, Monroe County,364,179,112,16,51,0,0,0,0,0,364,179,112,16,51,1259,63,1196
360550112053,36, New York,055, Monroe County,764,287,267,9,11,11,11,11,0,0,753,276,256,9,11,1870,99,1771
360550112071,36, New York,055, Monroe County,217,71,42,29,0,0,0,0,0,0,217,71,42,29,0,597,8,589
360550112072,36, New York,055, Monroe County,386,210,103,74,33,9,9,9,0,0,377,201,94,74,33,1140,67,1073
360550112073,36, New York,055, Monroe County,291,180,180,0,0,0,0,0,0,0,291,180,180,0,0,1002,16,986
360550112074,36, New York,055, Monroe County,334,157,96,61,0,11,11,11,0,0,323,146,85,61,0,1213,87,1126
360550112091,36, New York,055, Monroe County,137,43,43,0,0,0,0,0,0,0,137,43,43,0,0,763,0,763
360550112092,36, New York,055, Monroe County,307,138,44,81,13,0,0,0,0,0,307,138,44,81,13,1163,26,1137
360550112093,36, New York,055, Monroe County,264,141,12,83,46,15,0,0,0,0,249,141,12,83,46,874,115,759
360550112094,36, New York,055, Monroe County,284,131,23,0,108,30,30,0,0,30,254,101,23,0,78,1099,172,927
360550112101,36, New York,055, Monroe County,153,63,52,0,11,0,0,0,0,0,153,63,52,0,11,479,56,423
360550112102,36, New York,055, Monroe County,0,0,0,0,0,0,0,0,0,0,0,0,0,0,0,0,0,0
360550112103,36, New York,055, Monroe County,45,16,16,0,0,0,0,0,0,0,45,16,16,0,0,237,21,216
360550113021,36, New York,055, Monroe County,275,103,103,0,0,15,15,15,0,0,260,88,88,0,0,596,30,566
360550113022,36, New York,055, Monroe County,243,91,74,17,0,0,0,0,0,0,243,91,74,17,0,798,54,744
360550113023,36, New York,055, Monroe County,796,441,220,0,221,13,13,13,0,0,783,428,207,0,221,1532,57,1475
360550113024,36, New York,055, Monroe County,444,160,99,37,24,18,18,0,18,0,426,142,99,19,24,1366,42,1324
360550113031,36, New York,055, Monroe County,322,97,73,0,24,14,14,14,0,0,308,83,59,0,24,778,72,706
360550113032,36, New York,055, Monroe County,523,207,168,20,19,15,15,8,0,7,508,192,160,20,12,1249,48,1201
360550113041,36, New York,055, Monroe County,732,240,202,17,21,0,0,0,0,0,732,240,202,17,21,1576,0,1576
360550113042,36, New York,055, Monroe County,610,230,192,0,38,0,0,0,0,0,610,230,192,0,38,1467,20,1447
360550113043,36, New York,055, Monroe County,186,23,23,0,0,17,0,0,0,0,169,23,23,0,0,544,43,501
360550114011,36, New York,055, Monroe County,321,174,95,66,13,0,0,0,0,0,321,174,95,66,13,805,0,805
360550114012,36, New York,055, Monroe County,33,0,0,0,0,0,0,0,0,0,33,0,0,0,0,89,0,89
360550114013,36, New York,055, Monroe County,509,271,227,13,31,78,31,0,0,31,431,240,227,13,0,1478,279,1199
360550114021,36, New York,055, Monroe County,334,159,129,12,18,0,0,0,0,0,334,159,129,12,18,918,39,879
360550114022,36, New York,055, Monroe County,859,243,204,16,23,18,0,0,0,0,841,243,204,16,23,2341,96,2245
360550114031,36, New York,055, Monroe County,518,321,64,22,235,0,0,0,0,0,518,321,64,22,235,1913,212,1701
360550114032,36, New York,055, Monroe County,181,106,31,0,75,0,0,0,0,0,181,106,31,0,75,586,39,547
360550115031,36, New York,055, Monroe County,645,193,162,17,14,18,0,0,0,0,627,193,162,17,14,1603,52,1551
360550115032,36, New York,055, Monroe County,238,61,61,0,0,0,0,0,0,0,238,61,61,0,0,845,0,845
360550115033,36, New York,055, Monroe County,687,191,191,0,0,0,0,0,0,0,687,191,191,0,0,1759,27,1732
360550115041,36, New York,055, Monroe County,815,377,348,0,29,18,0,0,0,0,797,377,348,0,29,1933,66,1867
360550115042,36, New York,055, Monroe County,821,271,271,0,0,0,0,0,0,0,821,271,271,0,0,2179,43,2136
360550115043,36, New York,055, Monroe County,615,361,262,87,12,0,0,0,0,0,615,361,262,87,12,1503,4,1499
360550115051,36, New York,055, Monroe County,134,43,43,0,0,0,0,0,0,0,134,43,43,0,0,468,5,463
360550115052,36, New York,055, Monroe County,324,93,78,0,15,15,15,0,0,15,309,78,78,0,0,730,15,715
360550115053,36, New York,055, Monroe County,491,291,291,0,0,0,0,0,0,0,491,291,291,0,0,1327,58,1269
360550115054,36, New York,055, Monroe County,629,199,66,27,106,0,0,0,0,0,629,199,66,27,106,1724,28,1696
360550115061,36, New York,055, Monroe County,737,324,317,0,7,0,0,0,0,0,737,324,317,0,7,1827,25,1802
360550115062,36, New York,055, Monroe County,508,229,212,17,0,0,0,0,0,0,508,229,212,17,0,1126,0,1126
360550115071,36, New York,055, Monroe County,255,94,43,0,51,79,35,0,0,35,176,59,43,0,16,1135,168,967
360550115072,36, New York,055, Monroe County,903,527,464,28,35,35,35,0,0,35,868,492,464,28,0,2167,61,2106
360550116011,36, New York,055, Monroe County,192,83,21,0,62,0,0,0,0,0,192,83,21,0,62,470,23,447
360550116012,36, New York,055, Monroe County,337,161,69,17,75,43,43,0,0,43,294,118,69,17,32,1185,127,1058
360550116013,36, New York,055, Monroe County,264,127,112,15,0,0,0,0,0,0,264,127,112,15,0,828,42,786
360550116014,36, New York,055, Monroe County,604,239,221,18,0,35,0,0,0,0,569,239,221,18,0,1426,109,1317
360550116031,36, New York,055, Monroe County,229,80,22,9,49,40,37,15,0,22,189,43,7,9,27,1069,260,809
360550116041,36, New York,055, Monroe County,389,52,47,0,5,12,0,0,0,0,377,52,47,0,5,1214,34,1180
360550116042,36, New York,055, Monroe County,469,166,141,5,20,24,24,24,0,0,445,142,117,5,20,1238,73,1165
360550116051,36, New York,055, Monroe County,158,80,43,10,27,24,24,6,0,18,134,56,37,10,9,400,38,362
360550116052,36, New York,055, Monroe County,442,211,145,24,42,5,5,0,5,0,437,206,145,19,42,1108,96,1012
360550117051,36, New York,055, Monroe County,348,112,96,0,16,0,0,0,0,0,348,112,96,0,16,1173,80,1093
360550117052,36, New York,055, Monroe County,217,109,82,0,27,0,0,0,0,0,217,109,82,0,27,463,0,463
360550117071,36, New York,055, Monroe County,753,261,246,0,15,0,0,0,0,0,753,261,246,0,15,1927,55,1872
360550117072,36, New York,055, Monroe County,886,383,304,0,79,0,0,0,0,0,886,383,304,0,79,2171,47,2124
360550117073,36, New York,055, Monroe County,450,238,177,47,14,45,45,0,31,14,405,193,177,16,0,1114,73,1041
360550117081,36, New York,055, Monroe County,162,70,70,0,0,0,0,0,0,0,162,70,70,0,0,430,0,430
360550117082,36, New York,055, Monroe County,283,43,24,0,19,11,0,0,0,0,272,43,24,0,19,605,21,584
360550117083,36, New York,055, Monroe County,598,218,191,19,8,10,10,0,10,0,588,208,191,9,8,1761,33,1728
360550117091,36, New York,055, Monroe County,883,321,315,0,6,0,0,0,0,0,883,321,315,0,6,2302,27,2275
360550117101,36, New York,055, Monroe County,323,127,35,0,92,10,10,0,0,10,313,117,35,0,82,1082,29,1053
360550117102,36, New York,055, Monroe County,388,162,162,0,0,20,0,0,0,0,368,162,162,0,0,949,51,898
360550117103,36, New York,055, Monroe County,250,83,51,17,15,4,0,0,0,0,246,83,51,17,15,904,31,873
360550117104,36, New York,055, Monroe County,886,511,454,0,57,0,0,0,0,0,886,511,454,0,57,2190,15,2175
360550117111,36, New York,055, Monroe County,286,80,39,0,41,24,24,7,0,17,262,56,32,0,24,907,58,849
360550117112,36, New York,055, Monroe County,202,89,25,10,54,10,10,0,10,0,192,79,25,0,54,506,34,472
360550117121,36, New York,055, Monroe County,249,34,34,0,0,0,0,0,0,0,249,34,34,0,0,1084,31,1053
360550117122,36, New York,055, Monroe County,304,117,117,0,0,9,9,9,0,0,295,108,108,0,0,948,11,937
360550117123,36, New York,055, Monroe County,766,286,187,37,62,27,0,0,0,0,739,286,187,37,62,1597,61,1536
360550117124,36, New York,055, Monroe County,163,94,89,0,5,0,0,0,0,0,163,94,89,0,5,468,12,456
360550118001,36, New York,055, Monroe County,467,283,213,25,45,19,19,0,0,19,448,264,213,25,26,1301,102,1199
360550118002,36, New York,055, Monroe County,282,34,14,20,0,0,0,0,0,0,282,34,14,20,0,1073,29,1044
360550118003,36, New York,055, Monroe County,489,331,116,0,215,231,185,0,0,185,258,146,116,0,30,963,284,679
360550118004,36, New York,055, Monroe County,330,141,34,0,107,49,49,0,0,49,281,92,34,0,58,1085,95,990
360550119011,36, New York,055, Monroe County,329,112,112,0,0,14,0,0,0,0,315,112,112,0,0,978,73,905
360550119012,36, New York,055, Monroe County,153,97,97,0,0,0,0,0,0,0,153,97,97,0,0,384,3,381
360550119013,36, New York,055, Monroe County,313,21,21,0,0,14,0,0,0,0,299,21,21,0,0,960,32,928
360550119014,36, New York,055, Monroe County,550,252,137,11,104,80,65,50,0,15,470,187,87,11,89,1517,219,1298
360550119015,36, New York,055, Monroe County,186,109,20,60,29,0,0,0,0,0,186,109,20,60,29,609,103,506
360550119031,36, New York,055, Monroe County,579,266,254,0,12,12,12,0,0,12,567,254,254,0,0,1555,12,1543
360550119041,36, New York,055, Monroe County,375,107,91,0,16,0,0,0,0,0,375,107,91,0,16,1047,68,979
360550119042,36, New York,055, Monroe County,226,81,61,20,0,0,0,0,0,0,226,81,61,20,0,506,0,506
360550119043,36, New York,055, Monroe County,609,217,196,0,21,0,0,0,0,0,609,217,196,0,21,1797,67,1730
360550120001,36, New York,055, Monroe County,131,68,27,25,16,0,0,0,0,0,131,68,27,25,16,797,54,743
360550120002,36, New York,055, Monroe County,352,124,73,33,18,41,0,0,0,0,311,124,73,33,18,1204,184,1020
360550121001,36, New York,055, Monroe County,665,224,132,37,55,56,29,0,0,29,609,195,132,37,26,2094,291,1803
360550121002,36, New York,055, Monroe County,314,138,40,0,98,0,0,0,0,0,314,138,40,0,98,1100,32,1068
360550122011,36, New York,055, Monroe County,169,42,42,0,0,0,0,0,0,0,169,42,42,0,0,784,76,708
360550122012,36, New York,055, Monroe County,0,0,0,0,0,0,0,0,0,0,0,0,0,0,0,0,0,0
360550122013,36, New York,055, Monroe County,129,38,38,0,0,0,0,0,0,0,129,38,38,0,0,344,35,309
360550122014,36, New York,055, Monroe County,646,313,241,28,44,10,10,0,0,10,636,303,241,28,34,1591,135,1456
360550122015,36, New York,055, Monroe County,0,0,0,0,0,0,0,0,0,0,0,0,0,0,0,29,29,0
360550122021,36, New York,055, Monroe County,361,169,157,0,12,0,0,0,0,0,361,169,157,0,12,1118,69,1049
360550122022,36, New York,055, Monroe County,293,129,102,0,27,0,0,0,0,0,293,129,102,0,27,765,7,758
360550122023,36, New York,055, Monroe County,316,81,62,0,19,14,14,0,0,14,302,67,62,0,5,952,64,888
360550123011,36, New York,055, Monroe County,217,122,122,0,0,0,0,0,0,0,217,122,122,0,0,558,7,551
360550123012,36, New York,055, Monroe County,250,120,120,0,0,0,0,0,0,0,250,120,120,0,0,597,5,592
360550123013,36, New York,055, Monroe County,437,204,157,30,17,12,12,0,0,12,425,192,157,30,5,1302,40,1262
360550123014,36, New York,055, Monroe County,473,248,224,0,24,0,0,0,0,0,473,248,224,0,24,1144,0,1144
360550123015,36, New York,055, Monroe County,226,105,100,0,5,0,0,0,0,0,226,105,100,0,5,678,26,652
360550123041,36, New York,055, Monroe County,387,133,116,0,17,10,0,0,0,0,377,133,116,0,17,1086,30,1056
360550123042,36, New York,055, Monroe County,652,299,256,12,31,0,0,0,0,0,652,299,256,12,31,1559,38,1521
360550123043,36, New York,055, Monroe County,198,147,137,10,0,9,0,0,0,0,189,147,137,10,0,552,19,533
360550123051,36, New York,055, Monroe County,586,320,276,21,23,0,0,0,0,0,586,320,276,21,23,1334,20,1314
360550123052,36, New York,055, Monroe County,702,211,204,0,7,0,0,0,0,0,702,211,204,0,7,1594,13,1581
360550123071,36, New York,055, Monroe County,631,364,341,11,12,0,0,0,0,0,631,364,341,11,12,1413,8,1405
360550123081,36, New York,055, Monroe County,790,166,157,0,9,0,0,0,0,0,790,166,157,0,9,1919,13,1906
360550123082,36, New York,055, Monroe County,391,166,158,0,8,0,0,0,0,0,391,166,158,0,8,1023,10,1013
360550124011,36, New York,055, Monroe County,517,292,207,16,69,0,0,0,0,0,517,292,207,16,69,1386,55,1331
360550124012,36, New York,055, Monroe County,268,77,68,0,9,15,9,0,0,9,253,68,68,0,0,1006,129,877
360550124021,36, New York,055, Monroe County,614,294,269,0,25,47,25,0,0,25,567,269,269,0,0,1717,87,1630
360550124022,36, New York,055, Monroe County,300,89,89,0,0,0,0,0,0,0,300,89,89,0,0,922,0,922
360550124023,36, New York,055, Monroe County,878,532,409,57,66,57,57,0,57,0,821,475,409,0,66,1873,57,1816
360550125001,36, New York,055, Monroe County,412,96,74,0,22,0,0,0,0,0,412,96,74,0,22,998,30,968
360550125002,36, New York,055, Monroe County,337,150,105,0,45,8,8,0,0,8,329,142,105,0,37,1371,332,1039
360550125003,36, New York,055, Monroe County,404,150,150,0,0,0,0,0,0,0,404,150,150,0,0,1326,114,1212
360550126001,36, New York,055, Monroe County,61,0,0,0,0,0,0,0,0,0,61,0,0,0,0,500,36,464
360550126002,36, New York,055, Monroe County,363,186,154,0,32,32,32,0,0,32,331,154,154,0,0,1184,67,1117
360550126003,36, New York,055, Monroe County,236,123,102,0,21,21,21,0,0,21,215,102,102,0,0,582,67,515
360550126004,36, New York,055, Monroe County,508,149,141,0,8,0,0,0,0,0,508,149,141,0,8,1287,49,1238
360550127001,36, New York,055, Monroe County,294,172,170,0,2,0,0,0,0,0,294,172,170,0,2,733,10,723
360550127002,36, New York,055, Monroe County,434,233,166,0,67,16,8,0,0,8,418,225,166,0,59,1024,34,990
360550127003,36, New York,055, Monroe County,355,214,179,10,25,0,0,0,0,0,355,214,179,10,25,859,44,815
360550128001,36, New York,055, Monroe County,284,129,54,0,75,0,0,0,0,0,284,129,54,0,75,1501,293,1208
360550128002,36, New York,055, Monroe County,479,191,169,0,22,107,0,0,0,0,372,191,169,0,22,979,114,865
360550128003,36, New York,055, Monroe County,258,125,119,6,0,0,0,0,0,0,258,125,119,6,0,989,44,945
360550129001,36, New York,055, Monroe County,461,238,212,0,26,0,0,0,0,0,461,238,212,0,26,1198,0,1198
360550129002,36, New York,055, Monroe County,203,20,20,0,0,0,0,0,0,0,203,20,20,0,0,995,118,877
360550129003,36, New York,055, Monroe County,339,161,126,0,35,0,0,0,0,0,339,161,126,0,35,1073,102,971
360550129004,36, New York,055, Monroe County,410,85,60,10,15,0,0,0,0,0,410,85,60,10,15,1083,15,1068
360550130031,36, New York,055, Monroe County,475,211,163,16,32,0,0,0,0,0,475,211,163,16,32,1047,0,1047
360550130041,36, New York,055, Monroe County,453,212,201,0,11,0,0,0,0,0,453,212,201,0,11,1473,19,1454
360550130042,36, New York,055, Monroe County,173,106,66,0,40,12,12,0,0,12,161,94,66,0,28,656,75,581
360550130043,36, New York,055, Monroe County,169,115,71,26,18,0,0,0,0,0,169,115,71,26,18,514,42,472
360550130044,36, New York,055, Monroe County,450,280,158,0,122,43,43,43,0,0,407,237,115,0,122,950,91,859
360550130051,36, New York,055, Monroe County,71,13,8,0,5,5,5,0,0,5,66,8,8,0,0,672,88,584
360550130052,36, New York,055, Monroe County,277,161,135,0,26,48,48,48,0,0,229,113,87,0,26,876,160,716
360550130053,36, New York,055, Monroe County,0,0,0,0,0,0,0,0,0,0,0,0,0,0,0,0,0,0
360550130054,36, New York,055, Monroe County,123,78,78,0,0,0,0,0,0,0,123,78,78,0,0,356,0,356
360550130061,36, New York,055, Monroe County,373,124,57,67,0,72,67,0,67,0,301,57,57,0,0,972,104,868
360550130062,36, New York,055, Monroe County,101,46,46,0,0,46,46,46,0,0,55,0,0,0,0,632,74,558
360550131011,36, New York,055, Monroe County,304,83,56,0,27,23,23,23,0,0,281,60,33,0,27,914,52,862
360550131012,36, New York,055, Monroe County,239,55,39,16,0,28,0,0,0,0,211,55,39,16,0,1048,128,920
360550131013,36, New York,055, Monroe County,180,64,64,0,0,0,0,0,0,0,180,64,64,0,0,558,13,545
360550131014,36, New York,055, Monroe County,236,61,30,0,31,31,31,0,0,31,205,30,30,0,0,678,84,594
360550131015,36, New York,055, Monroe County,503,234,105,0,129,20,20,20,0,0,483,214,85,0,129,1065,37,1028
360550131016,36, New York,055, Monroe County,454,41,9,0,32,0,0,0,0,0,454,41,9,0,32,1238,52,1186
360550131031,36, New York,055, Monroe County,330,147,141,6,0,0,0,0,0,0,330,147,141,6,0,1094,240,854
360550131032,36, New York,055, Monroe County,0,0,0,0,0,0,0,0,0,0,0,0,0,0,0,286,252,34
360550131033,36, New York,055, Monroe County,9,0,0,0,0,0,0,0,0,0,9,0,0,0,0,720,140,580
360550131041,36, New York,055, Monroe County,130,18,6,12,0,18,0,0,0,0,112,18,6,12,0,608,60,548
360550131042,36, New York,055, Monroe County,236,63,21,22,20,0,0,0,0,0,236,63,21,22,20,1214,173,1041
360550131043,36, New York,055, Monroe County,628,255,100,30,125,48,48,0,0,48,580,207,100,30,77,1725,228,1497
360550132031,36, New York,055, Monroe County,301,111,96,0,15,0,0,0,0,0,301,111,96,0,15,960,0,960
360550132032,36, New York,055, Monroe County,342,107,107,0,0,0,0,0,0,0,342,107,107,0,0,1146,119,1027
360550132033,36, New York,055, Monroe County,528,385,340,0,45,48,48,32,0,16,480,337,308,0,29,1278,205,1073
360550132034,36, New York,055, Monroe County,529,148,114,34,0,0,0,0,0,0,529,148,114,34,0,1413,49,1364
360550132051,36, New York,055, Monroe County,206,40,26,0,14,26,0,0,0,0,180,40,26,0,14,537,45,492
360550132052,36, New York,055, Monroe County,606,293,148,71,74,0,0,0,0,0,606,293,148,71,74,1915,205,1710
360550132053,36, New York,055, Monroe County,321,116,52,4,60,33,4,0,4,0,288,112,52,0,60,1537,654,883
360550132061,36, New York,055, Monroe County,853,395,317,23,55,0,0,0,0,0,853,395,317,23,55,2050,65,1985
360550132062,36, New York,055, Monroe County,545,231,216,15,0,36,0,0,0,0,509,231,216,15,0,1539,83,1456
360550132063,36, New York,055, Monroe County,470,120,110,0,10,37,0,0,0,0,433,120,110,0,10,1593,181,1412
360550132071,36, New York,055, Monroe County,357,151,94,39,18,22,22,0,22,0,335,129,94,17,18,1215,112,1103
360550132072,36, New York,055, Monroe County,914,486,282,67,137,0,0,0,0,0,914,486,282,67,137,2031,16,2015
360550132073,36, New York,055, Monroe County,730,387,286,17,84,0,0,0,0,0,730,387,286,17,84,1667,0,1667
360550132081,36, New York,055, Monroe County,306,130,103,27,0,0,0,0,0,0,306,130,103,27,0,1112,0,1112
360550132082,36, New York,055, Monroe County,0,0,0,0,0,0,0,0,0,0,0,0,0,0,0,0,0,0
360550132083,36, New York,055, Monroe County,189,9,0,0,9,0,0,0,0,0,189,9,0,0,9,1026,76,950
360550133001,36, New York,055, Monroe County,433,175,125,8,42,0,0,0,0,0,433,175,125,8,42,1047,9,1038
360550133002,36, New York,055, Monroe County,179,44,24,0,20,20,20,0,0,20,159,24,24,0,0,561,51,510
360550133003,36, New York,055, Monroe County,386,95,95,0,0,0,0,0,0,0,386,95,95,0,0,1198,31,1167
360550134011,36, New York,055, Monroe County,497,382,74,12,296,133,133,0,0,133,364,249,74,12,163,1408,219,1189
360550134012,36, New York,055, Monroe County,279,118,45,14,59,0,0,0,0,0,279,118,45,14,59,1059,46,1013
360550134013,36, New York,055, Monroe County,300,84,64,0,20,28,8,0,0,8,272,76,64,0,12,716,73,643
360550134021,36, New York,055, Monroe County,106,26,26,0,0,0,0,0,0,0,106,26,26,0,0,302,9,293
360550134022,36, New York,055, Monroe County,380,139,98,0,41,33,33,0,0,33,347,106,98,0,8,1038,110,928
360550134023,36, New York,055, Monroe County,490,142,79,16,47,38,38,38,0,0,452,104,41,16,47,1469,49,1420
360550135031,36, New York,055, Monroe County,298,172,147,25,0,0,0,0,0,0,298,172,147,25,0,752,50,702
360550135032,36, New York,055, Monroe County,648,265,242,15,8,0,0,0,0,0,648,265,242,15,8,1417,0,1417
360550135033,36, New York,055, Monroe County,919,345,316,10,19,0,0,0,0,0,919,345,316,10,19,2162,17,2145
360550135051,36, New York,055, Monroe County,372,174,113,2,59,26,26,0,0,26,346,148,113,2,33,1191,131,1060
360550135052,36, New York,055, Monroe County,178,70,46,0,24,47,5,5,0,0,131,65,41,0,24,925,165,760
360550135053,36, New York,055, Monroe County,362,105,95,0,10,19,10,0,0,10,343,95,95,0,0,905,53,852
360550135071,36, New York,055, Monroe County,857,373,350,15,8,17,17,17,0,0,840,356,333,15,8,2472,86,2386
360550135072,36, New York,055, Monroe County,391,192,137,55,0,19,0,0,0,0,372,192,137,55,0,970,38,932
360550135073,36, New York,055, Monroe County,595,207,179,0,28,12,0,0,0,0,583,207,179,0,28,1541,39,1502
360550135081,36, New York,055, Monroe County,515,286,214,30,42,32,19,0,19,0,483,267,214,11,42,1311,54,1257
360550135082,36, New York,055, Monroe County,647,266,195,43,28,0,0,0,0,0,647,266,195,43,28,1733,28,1705
360550135091,36, New York,055, Monroe County,340,123,123,0,0,0,0,0,0,0,340,123,123,0,0,1053,2,1051
360550135092,36, New York,055, Monroe County,310,107,107,0,0,0,0,0,0,0,310,107,107,0,0,1104,74,1030
360550135101,36, New York,055, Monroe County,414,151,116,26,9,20,12,12,0,0,394,139,104,26,9,1154,50,1104
360550135102,36, New York,055, Monroe County,615,156,127,0,29,54,33,33,0,0,561,123,94,0,29,1580,72,1508
360550135111,36, New York,055, Monroe County,644,280,137,22,121,78,78,0,0,78,566,202,137,22,43,1443,112,1331
360550136011,36, New York,055, Monroe County,308,103,61,9,33,0,0,0,0,0,308,103,61,9,33,1085,19,1066
360550136012,36, New York,055, Monroe County,225,121,80,30,11,30,30,0,30,0,195,91,80,0,11,703,39,664
360550136013,36, New York,055, Monroe County,555,238,81,5,152,47,47,0,0,47,508,191,81,5,105,1501,147,1354
360550136031,36, New York,055, Monroe County,164,66,66,0,0,0,0,0,0,0,164,66,66,0,0,901,283,618
360550136032,36, New York,055, Monroe County,722,219,110,15,94,0,0,0,0,0,722,219,110,15,94,1954,33,1921
360550136033,36, New York,055, Monroe County,523,193,183,0,10,0,0,0,0,0,523,193,183,0,10,1279,0,1279
360550136041,36, New York,055, Monroe County,579,317,213,62,42,98,98,98,0,0,481,219,115,62,42,1465,184,1281
360550136042,36, New York,055, Monroe County,551,377,59,33,285,115,115,0,0,115,436,262,59,33,170,1593,373,1220
360550136043,36, New York,055, Monroe County,362,98,98,0,0,0,0,0,0,0,362,98,98,0,0,1183,41,1142
360550137011,36, New York,055, Monroe County,408,225,169,0,56,13,0,0,0,0,395,225,169,0,56,1157,29,1128
360550137012,36, New York,055, Monroe County,130,84,11,0,73,27,27,0,0,27,103,57,11,0,46,451,66,385
360550137021,36, New York,055, Monroe County,154,78,19,0,59,32,32,0,0,32,122,46,19,0,27,501,51,450
360550137022,36, New York,055, Monroe County,338,207,120,40,47,15,15,0,0,15,323,192,120,40,32,1047,134,913
360550137023,36, New York,055, Monroe County,453,244,48,111,85,46,31,15,16,0,407,213,33,95,85,1373,97,1276
360550138001,36, New York,055, Monroe County,149,106,49,46,11,0,0,0,0,0,149,106,49,46,11,545,12,533
360550138002,36, New York,055, Monroe County,347,140,90,0,50,0,0,0,0,0,347,140,90,0,50,877,0,877
360550138003,36, New York,055, Monroe County,256,138,58,0,80,0,0,0,0,0,256,138,58,0,80,785,76,709
360550138004,36, New York,055, Monroe County,415,248,132,95,21,0,0,0,0,0,415,248,132,95,21,1177,106,1071
360550138005,36, New York,055, Monroe County,241,164,104,0,60,111,102,52,0,50,130,62,52,0,10,725,298,427
360550139011,36, New York,055, Monroe County,173,121,107,0,14,9,9,9,0,0,164,112,98,0,14,941,95,846
360550139012,36, New York,055, Monroe County,245,115,64,24,27,23,23,11,8,4,222,92,53,16,23,816,35,781
360550139013,36, New York,055, Monroe County,455,172,98,5,69,21,10,0,0,10,434,162,98,5,59,1488,67,1421
360550139021,36, New York,055, Monroe County,219,107,40,6,61,43,36,15,0,21,176,71,25,6,40,713,82,631
360550139022,36, New York,055, Monroe County,418,399,191,11,197,83,83,83,0,0,335,316,108,11,197,1205,301,904
360550139023,36, New York,055, Monroe County,244,52,13,34,5,37,5,0,0,5,207,47,13,34,0,1023,222,801
360550140011,36, New York,055, Monroe County,181,84,58,0,26,0,0,0,0,0,181,84,58,0,26,631,13,618
360550140012,36, New York,055, Monroe County,584,251,106,0,145,42,42,18,0,24,542,209,88,0,121,1703,262,1441
360550140013,36, New York,055, Monroe County,176,96,79,17,0,0,0,0,0,0,176,96,79,17,0,485,46,439
360550140014,36, New York,055, Monroe County,224,74,44,0,30,0,0,0,0,0,224,74,44,0,30,710,9,701
360550140031,36, New York,055, Monroe County,326,111,8,60,43,12,12,0,0,12,314,99,8,60,31,741,64,677
360550140032,36, New York,055, Monroe County,265,67,56,0,11,11,11,0,0,11,254,56,56,0,0,763,12,751
360550140033,36, New York,055, Monroe County,252,132,57,44,31,0,0,0,0,0,252,132,57,44,31,1158,55,1103
360550140034,36, New York,055, Monroe County,308,93,61,0,32,20,20,0,0,20,288,73,61,0,12,1067,61,1006
360550140041,36, New York,055, Monroe County,339,223,181,0,42,91,91,91,0,0,248,132,90,0,42,1186,372,814
360550140042,36, New York,055, Monroe County,226,39,15,10,14,10,10,0,10,0,216,29,15,0,14,685,29,656
360550140043,36, New York,055, Monroe County,422,185,79,19,87,86,76,0,0,76,336,109,79,19,11,1178,108,1070
360550141021,36, New York,055, Monroe County,121,50,41,0,9,8,8,8,0,0,113,42,33,0,9,344,47,297
360550141022,36, New York,055, Monroe County,280,65,33,23,9,14,14,10,4,0,266,51,23,19,9,941,60,881
360550141023,36, New York,055, Monroe County,0,0,0,0,0,0,0,0,0,0,0,0,0,0,0,0,0,0
360550141024,36, New York,055, Monroe County,396,179,128,48,3,29,0,0,0,0,367,179,128,48,3,1408,211,1197
360550141031,36, New York,055, Monroe County,453,226,192,0,34,26,26,0,0,26,427,200,192,0,8,1522,138,1384
360550141032,36, New York,055, Monroe County,721,223,120,12,91,53,0,0,0,0,668,223,120,12,91,2093,228,1865
360550141041,36, New York,055, Monroe County,106,22,15,0,7,16,7,0,0,7,90,15,15,0,0,506,116,390
360550141042,36, New York,055, Monroe County,366,173,107,23,43,23,23,0,23,0,343,150,107,0,43,1358,111,1247
360550141043,36, New York,055, Monroe County,123,36,23,0,13,0,0,0,0,0,123,36,23,0,13,315,0,315
360550141044,36, New York,055, Monroe County,176,47,36,11,0,0,0,0,0,0,176,47,36,11,0,513,14,499
360550142021,36, New York,055, Monroe County,770,340,153,64,123,12,12,0,0,12,758,328,153,64,111,2300,109,2191
360550142022,36, New York,055, Monroe County,0,0,0,0,0,0,0,0,0,0,0,0,0,0,0,0,0,0
360550142023,36, New York,055, Monroe County,395,214,197,0,17,55,55,55,0,0,340,159,142,0,17,1378,136,1242
360550142024,36, New York,055, Monroe County,391,75,75,0,0,15,10,10,0,0,376,65,65,0,0,982,49,933
360550142025,36, New York,055, Monroe County,372,48,25,0,23,0,0,0,0,0,372,48,25,0,23,906,11,895
360550142026,36, New York,055, Monroe County,159,14,0,14,0,0,0,0,0,0,159,14,0,14,0,565,12,553
360550142041,36, New York,055, Monroe County,395,171,135,6,30,9,0,0,0,0,386,171,135,6,30,1090,38,1052
360550142042,36, New York,055, Monroe County,278,128,68,11,49,0,0,0,0,0,278,128,68,11,49,711,14,697
360550142051,36, New York,055, Monroe County,314,130,122,0,8,7,7,0,0,7,307,123,122,0,1,923,13,910
360550142052,36, New York,055, Monroe County,469,190,52,102,36,5,0,0,0,0,464,190,52,102,36,1444,44,1400
360550142061,36, New York,055, Monroe County,479,204,204,0,0,0,0,0,0,0,479,204,204,0,0,1382,138,1244
360550142062,36, New York,055, Monroe County,286,190,81,46,63,0,0,0,0,0,286,190,81,46,63,830,4,826
360550142063,36, New York,055, Monroe County,250,45,30,15,0,0,0,0,0,0,250,45,30,15,0,742,39,703
360550143011,36, New York,055, Monroe County,462,105,21,6,78,64,0,0,0,0,398,105,21,6,78,1419,187,1232
360550143012,36, New York,055, Monroe County,396,150,42,0,108,14,14,0,0,14,382,136,42,0,94,1187,100,1087
360550143021,36, New York,055, Monroe County,180,45,24,21,0,0,0,0,0,0,180,45,24,21,0,510,19,491
360550143022,36, New York,055, Monroe County,259,112,15,0,97,59,59,0,0,59,200,53,15,0,38,708,66,642
360550143023,36, New York,055, Monroe County,360,133,86,0,47,0,0,0,0,0,360,133,86,0,47,1236,98,1138
360550143024,36, New York,055, Monroe County,383,140,66,56,18,28,28,28,0,0,355,112,38,56,18,1165,91,1074
360550144001,36, New York,055, Monroe County,166,95,20,30,45,14,14,0,0,14,152,81,20,30,31,542,43,499
360550144002,36, New York,055, Monroe County,485,231,179,31,21,14,14,0,0,14,471,217,179,31,7,1521,67,1454
360550144003,36, New York,055, Monroe County,404,171,171,0,0,18,0,0,0,0,386,171,171,0,0,967,56,911
360550144004,36, New York,055, Monroe County,182,32,25,0,7,0,0,0,0,0,182,32,25,0,7,558,90,468
360550145011,36, New York,055, Monroe County,589,196,175,9,12,22,22,10,0,12,567,174,165,9,0,1480,59,1421
360550145012,36, New York,055, Monroe County,1046,456,162,140,154,18,7,0,0,7,1028,449,162,140,147,2461,70,2391
360550145031,36, New York,055, Monroe County,234,118,43,23,52,13,4,0,0,4,221,114,43,23,48,744,64,680
360550145032,36, New York,055, Monroe County,386,121,113,0,8,16,16,16,0,0,370,105,97,0,8,1217,86,1131
360550145033,36, New York,055, Monroe County,166,39,28,11,0,18,0,0,0,0,148,39,28,11,0,474,51,423
360550145041,36, New York,055, Monroe County,680,300,300,0,0,0,0,0,0,0,680,300,300,0,0,1715,0,1715
360550145042,36, New York,055, Monroe County,275,72,72,0,0,0,0,0,0,0,275,72,72,0,0,715,0,715
360550145043,36, New York,055, Monroe County,311,156,156,0,0,8,0,0,0,0,303,156,156,0,0,757,23,734
360550145044,36, New York,055, Monroe County,482,305,156,43,106,0,0,0,0,0,482,305,156,43,106,1097,33,1064
360550145051,36, New York,055, Monroe County,421,272,125,47,100,28,28,0,28,0,393,244,125,19,100,1117,97,1020
360550145052,36, New York,055, Monroe County,432,132,74,0,58,74,0,0,0,0,358,132,74,0,58,1599,251,1348
360550145053,36, New York,055, Monroe County,266,81,61,0,20,0,0,0,0,0,266,81,61,0,20,822,0,822
360550146011,36, New York,055, Monroe County,564,213,182,31,0,25,0,0,0,0,539,213,182,31,0,1276,59,1217
360550146012,36, New York,055, Monroe County,427,233,202,0,31,0,0,0,0,0,427,233,202,0,31,1175,8,1167
360550146013,36, New York,055, Monroe County,463,270,135,22,113,0,0,0,0,0,463,270,135,22,113,1059,89,970
360550146014,36, New York,055, Monroe County,116,71,60,0,11,6,6,0,0,6,110,65,60,0,5,678,126,552
360550146021,36, New York,055, Monroe County,469,86,66,0,20,0,0,0,0,0,469,86,66,0,20,1401,0,1401
360550146022,36, New York,055, Monroe County,430,114,80,0,34,0,0,0,0,0,430,114,80,0,34,1318,173,1145
360550146023,36, New York,055, Monroe County,413,303,124,43,136,55,55,0,43,12,358,248,124,0,124,1229,251,978
360550147001,36, New York,055, Monroe County,304,99,79,5,15,0,0,0,0,0,304,99,79,5,15,1202,55,1147
360550147002,36, New York,055, Monroe County,257,78,51,10,17,12,12,0,10,2,245,66,51,0,15,848,47,801
360550147003,36, New York,055, Monroe County,196,99,69,0,30,12,12,0,0,12,184,87,69,0,18,651,84,567
360550147004,36, New York,055, Monroe County,172,62,44,18,0,0,0,0,0,0,172,62,44,18,0,515,31,484
360550147005,36, New York,055, Monroe County,253,139,126,8,5,0,0,0,0,0,253,139,126,8,5,728,87,641
360550148021,36, New York,055, Monroe County,689,205,168,0,37,0,0,0,0,0,689,205,168,0,37,1966,180,1786
360550148022,36, New York,055, Monroe County,473,178,128,34,16,17,17,0,17,0,456,161,128,17,16,1326,156,1170
360550148023,36, New York,055, Monroe County,424,101,80,21,0,0,0,0,0,0,424,101,80,21,0,1085,16,1069
360550148031,36, New York,055, Monroe County,271,123,123,0,0,9,0,0,0,0,262,123,123,0,0,677,20,657
360550148032,36, New York,055, Monroe County,329,229,188,20,21,0,0,0,0,0,329,229,188,20,21,764,0,764
360550148033,36, New York,055, Monroe County,567,320,184,103,33,23,23,0,0,23,544,297,184,103,10,1330,36,1294
360550148051,36, New York,055, Monroe County,359,101,101,0,0,0,0,0,0,0,359,101,101,0,0,1096,27,1069
360550148052,36, New York,055, Monroe County,534,411,148,115,148,75,75,6,0,69,459,336,142,115,79,1426,249,1177
360550148061,36, New York,055, Monroe County,432,227,159,49,19,40,10,0,10,0,392,217,159,39,19,970,94,876
360550148062,36, New York,055, Monroe County,501,217,140,37,40,25,25,0,0,25,476,192,140,37,15,1450,103,1347
360550149011,36, New York,055, Monroe County,415,177,95,0,82,24,24,0,0,24,391,153,95,0,58,1042,65,977
360550149012,36, New York,055, Monroe County,158,71,60,11,0,0,0,0,0,0,158,71,60,11,0,397,32,365
360550149013,36, New York,055, Monroe County,628,321,231,46,44,56,44,0,0,44,572,277,231,46,0,1815,80,1735
360550149014,36, New York,055, Monroe County,389,121,44,0,77,9,9,9,0,0,380,112,35,0,77,1014,31,983
360550149031,36, New York,055, Monroe County,326,106,77,17,12,0,0,0,0,0,326,106,77,17,12,1009,36,973
360550149032,36, New York,055, Monroe County,713,323,301,0,22,22,22,0,0,22,691,301,301,0,0,1880,37,1843
360550149033,36, New York,055, Monroe County,191,79,61,0,18,0,0,0,0,0,191,79,61,0,18,619,17,602
360550149034,36, New York,055, Monroe County,254,154,149,5,0,5,5,0,5,0,249,149,149,0,0,746,17,729
360550149051,36, New York,055, Monroe County,404,164,136,7,21,39,39,18,0,21,365,125,118,7,0,1162,62,1100
360550149052,36, New York,055, Monroe County,402,161,112,0,49,28,28,0,0,28,374,133,112,0,21,1130,53,1077
360550149053,36, New York,055, Monroe County,550,238,218,0,20,0,0,0,0,0,550,238,218,0,20,1888,117,1771
360550149061,36, New York,055, Monroe County,495,209,92,28,89,0,0,0,0,0,495,209,92,28,89,1438,55,1383
360550149062,36, New York,055, Monroe County,288,133,69,29,35,41,41,12,29,0,247,92,57,0,35,790,110,680
360550149063,36, New York,055, Monroe County,201,97,60,23,14,0,0,0,0,0,201,97,60,23,14,512,24,488
360550150001,36, New York,055, Monroe County,437,160,160,0,0,0,0,0,0,0,437,160,160,0,0,1291,13,1278
360550150002,36, New York,055, Monroe County,202,93,46,0,47,16,0,0,0,0,186,93,46,0,47,517,32,485
360550150003,36, New York,055, Monroe County,428,200,165,6,29,4,0,0,0,0,424,200,165,6,29,1307,29,1278
360550150004,36, New York,055, Monroe County,232,120,120,0,0,0,0,0,0,0,232,120,120,0,0,641,14,627
360550150005,36, New York,055, Monroe County,145,87,37,38,12,38,38,0,38,0,107,49,37,0,12,377,28,349
360550151011,36, New York,055, Monroe County,811,421,341,16,64,43,37,24,0,13,768,384,317,16,51,2279,131,2148
360550151012,36, New York,055, Monroe County,596,195,179,0,16,30,0,0,0,0,566,195,179,0,16,1710,100,1610
360550151021,36, New York,055, Monroe County,502,128,34,19,75,57,51,0,19,32,445,77,34,0,43,1361,214,1147
360550151022,36, New York,055, Monroe County,189,53,9,28,16,0,0,0,0,0,189,53,9,28,16,653,88,565
360550151023,36, New York,055, Monroe County,388,137,119,5,13,38,5,0,5,0,350,132,119,0,13,986,80,906
360550152001,36, New York,055, Monroe County,641,234,156,23,55,0,0,0,0,0,641,234,156,23,55,1668,60,1608
360550152002,36, New York,055, Monroe County,325,153,100,53,0,16,0,0,0,0,309,153,100,53,0,784,58,726
360550152003,36, New York,055, Monroe County,346,106,47,0,59,116,0,0,0,0,230,106,47,0,59,1038,357,681
360550152004,36, New York,055, Monroe County,596,221,138,52,31,15,15,15,0,0,581,206,123,52,31,1818,65,1753
360550153011,36, New York,055, Monroe County,10,5,5,0,0,0,0,0,0,0,10,5,5,0,0,76,41,35
360550153031,36, New York,055, Monroe County,411,211,110,0,101,39,39,6,0,33,372,172,104,0,68,1461,204,1257
360550153032,36, New York,055, Monroe County,172,133,94,12,27,0,0,0,0,0,172,133,94,12,27,944,229,715
360550153041,36, New York,055, Monroe County,374,51,36,0,15,0,0,0,0,0,374,51,36,0,15,1158,27,1131
360550153042,36, New York,055, Monroe County,279,81,12,13,56,126,52,0,0,52,153,29,12,13,4,873,266,607
360550153043,36, New York,055, Monroe County,135,36,28,0,8,8,8,0,0,8,127,28,28,0,0,1136,419,717
360550154001,36, New York,055, Monroe County,244,101,62,0,39,18,11,0,0,11,226,90,62,0,28,651,87,564
360550154002,36, New York,055, Monroe County,417,135,68,13,54,34,28,0,0,28,383,107,68,13,26,1171,180,991
360550154003,36, New York,055, Monroe County,230,84,41,43,0,0,0,0,0,0,230,84,41,43,0,652,74,578
360550154004,36, New York,055, Monroe County,270,140,92,42,6,0,0,0,0,0,270,140,92,42,6,716,59,657
360559800001,36, New York,055, Monroe County,0,0,0,0,0,0,0,0,0,0,0,0,0,0,0,0,0,0
360559801001,36, New York,055, Monroe County,6,0,0,0,0,0,0,0,0,0,6,0,0,0,0,27,0,27
360559802001,36, New York,055, Monroe County,0,0,0,0,0,0,0,0,0,0,0,0,0,0,0,22,22,0
360559900000,36, New York,055, Monroe County,0,0,0,0,0,0,0,0,0,0,0,0,0,0,0,0,0,0
360191001011,36, New York,019, Clinton County,252,149,116,0,33,0,0,0,0,0,252,149,116,0,33,722,40,682
360191001012,36, New York,019, Clinton County,255,48,36,11,1,15,9,4,4,1,240,39,32,7,0,672,36,636
360191001013,36, New York,019, Clinton County,216,122,61,5,56,5,5,0,5,0,211,117,61,0,56,578,39,539
360191001021,36, New York,019, Clinton County,249,115,90,0,25,17,12,12,0,0,232,103,78,0,25,827,81,746
360191001022,36, New York,019, Clinton County,158,85,48,0,37,61,30,0,0,30,97,55,48,0,7,509,191,318
360191001023,36, New York,019, Clinton County,379,108,103,0,5,27,5,0,0,5,352,103,103,0,0,1042,80,962
360191002001,36, New York,019, Clinton County,428,109,105,0,4,16,0,0,0,0,412,109,105,0,4,1103,72,1031
360191002002,36, New York,019, Clinton County,191,134,79,37,18,26,26,0,26,0,165,108,79,11,18,459,98,361
360191002003,36, New York,019, Clinton County,318,149,133,16,0,22,0,0,0,0,296,149,133,16,0,940,103,837
360191002004,36, New York,019, Clinton County,245,73,58,15,0,0,0,0,0,0,245,73,58,15,0,638,27,611
360191006001,36, New York,019, Clinton County,482,313,240,20,53,53,53,0,0,53,429,260,240,20,0,1113,53,1060
360191006002,36, New York,019, Clinton County,206,126,73,0,53,36,30,30,0,0,170,96,43,0,53,728,119,609
360191006003,36, New York,019, Clinton County,372,49,12,14,23,0,0,0,0,0,372,49,12,14,23,1010,41,969
360191006004,36, New York,019, Clinton County,186,112,99,13,0,0,0,0,0,0,186,112,99,13,0,436,0,436
360191006005,36, New York,019, Clinton County,277,106,81,9,16,13,0,0,0,0,264,106,81,9,16,760,26,734
360191007001,36, New York,019, Clinton County,556,215,168,25,22,9,0,0,0,0,547,215,168,25,22,1317,36,1281
360191007002,36, New York,019, Clinton County,323,82,72,10,0,0,0,0,0,0,323,82,72,10,0,894,19,875
360191007003,36, New York,019, Clinton County,269,152,103,0,49,32,21,0,0,21,237,131,103,0,28,773,52,721
360191008001,36, New York,019, Clinton County,281,68,43,0,25,50,9,9,0,0,231,59,34,0,25,707,106,601
360191008002,36, New York,019, Clinton County,265,87,52,2,33,16,16,0,0,16,249,71,52,2,17,746,65,681
360191008003,36, New York,019, Clinton County,410,63,52,0,11,12,12,12,0,0,398,51,40,0,11,944,39,905
360191008004,36, New York,019, Clinton County,240,35,26,9,0,0,0,0,0,0,240,35,26,9,0,619,17,602
360191008005,36, New York,019, Clinton County,218,57,57,0,0,0,0,0,0,0,218,57,57,0,0,587,8,579
360191009011,36, New York,019, Clinton County,146,25,3,22,0,0,0,0,0,0,146,25,3,22,0,792,213,579
360191009012,36, New York,019, Clinton County,237,183,65,69,49,45,45,45,0,0,192,138,20,69,49,916,275,641
360191009013,36, New York,019, Clinton County,187,101,77,15,9,0,0,0,0,0,187,101,77,15,9,502,99,403
360191009021,36, New York,019, Clinton County,376,153,94,0,59,0,0,0,0,0,376,153,94,0,59,1068,37,1031
360191009022,36, New York,019, Clinton County,10,0,0,0,0,0,0,0,0,0,10,0,0,0,0,579,102,477
360191010001,36, New York,019, Clinton County,187,95,73,0,22,40,29,7,0,22,147,66,66,0,0,500,71,429
360191010002,36, New York,019, Clinton County,163,81,81,0,0,0,0,0,0,0,163,81,81,0,0,507,0,507
360191010003,36, New York,019, Clinton County,233,62,20,32,10,0,0,0,0,0,233,62,20,32,10,915,57,858
360191010004,36, New York,019, Clinton County,163,64,55,0,9,0,0,0,0,0,163,64,55,0,9,564,80,484
360191010005,36, New York,019, Clinton County,336,98,50,48,0,0,0,0,0,0,336,98,50,48,0,916,62,854
360191016001,36, New York,019, Clinton County,393,189,52,7,130,83,72,0,0,72,310,117,52,7,58,1203,223,980
360191019011,36, New York,019, Clinton County,385,112,86,0,26,0,0,0,0,0,385,112,86,0,26,1389,48,1341
360191019012,36, New York,019, Clinton County,407,154,140,0,14,26,26,12,0,14,381,128,128,0,0,1153,72,1081
360191019013,36, New York,019, Clinton County,311,203,175,16,12,0,0,0,0,0,311,203,175,16,12,807,18,789
360191019014,36, New York,019, Clinton County,360,184,149,16,19,19,19,0,0,19,341,165,149,16,0,745,94,651
360191019021,36, New York,019, Clinton County,340,175,132,3,40,40,40,0,0,40,300,135,132,3,0,784,73,711
360191021001,36, New York,019, Clinton County,315,142,117,8,17,0,0,0,0,0,315,142,117,8,17,788,47,741
360191021002,36, New York,019, Clinton County,219,97,12,43,42,73,73,0,38,35,146,24,12,5,7,581,103,478
360191022001,36, New York,019, Clinton County,95,31,0,0,31,22,0,0,0,0,73,31,0,0,31,574,121,453
360191022002,36, New York,019, Clinton County,249,184,59,21,104,72,72,18,0,54,177,112,41,21,50,592,163,429
360191022003,36, New York,019, Clinton County,298,262,36,8,218,168,168,0,0,168,130,94,36,8,50,682,259,423
360191022004,36, New York,019, Clinton County,90,26,26,0,0,0,0,0,0,0,90,26,26,0,0,410,0,410
360191028001,36, New York,019, Clinton County,230,122,91,15,16,15,15,0,15,0,215,107,91,0,16,581,40,541
360191028002,36, New York,019, Clinton County,248,157,135,0,22,9,9,0,0,9,239,148,135,0,13,1135,47,1088
360191028003,36, New York,019, Clinton County,221,95,71,12,12,26,12,0,0,12,195,83,71,12,0,725,107,618
360191028004,36, New York,019, Clinton County,29,14,14,0,0,0,0,0,0,0,29,14,14,0,0,135,0,135
360191030001,36, New York,019, Clinton County,0,0,0,0,0,0,0,0,0,0,0,0,0,0,0,0,0,0
360191031001,36, New York,019, Clinton County,43,18,0,18,0,11,0,0,0,0,32,18,0,18,0,372,166,206
360191031002,36, New York,019, Clinton County,149,106,31,25,50,16,16,16,0,0,133,90,15,25,50,964,447,517
360191031003,36, New York,019, Clinton County,168,56,12,16,28,56,28,0,0,28,112,28,12,16,0,1050,657,393
360191032001,36, New York,019, Clinton County,231,89,29,31,29,0,0,0,0,0,231,89,29,31,29,617,16,601
360191032002,36, New York,019, Clinton County,68,51,0,0,51,42,42,0,0,42,26,9,0,0,9,509,220,289
360191032003,36, New York,019, Clinton County,189,107,99,0,8,0,0,0,0,0,189,107,99,0,8,563,23,540
360191035121,36, New York,019, Clinton County,152,72,38,0,34,23,23,0,0,23,129,49,38,0,11,436,71,365
360191035122,36, New York,019, Clinton County,0,0,0,0,0,0,0,0,0,0,0,0,0,0,0,0,0,0
360191035123,36, New York,019, Clinton County,192,78,47,0,31,24,24,5,0,19,168,54,42,0,12,515,54,461
360191035124,36, New York,019, Clinton County,432,148,93,24,31,29,10,10,0,0,403,138,83,24,31,1245,163,1082
360191035125,36, New York,019, Clinton County,265,109,81,5,23,25,22,7,0,15,240,87,74,5,8,753,91,662
360191035126,36, New York,019, Clinton County,162,48,32,13,3,25,3,3,0,0,137,45,29,13,3,464,97,367
360191038001,36, New York,019, Clinton County,76,43,43,0,0,18,0,0,0,0,58,43,43,0,0,176,34,142
360191038002,36, New York,019, Clinton County,345,130,52,65,13,84,65,0,65,0,261,65,52,0,13,838,206,632
360191038003,36, New York,019, Clinton County,212,96,85,0,11,3,3,0,0,3,209,93,85,0,8,870,83,787
360191038004,36, New York,019, Clinton County,119,38,32,2,4,2,2,0,2,0,117,36,32,0,4,555,28,527
360191038005,36, New York,019, Clinton County,250,59,37,4,18,9,6,0,0,6,241,53,37,4,12,767,71,696
360191038006,36, New York,019, Clinton County,434,219,186,0,33,0,0,0,0,0,434,219,186,0,33,1131,0,1131
360191039001,36, New York,019, Clinton County,277,151,33,0,118,0,0,0,0,0,277,151,33,0,118,850,105,745
360191039002,36, New York,019, Clinton County,204,84,84,0,0,15,0,0,0,0,189,84,84,0,0,470,30,440
360191039003,36, New York,019, Clinton County,410,197,151,0,46,13,13,0,0,13,397,184,151,0,33,1074,41,1033
360191039004,36, New York,019, Clinton County,435,141,106,4,31,35,35,0,4,31,400,106,106,0,0,1267,43,1224
360191039005,36, New York,019, Clinton County,193,83,72,11,0,13,0,0,0,0,180,83,72,11,0,608,68,540
360191042001,36, New York,019, Clinton County,303,161,98,28,35,6,6,6,0,0,297,155,92,28,35,1047,219,828
360191042002,36, New York,019, Clinton County,293,149,64,61,24,72,72,0,61,11,221,77,64,0,13,752,100,652
360191042003,36, New York,019, Clinton County,323,129,129,0,0,0,0,0,0,0,323,129,129,0,0,934,14,920
360191042004,36, New York,019, Clinton County,261,106,36,33,37,48,44,0,7,37,213,62,36,26,0,669,166,503
360191042005,36, New York,019, Clinton County,301,112,83,0,29,36,12,7,0,5,265,100,76,0,24,855,157,698
360239701001,36, New York,023, Cortland County,188,75,61,4,10,27,19,15,0,4,161,56,46,4,6,739,73,666
360239701002,36, New York,023, Cortland County,174,66,43,10,13,12,10,0,0,10,162,56,43,10,3,600,76,524
360239701003,36, New York,023, Cortland County,261,82,46,20,16,11,7,0,0,7,250,75,46,20,9,732,45,687
360239701004,36, New York,023, Cortland County,191,70,32,17,21,10,2,0,0,2,181,68,32,17,19,601,42,559
360239702011,36, New York,023, Cortland County,298,135,35,59,41,32,29,3,3,23,266,106,32,56,18,720,81,639
360239702012,36, New York,023, Cortland County,126,30,9,2,19,4,4,2,2,0,122,26,7,0,19,391,24,367
360239702013,36, New York,023, Cortland County,279,78,75,3,0,3,0,0,0,0,276,78,75,3,0,723,18,705
360239702021,36, New York,023, Cortland County,376,149,73,0,76,56,39,0,0,39,320,110,73,0,37,851,110,741
360239702022,36, New York,023, Cortland County,672,288,288,0,0,20,0,0,0,0,652,288,288,0,0,1675,59,1616
360239703001,36, New York,023, Cortland County,190,65,48,6,11,0,0,0,0,0,190,65,48,6,11,487,14,473
360239703002,36, New York,023, Cortland County,264,114,100,0,14,0,0,0,0,0,264,114,100,0,14,698,8,690
360239703003,36, New York,023, Cortland County,271,120,98,0,22,0,0,0,0,0,271,120,98,0,22,698,6,692
360239703004,36, New York,023, Cortland County,193,67,59,0,8,0,0,0,0,0,193,67,59,0,8,556,10,546
360239704001,36, New York,023, Cortland County,290,148,63,31,54,26,4,0,4,0,264,144,63,27,54,730,47,683
360239704002,36, New York,023, Cortland County,253,147,99,23,25,18,4,4,0,0,235,143,95,23,25,775,62,713
360239704003,36, New York,023, Cortland County,186,29,16,6,7,7,0,0,0,0,179,29,16,6,7,501,20,481
360239705001,36, New York,023, Cortland County,341,213,100,48,65,58,58,16,0,42,283,155,84,48,23,917,157,760
360239705002,36, New York,023, Cortland County,168,115,89,0,26,9,9,0,0,9,159,106,89,0,17,507,65,442
360239705003,36, New York,023, Cortland County,192,149,64,0,85,48,43,0,0,43,144,106,64,0,42,910,395,515
360239705004,36, New York,023, Cortland County,187,153,69,52,32,24,24,0,17,7,163,129,69,35,25,668,225,443
360239706001,36, New York,023, Cortland County,213,169,32,73,64,64,64,0,0,64,149,105,32,73,0,931,282,649
360239706002,36, New York,023, Cortland County,108,19,0,19,0,31,12,0,12,0,77,7,0,7,0,571,135,436
360239706003,36, New York,023, Cortland County,90,34,10,0,24,24,24,0,0,24,66,10,10,0,0,340,95,245
360239706004,36, New York,023, Cortland County,79,65,11,28,26,13,13,0,0,13,66,52,11,28,13,356,59,297
360239707001,36, New York,023, Cortland County,215,51,51,0,0,0,0,0,0,0,215,51,51,0,0,670,16,654
360239707002,36, New York,023, Cortland County,213,47,41,6,0,0,0,0,0,0,213,47,41,6,0,694,21,673
360239707003,36, New York,023, Cortland County,114,39,32,0,7,0,0,0,0,0,114,39,32,0,7,531,214,317
360239707004,36, New York,023, Cortland County,296,189,149,16,24,8,8,0,0,8,288,181,149,16,16,875,118,757
360239707005,36, New York,023, Cortland County,50,18,18,0,0,0,0,0,0,0,50,18,18,0,0,414,244,170
360239708001,36, New York,023, Cortland County,40,9,2,0,7,13,0,0,0,0,27,9,2,0,7,160,21,139
360239709001,36, New York,023, Cortland County,405,293,162,0,131,27,27,0,0,27,378,266,162,0,104,1168,146,1022
360239709002,36, New York,023, Cortland County,121,32,12,15,5,25,15,0,15,0,96,17,12,0,5,696,158,538
360239709003,36, New York,023, Cortland County,145,52,25,6,21,0,0,0,0,0,145,52,25,6,21,1048,318,730
360239709004,36, New York,023, Cortland County,251,105,38,35,32,12,12,0,0,12,239,93,38,35,20,727,127,600
360239710001,36, New York,023, Cortland County,295,219,91,0,128,0,0,0,0,0,295,219,91,0,128,642,47,595
360239710002,36, New York,023, Cortland County,240,95,95,0,0,15,0,0,0,0,225,95,95,0,0,712,54,658
360239710003,36, New York,023, Cortland County,302,137,121,0,16,0,0,0,0,0,302,137,121,0,16,838,24,814
360239710004,36, New York,023, Cortland County,321,169,169,0,0,29,0,0,0,0,292,169,169,0,0,796,117,679
360239710005,36, New York,023, Cortland County,232,57,41,16,0,0,0,0,0,0,232,57,41,16,0,937,131,806
360239711001,36, New York,023, Cortland County,461,214,120,87,7,43,15,11,2,2,418,199,109,85,5,1234,124,1110
360239711002,36, New York,023, Cortland County,242,110,79,10,21,30,28,16,0,12,212,82,63,10,9,726,119,607
360239711003,36, New York,023, Cortland County,306,180,146,5,29,18,9,9,0,0,288,171,137,5,29,837,72,765
360239711004,36, New York,023, Cortland County,295,132,65,48,19,3,0,0,0,0,292,132,65,48,19,815,61,754
360239712001,36, New York,023, Cortland County,236,103,95,2,6,20,19,15,0,4,216,84,80,2,2,643,64,579
360239712002,36, New York,023, Cortland County,256,64,51,9,4,19,19,17,0,2,237,45,34,9,2,662,53,609
360239712003,36, New York,023, Cortland County,266,88,59,21,8,34,17,9,0,8,232,71,50,21,0,739,106,633
360239712004,36, New York,023, Cortland County,428,246,163,61,22,8,0,0,0,0,420,246,163,61,22,1150,73,1077
360593001001,36, New York,059, Nassau County,302,154,142,0,12,0,0,0,0,0,302,154,142,0,12,860,0,860
360593001002,36, New York,059, Nassau County,305,148,135,0,13,0,0,0,0,0,305,148,135,0,13,779,10,769
360593001003,36, New York,059, Nassau County,264,104,21,0,83,0,0,0,0,0,264,104,21,0,83,759,0,759
360593001004,36, New York,059, Nassau County,307,171,171,0,0,0,0,0,0,0,307,171,171,0,0,884,81,803
360593003001,36, New York,059, Nassau County,399,247,202,0,45,65,65,33,0,32,334,182,169,0,13,835,185,650
360593003002,36, New York,059, Nassau County,268,134,122,0,12,0,0,0,0,0,268,134,122,0,12,709,9,700
360593003003,36, New York,059, Nassau County,202,129,129,0,0,0,0,0,0,0,202,129,129,0,0,431,10,421
360593003004,36, New York,059, Nassau County,251,25,25,0,0,0,0,0,0,0,251,25,25,0,0,515,11,504
360593004001,36, New York,059, Nassau County,393,242,198,0,44,44,44,0,0,44,349,198,198,0,0,894,113,781
360593004002,36, New York,059, Nassau County,355,212,177,0,35,0,0,0,0,0,355,212,177,0,35,1021,0,1021
360593004003,36, New York,059, Nassau County,287,124,94,0,30,0,0,0,0,0,287,124,94,0,30,775,38,737
360593004004,36, New York,059, Nassau County,225,102,97,0,5,39,39,39,0,0,186,63,58,0,5,601,34,567
360593004005,36, New York,059, Nassau County,294,226,226,0,0,22,0,0,0,0,272,226,226,0,0,519,43,476
360593005001,36, New York,059, Nassau County,291,205,198,7,0,21,21,21,0,0,270,184,177,7,0,751,42,709
360593005002,36, New York,059, Nassau County,185,62,61,1,0,0,0,0,0,0,185,62,61,1,0,513,25,488
360593005003,36, New York,059, Nassau County,257,112,95,10,7,6,0,0,0,0,251,112,95,10,7,621,18,603
360593005004,36, New York,059, Nassau County,472,224,113,0,111,92,92,0,0,92,380,132,113,0,19,1017,36,981
360593005005,36, New York,059, Nassau County,420,190,185,0,5,5,5,0,0,5,415,185,185,0,0,1049,11,1038
360593006001,36, New York,059, Nassau County,163,44,27,17,0,35,0,0,0,0,128,44,27,17,0,538,208,330
360593006002,36, New York,059, Nassau County,302,125,125,0,0,38,0,0,0,0,264,125,125,0,0,824,100,724
360593006003,36, New York,059, Nassau County,218,106,102,0,4,4,4,0,0,4,214,102,102,0,0,680,4,676
360593006004,36, New York,059, Nassau County,176,113,94,0,19,5,5,5,0,0,171,108,89,0,19,413,46,367
360593006005,36, New York,059, Nassau County,477,207,194,4,9,8,8,8,0,0,469,199,186,4,9,1130,35,1095
360593006006,36, New York,059, Nassau County,405,158,137,3,18,3,3,3,0,0,402,155,134,3,18,1034,64,970
360593007001,36, New York,059, Nassau County,256,130,111,0,19,0,0,0,0,0,256,130,111,0,19,737,100,637
360593007002,36, New York,059, Nassau County,212,95,74,0,21,0,0,0,0,0,212,95,74,0,21,630,24,606
360593007003,36, New York,059, Nassau County,440,166,56,0,110,0,0,0,0,0,440,166,56,0,110,1443,0,1443
360593007004,36, New York,059, Nassau County,316,142,67,0,75,25,25,0,0,25,291,117,67,0,50,690,19,671
360593007005,36, New York,059, Nassau County,302,131,131,0,0,0,0,0,0,0,302,131,131,0,0,1194,57,1137
360593008001,36, New York,059, Nassau County,206,61,61,0,0,0,0,0,0,0,206,61,61,0,0,637,0,637
360593008002,36, New York,059, Nassau County,230,98,76,22,0,50,42,20,22,0,180,56,56,0,0,487,95,392
360593008003,36, New York,059, Nassau County,216,70,45,15,10,0,0,0,0,0,216,70,45,15,10,526,0,526
360593008004,36, New York,059, Nassau County,482,217,169,0,48,15,6,6,0,0,467,211,163,0,48,1389,42,1347
360593009011,36, New York,059, Nassau County,182,103,94,5,4,5,5,5,0,0,177,98,89,5,4,438,14,424
360593009012,36, New York,059, Nassau County,255,151,140,0,11,0,0,0,0,0,255,151,140,0,11,608,6,602
360593009013,36, New York,059, Nassau County,235,160,138,16,6,5,5,5,0,0,230,155,133,16,6,580,12,568
360593009021,36, New York,059, Nassau County,879,355,313,0,42,0,0,0,0,0,879,355,313,0,42,2013,58,1955
360593009022,36, New York,059, Nassau County,941,243,225,18,0,26,26,26,0,0,915,217,199,18,0,2264,41,2223
360593010001,36, New York,059, Nassau County,451,278,267,0,11,35,22,11,0,11,416,256,256,0,0,1033,54,979
360593010002,36, New York,059, Nassau County,456,117,117,0,0,0,0,0,0,0,456,117,117,0,0,1226,5,1221
360593010003,36, New York,059, Nassau County,358,157,132,11,14,5,0,0,0,0,353,157,132,11,14,932,24,908
360593010004,36, New York,059, Nassau County,222,125,100,25,0,4,0,0,0,0,218,125,100,25,0,513,7,506
360593011011,36, New York,059, Nassau County,614,453,421,0,32,0,0,0,0,0,614,453,421,0,32,1598,4,1594
360593011012,36, New York,059, Nassau County,757,222,176,46,0,132,0,0,0,0,625,222,176,46,0,1679,397,1282
360593011013,36, New York,059, Nassau County,518,167,41,23,103,0,0,0,0,0,518,167,41,23,103,1202,52,1150
360593011021,36, New York,059, Nassau County,313,207,189,0,18,8,0,0,0,0,305,207,189,0,18,725,16,709
360593011022,36, New York,059, Nassau County,527,213,182,10,21,12,0,0,0,0,515,213,182,10,21,1743,97,1646
360593011023,36, New York,059, Nassau County,501,250,250,0,0,22,22,22,0,0,479,228,228,0,0,1086,60,1026
360593012001,36, New York,059, Nassau County,453,212,212,0,0,0,0,0,0,0,453,212,212,0,0,1257,8,1249
360593012002,36, New York,059, Nassau County,330,100,79,21,0,0,0,0,0,0,330,100,79,21,0,1133,75,1058
360593012003,36, New York,059, Nassau County,324,147,130,3,14,0,0,0,0,0,324,147,130,3,14,770,2,768
360593012004,36, New York,059, Nassau County,352,182,182,0,0,0,0,0,0,0,352,182,182,0,0,799,0,799
360593012005,36, New York,059, Nassau County,275,99,84,0,15,0,0,0,0,0,275,99,84,0,15,682,29,653
360593013001,36, New York,059, Nassau County,436,213,109,9,95,41,41,0,0,41,395,172,109,9,54,1043,64,979
360593013002,36, New York,059, Nassau County,193,54,54,0,0,0,0,0,0,0,193,54,54,0,0,487,18,469
360593013003,36, New York,059, Nassau County,163,50,50,0,0,0,0,0,0,0,163,50,50,0,0,459,39,420
360593013004,36, New York,059, Nassau County,309,201,167,14,20,26,26,6,0,20,283,175,161,14,0,824,24,800
360593013005,36, New York,059, Nassau County,265,161,161,0,0,0,0,0,0,0,265,161,161,0,0,572,43,529
360593014001,36, New York,059, Nassau County,362,208,189,6,13,5,0,0,0,0,357,208,189,6,13,800,9,791
360593014002,36, New York,059, Nassau County,233,138,128,0,10,0,0,0,0,0,233,138,128,0,10,621,9,612
360593015001,36, New York,059, Nassau County,200,74,74,0,0,16,3,3,0,0,184,71,71,0,0,509,40,469
360593015002,36, New York,059, Nassau County,375,181,165,0,16,17,14,0,0,14,358,167,165,0,2,910,19,891
360593015003,36, New York,059, Nassau County,285,140,127,5,8,0,0,0,0,0,285,140,127,5,8,653,5,648
360593016001,36, New York,059, Nassau County,363,220,207,9,4,27,0,0,0,0,336,220,207,9,4,883,89,794
360593016002,36, New York,059, Nassau County,312,98,90,0,8,31,8,0,0,8,281,90,90,0,0,696,54,642
360593016003,36, New York,059, Nassau County,295,152,144,0,8,0,0,0,0,0,295,152,144,0,8,677,0,677
360593016004,36, New York,059, Nassau County,451,170,148,22,0,0,0,0,0,0,451,170,148,22,0,1197,32,1165
360593017001,36, New York,059, Nassau County,396,217,200,0,17,17,17,0,0,17,379,200,200,0,0,836,6,830
360593017002,36, New York,059, Nassau County,386,235,224,5,6,16,16,16,0,0,370,219,208,5,6,977,37,940
360593018001,36, New York,059, Nassau County,172,100,100,0,0,0,0,0,0,0,172,100,100,0,0,346,0,346
360593018002,36, New York,059, Nassau County,101,46,24,0,22,0,0,0,0,0,101,46,24,0,22,425,29,396
360593018003,36, New York,059, Nassau County,221,134,79,12,43,43,43,0,0,43,178,91,79,12,0,545,62,483
360593018004,36, New York,059, Nassau County,148,68,45,16,7,0,0,0,0,0,148,68,45,16,7,359,0,359
360593018005,36, New York,059, Nassau County,453,238,159,0,79,45,34,0,0,34,408,204,159,0,45,1475,88,1387
360593019001,36, New York,059, Nassau County,386,197,187,10,0,0,0,0,0,0,386,197,187,10,0,949,12,937
360593019002,36, New York,059, Nassau County,299,151,140,0,11,0,0,0,0,0,299,151,140,0,11,673,0,673
360593019003,36, New York,059, Nassau County,190,73,65,0,8,0,0,0,0,0,190,73,65,0,8,492,10,482
360593020001,36, New York,059, Nassau County,310,130,110,0,20,21,21,18,0,3,289,109,92,0,17,796,46,750
360593020002,36, New York,059, Nassau County,423,149,104,0,45,0,0,0,0,0,423,149,104,0,45,1501,75,1426
360593020003,36, New York,059, Nassau County,573,191,160,12,19,19,19,0,12,7,554,172,160,0,12,1710,133,1577
360593021011,36, New York,059, Nassau County,247,150,150,0,0,0,0,0,0,0,247,150,150,0,0,602,0,602
360593021012,36, New York,059, Nassau County,285,122,95,27,0,0,0,0,0,0,285,122,95,27,0,912,0,912
360593021013,36, New York,059, Nassau County,149,48,36,0,12,0,0,0,0,0,149,48,36,0,12,460,21,439
360593021014,36, New York,059, Nassau County,444,187,178,0,9,0,0,0,0,0,444,187,178,0,9,1235,0,1235
360593021021,36, New York,059, Nassau County,240,72,69,3,0,0,0,0,0,0,240,72,69,3,0,612,3,609
360593021022,36, New York,059, Nassau County,316,124,124,0,0,0,0,0,0,0,316,124,124,0,0,824,9,815
360593021023,36, New York,059, Nassau County,149,48,48,0,0,0,0,0,0,0,149,48,48,0,0,434,55,379
360593021024,36, New York,059, Nassau County,268,190,157,16,17,0,0,0,0,0,268,190,157,16,17,648,35,613
360593022001,36, New York,059, Nassau County,350,193,181,12,0,6,6,6,0,0,344,187,175,12,0,998,7,991
360593022002,36, New York,059, Nassau County,265,191,133,0,58,10,10,0,0,10,255,181,133,0,48,606,17,589
360593022003,36, New York,059, Nassau County,272,208,208,0,0,0,0,0,0,0,272,208,208,0,0,639,24,615
360593022004,36, New York,059, Nassau County,214,131,97,0,34,18,18,0,0,18,196,113,97,0,16,493,47,446
360593023001,36, New York,059, Nassau County,484,161,161,0,0,8,0,0,0,0,476,161,161,0,0,1163,8,1155
360593023002,36, New York,059, Nassau County,540,250,240,0,10,23,0,0,0,0,517,250,240,0,10,1428,44,1384
360593023003,36, New York,059, Nassau County,428,176,149,0,27,0,0,0,0,0,428,176,149,0,27,1065,7,1058
360593024001,36, New York,059, Nassau County,363,163,163,0,0,0,0,0,0,0,363,163,163,0,0,816,6,810
360593024002,36, New York,059, Nassau County,230,85,85,0,0,0,0,0,0,0,230,85,85,0,0,955,0,955
360593024003,36, New York,059, Nassau County,238,85,85,0,0,0,0,0,0,0,238,85,85,0,0,678,0,678
360593024004,36, New York,059, Nassau County,226,56,56,0,0,10,0,0,0,0,216,56,56,0,0,696,20,676
360593024005,36, New York,059, Nassau County,283,68,58,10,0,7,0,0,0,0,276,68,58,10,0,866,14,852
360593025011,36, New York,059, Nassau County,359,189,189,0,0,8,0,0,0,0,351,189,189,0,0,800,16,784
360593025012,36, New York,059, Nassau County,419,200,187,0,13,14,14,14,0,0,405,186,173,0,13,1169,65,1104
360593025021,36, New York,059, Nassau County,357,176,162,14,0,14,14,0,14,0,343,162,162,0,0,1147,63,1084
360593025022,36, New York,059, Nassau County,285,65,65,0,0,9,0,0,0,0,276,65,65,0,0,1055,46,1009
360593026001,36, New York,059, Nassau County,244,156,135,9,12,0,0,0,0,0,244,156,135,9,12,860,6,854
360593026002,36, New York,059, Nassau County,373,158,143,0,15,0,0,0,0,0,373,158,143,0,15,908,22,886
360593027001,36, New York,059, Nassau County,308,70,51,6,13,0,0,0,0,0,308,70,51,6,13,1044,12,1032
360593027002,36, New York,059, Nassau County,425,180,142,0,38,8,8,8,0,0,417,172,134,0,38,1201,35,1166
360593027003,36, New York,059, Nassau County,340,85,73,12,0,21,10,10,0,0,319,75,63,12,0,1078,62,1016
360593028001,36, New York,059, Nassau County,163,48,48,0,0,0,0,0,0,0,163,48,48,0,0,490,0,490
360593028002,36, New York,059, Nassau County,140,0,0,0,0,0,0,0,0,0,140,0,0,0,0,278,0,278
360593028003,36, New York,059, Nassau County,161,98,98,0,0,0,0,0,0,0,161,98,98,0,0,523,0,523
360593028004,36, New York,059, Nassau County,302,61,61,0,0,0,0,0,0,0,302,61,61,0,0,939,15,924
360593028005,36, New York,059, Nassau County,204,179,164,0,15,0,0,0,0,0,204,179,164,0,15,614,0,614
360593028006,36, New York,059, Nassau County,205,62,62,0,0,0,0,0,0,0,205,62,62,0,0,668,0,668
360593028007,36, New York,059, Nassau County,423,122,105,17,0,16,0,0,0,0,407,122,105,17,0,1056,50,1006
360593029001,36, New York,059, Nassau County,288,139,139,0,0,8,0,0,0,0,280,139,139,0,0,849,16,833
360593029002,36, New York,059, Nassau County,317,107,78,29,0,11,11,11,0,0,306,96,67,29,0,754,28,726
360593029003,36, New York,059, Nassau County,356,157,157,0,0,25,0,0,0,0,331,157,157,0,0,954,100,854
360593029004,36, New York,059, Nassau County,351,86,64,0,22,0,0,0,0,0,351,86,64,0,22,838,0,838
360593030001,36, New York,059, Nassau County,278,122,122,0,0,5,0,0,0,0,273,122,122,0,0,896,10,886
360593030002,36, New York,059, Nassau County,362,213,172,30,11,0,0,0,0,0,362,213,172,30,11,833,40,793
360593030003,36, New York,059, Nassau County,158,72,60,12,0,0,0,0,0,0,158,72,60,12,0,448,0,448
360593030004,36, New York,059, Nassau County,564,214,203,0,11,10,10,10,0,0,554,204,193,0,11,1332,47,1285
360593030005,36, New York,059, Nassau County,224,152,111,0,41,30,30,0,0,30,194,122,111,0,11,577,51,526
360593031011,36, New York,059, Nassau County,360,166,103,18,45,13,0,0,0,0,347,166,103,18,45,962,105,857
360593031012,36, New York,059, Nassau County,311,139,135,4,0,4,4,0,4,0,307,135,135,0,0,747,0,747
360593031013,36, New York,059, Nassau County,418,60,60,0,0,5,5,5,0,0,413,55,55,0,0,1361,5,1356
360593031021,36, New York,059, Nassau County,247,111,103,0,8,0,0,0,0,0,247,111,103,0,8,857,12,845
360593031022,36, New York,059, Nassau County,323,105,68,0,37,0,0,0,0,0,323,105,68,0,37,818,0,818
360593031023,36, New York,059, Nassau County,316,140,140,0,0,40,20,20,0,0,276,120,120,0,0,819,116,703
360593031024,36, New York,059, Nassau County,257,76,76,0,0,23,0,0,0,0,234,76,76,0,0,668,46,622
360593032031,36, New York,059, Nassau County,534,225,180,34,11,0,0,0,0,0,534,225,180,34,11,1267,0,1267
360593032032,36, New York,059, Nassau County,380,203,188,0,15,0,0,0,0,0,380,203,188,0,15,898,7,891
360593032041,36, New York,059, Nassau County,289,135,106,12,17,0,0,0,0,0,289,135,106,12,17,949,31,918
360593032042,36, New York,059, Nassau County,181,95,95,0,0,0,0,0,0,0,181,95,95,0,0,500,8,492
360593032043,36, New York,059, Nassau County,283,112,112,0,0,11,0,0,0,0,272,112,112,0,0,730,29,701
360593032044,36, New York,059, Nassau County,387,215,215,0,0,7,7,7,0,0,380,208,208,0,0,1231,29,1202
360593033011,36, New York,059, Nassau County,202,92,92,0,0,20,9,9,0,0,182,83,83,0,0,621,23,598
360593033012,36, New York,059, Nassau County,326,195,195,0,0,0,0,0,0,0,326,195,195,0,0,851,24,827
360593033013,36, New York,059, Nassau County,170,96,96,0,0,11,0,0,0,0,159,96,96,0,0,435,32,403
360593033021,36, New York,059, Nassau County,323,101,101,0,0,0,0,0,0,0,323,101,101,0,0,812,10,802
360593033022,36, New York,059, Nassau County,473,302,264,28,10,0,0,0,0,0,473,302,264,28,10,1175,0,1175
360593033023,36, New York,059, Nassau County,214,89,76,0,13,0,0,0,0,0,214,89,76,0,13,522,0,522
360593033024,36, New York,059, Nassau County,243,83,83,0,0,0,0,0,0,0,243,83,83,0,0,802,6,796
360593034001,36, New York,059, Nassau County,447,236,224,0,12,20,0,0,0,0,427,236,224,0,12,1124,22,1102
360593034002,36, New York,059, Nassau County,292,124,107,0,17,0,0,0,0,0,292,124,107,0,17,778,6,772
360593035001,36, New York,059, Nassau County,247,131,92,21,18,0,0,0,0,0,247,131,92,21,18,452,0,452
360593035002,36, New York,059, Nassau County,165,108,88,0,20,0,0,0,0,0,165,108,88,0,20,560,23,537
360593035003,36, New York,059, Nassau County,186,61,61,0,0,0,0,0,0,0,186,61,61,0,0,506,0,506
360593035004,36, New York,059, Nassau County,341,149,149,0,0,0,0,0,0,0,341,149,149,0,0,942,22,920
360593035005,36, New York,059, Nassau County,402,159,143,0,16,11,0,0,0,0,391,159,143,0,16,1086,22,1064
360593035006,36, New York,059, Nassau County,166,87,68,19,0,19,19,0,19,0,147,68,68,0,0,581,68,513
360593036001,36, New York,059, Nassau County,213,108,89,0,19,19,19,0,0,19,194,89,89,0,0,357,19,338
360593036002,36, New York,059, Nassau County,280,19,0,0,19,36,19,0,0,19,244,0,0,0,0,759,135,624
360593036003,36, New York,059, Nassau County,188,59,22,0,37,28,0,0,0,0,160,59,22,0,37,947,157,790
360593036004,36, New York,059, Nassau County,381,85,26,0,59,0,0,0,0,0,381,85,26,0,59,1251,32,1219
360593036005,36, New York,059, Nassau County,340,280,266,0,14,0,0,0,0,0,340,280,266,0,14,913,79,834
360593036006,36, New York,059, Nassau County,332,180,74,100,6,30,30,0,30,0,302,150,74,70,6,1324,26,1298
360593037001,36, New York,059, Nassau County,425,221,221,0,0,0,0,0,0,0,425,221,221,0,0,1082,0,1082
360593037002,36, New York,059, Nassau County,266,108,108,0,0,0,0,0,0,0,266,108,108,0,0,646,0,646
360593037003,36, New York,059, Nassau County,594,100,100,0,0,0,0,0,0,0,594,100,100,0,0,1784,18,1766
360593037004,36, New York,059, Nassau County,271,71,59,12,0,12,12,0,12,0,259,59,59,0,0,704,39,665
360593037005,36, New York,059, Nassau County,528,116,116,0,0,17,17,17,0,0,511,99,99,0,0,1503,152,1351
360593038001,36, New York,059, Nassau County,454,259,71,141,47,0,0,0,0,0,454,259,71,141,47,854,0,854
360593038002,36, New York,059, Nassau County,270,181,158,0,23,23,23,0,0,23,247,158,158,0,0,744,23,721
360593038003,36, New York,059, Nassau County,219,164,80,25,59,28,28,0,0,28,191,136,80,25,31,503,41,462
360593038004,36, New York,059, Nassau County,267,116,116,0,0,0,0,0,0,0,267,116,116,0,0,763,1,762
360593038005,36, New York,059, Nassau County,234,94,83,0,11,18,0,0,0,0,216,94,83,0,11,595,17,578
360593039001,36, New York,059, Nassau County,145,7,7,0,0,0,0,0,0,0,145,7,7,0,0,504,57,447
360593039002,36, New York,059, Nassau County,343,182,137,14,31,0,0,0,0,0,343,182,137,14,31,1018,0,1018
360593039003,36, New York,059, Nassau County,254,94,61,0,33,0,0,0,0,0,254,94,61,0,33,680,11,669
360593039004,36, New York,059, Nassau County,302,82,82,0,0,0,0,0,0,0,302,82,82,0,0,1036,9,1027
360593040011,36, New York,059, Nassau County,182,41,41,0,0,0,0,0,0,0,182,41,41,0,0,623,60,563
360593040012,36, New York,059, Nassau County,420,168,168,0,0,0,0,0,0,0,420,168,168,0,0,1164,22,1142
360593040021,36, New York,059, Nassau County,487,347,313,21,13,0,0,0,0,0,487,347,313,21,13,1189,15,1174
360593040022,36, New York,059, Nassau County,247,85,41,0,44,30,30,30,0,0,217,55,11,0,44,572,33,539
360593040023,36, New York,059, Nassau County,170,52,40,0,12,12,12,0,0,12,158,40,40,0,0,715,25,690
360593040024,36, New York,059, Nassau County,324,180,152,28,0,36,0,0,0,0,288,180,152,28,0,913,180,733
360593041001,36, New York,059, Nassau County,345,211,107,34,70,0,0,0,0,0,345,211,107,34,70,1082,19,1063
360593041002,36, New York,059, Nassau County,481,279,68,102,109,32,32,0,0,32,449,247,68,102,77,1061,55,1006
360593041003,36, New York,059, Nassau County,247,74,68,0,6,0,0,0,0,0,247,74,68,0,6,512,31,481
360593042021,36, New York,059, Nassau County,109,16,16,0,0,0,0,0,0,0,109,16,16,0,0,338,0,338
360593042022,36, New York,059, Nassau County,256,145,90,8,47,13,13,13,0,0,243,132,77,8,47,726,17,709
360593042023,36, New York,059, Nassau County,344,189,126,51,12,24,24,24,0,0,320,165,102,51,12,810,63,747
360593042031,36, New York,059, Nassau County,138,78,30,0,48,0,0,0,0,0,138,78,30,0,48,228,0,228
360593042032,36, New York,059, Nassau County,355,149,114,0,35,22,22,0,0,22,333,127,114,0,13,902,3,899
360593042033,36, New York,059, Nassau County,324,135,32,60,43,129,103,0,60,43,195,32,32,0,0,889,234,655
360593042034,36, New York,059, Nassau County,223,191,139,19,33,0,0,0,0,0,223,191,139,19,33,883,9,874
360593042041,36, New York,059, Nassau County,458,345,179,0,166,42,42,16,0,26,416,303,163,0,140,1296,115,1181
360593042042,36, New York,059, Nassau County,376,231,174,0,57,12,12,12,0,0,364,219,162,0,57,858,154,704
360593042043,36, New York,059, Nassau County,125,93,46,0,47,0,0,0,0,0,125,93,46,0,47,604,40,564
360594043001,36, New York,059, Nassau County,172,76,70,4,2,2,0,0,0,0,170,76,70,4,2,449,13,436
360594043002,36, New York,059, Nassau County,393,197,141,39,17,10,10,0,10,0,383,187,141,29,17,1079,23,1056
360594043003,36, New York,059, Nassau County,339,187,52,0,135,0,0,0,0,0,339,187,52,0,135,713,18,695
360594044001,36, New York,059, Nassau County,199,85,85,0,0,10,10,10,0,0,189,75,75,0,0,588,31,557
360594044002,36, New York,059, Nassau County,330,162,162,0,0,0,0,0,0,0,330,162,162,0,0,872,0,872
360594044003,36, New York,059, Nassau County,364,213,192,0,21,0,0,0,0,0,364,213,192,0,21,1045,9,1036
360594044004,36, New York,059, Nassau County,271,161,122,39,0,13,7,7,0,0,258,154,115,39,0,812,24,788
360594044005,36, New York,059, Nassau County,139,57,41,0,16,0,0,0,0,0,139,57,41,0,16,376,10,366
360594045001,36, New York,059, Nassau County,153,67,67,0,0,0,0,0,0,0,153,67,67,0,0,443,20,423
360594045002,36, New York,059, Nassau County,243,156,156,0,0,22,22,22,0,0,221,134,134,0,0,699,9,690
360594045003,36, New York,059, Nassau County,307,115,115,0,0,17,0,0,0,0,290,115,115,0,0,999,60,939
360594045004,36, New York,059, Nassau County,405,92,54,0,38,10,0,0,0,0,395,92,54,0,38,816,71,745
360594045005,36, New York,059, Nassau County,85,29,29,0,0,0,0,0,0,0,85,29,29,0,0,202,8,194
360594046001,36, New York,059, Nassau County,186,72,56,0,16,0,0,0,0,0,186,72,56,0,16,534,0,534
360594046002,36, New York,059, Nassau County,465,189,177,0,12,17,0,0,0,0,448,189,177,0,12,1192,49,1143
360594046003,36, New York,059, Nassau County,246,87,74,13,0,12,12,12,0,0,234,75,62,13,0,547,9,538
360594046004,36, New York,059, Nassau County,302,153,122,10,21,21,21,0,0,21,281,132,122,10,0,808,22,786
360594047001,36, New York,059, Nassau County,329,196,169,0,27,27,27,0,0,27,302,169,169,0,0,896,27,869
360594047002,36, New York,059, Nassau County,223,84,72,0,12,0,0,0,0,0,223,84,72,0,12,729,0,729
360594047003,36, New York,059, Nassau County,281,142,98,8,36,7,4,0,0,4,274,138,98,8,32,658,21,637
360594047004,36, New York,059, Nassau County,376,141,134,4,3,19,4,0,4,0,357,137,134,0,3,1085,37,1048
360594047005,36, New York,059, Nassau County,215,98,96,0,2,0,0,0,0,0,215,98,96,0,2,632,4,628
360594047006,36, New York,059, Nassau County,259,97,97,0,0,0,0,0,0,0,259,97,97,0,0,834,73,761
360594048001,36, New York,059, Nassau County,323,135,106,0,29,1,1,1,0,0,322,134,105,0,29,1026,62,964
360594048002,36, New York,059, Nassau County,372,109,66,0,43,0,0,0,0,0,372,109,66,0,43,1065,9,1056
360594048003,36, New York,059, Nassau County,371,185,146,4,35,30,30,21,0,9,341,155,125,4,26,1227,73,1154
360594048004,36, New York,059, Nassau County,273,218,124,30,64,45,45,45,0,0,228,173,79,30,64,730,89,641
360594049011,36, New York,059, Nassau County,201,43,9,30,4,4,4,0,0,4,197,39,9,30,0,853,18,835
360594049012,36, New York,059, Nassau County,275,112,69,0,43,0,0,0,0,0,275,112,69,0,43,885,72,813
360594049013,36, New York,059, Nassau County,236,144,106,0,38,8,8,8,0,0,228,136,98,0,38,658,24,634
360594049014,36, New York,059, Nassau County,322,75,49,6,20,6,0,0,0,0,316,75,49,6,20,1108,13,1095
360594049015,36, New York,059, Nassau County,205,96,16,20,60,0,0,0,0,0,205,96,16,20,60,580,0,580
360594049021,36, New York,059, Nassau County,648,376,162,51,163,19,0,0,0,0,629,376,162,51,163,2139,175,1964
360594049022,36, New York,059, Nassau County,509,296,151,64,81,35,35,0,35,0,474,261,151,29,81,1708,96,1612
360594050001,36, New York,059, Nassau County,363,187,145,13,29,0,0,0,0,0,363,187,145,13,29,1352,77,1275
360594050002,36, New York,059, Nassau County,272,133,79,0,54,0,0,0,0,0,272,133,79,0,54,1056,20,1036
360594050003,36, New York,059, Nassau County,278,175,144,0,31,8,0,0,0,0,270,175,144,0,31,846,54,792
360594050004,36, New York,059, Nassau County,226,88,58,8,22,2,0,0,0,0,224,88,58,8,22,684,14,670
360594051001,36, New York,059, Nassau County,444,360,360,0,0,0,0,0,0,0,444,360,360,0,0,815,0,815
360594051002,36, New York,059, Nassau County,499,243,206,0,37,0,0,0,0,0,499,243,206,0,37,1558,0,1558
360594051003,36, New York,059, Nassau County,565,380,316,45,19,0,0,0,0,0,565,380,316,45,19,1683,0,1683
360594051004,36, New York,059, Nassau County,318,143,143,0,0,0,0,0,0,0,318,143,143,0,0,910,0,910
360594051005,36, New York,059, Nassau County,85,20,20,0,0,0,0,0,0,0,85,20,20,0,0,313,0,313
360594051006,36, New York,059, Nassau County,227,111,111,0,0,22,0,0,0,0,205,111,111,0,0,560,55,505
360594051007,36, New York,059, Nassau County,335,88,59,0,29,0,0,0,0,0,335,88,59,0,29,1258,1,1257
360594052001,36, New York,059, Nassau County,635,316,257,47,12,33,33,33,0,0,602,283,224,47,12,1446,73,1373
360594052002,36, New York,059, Nassau County,481,209,147,51,11,0,0,0,0,0,481,209,147,51,11,1470,36,1434
360594052003,36, New York,059, Nassau County,396,180,108,39,33,0,0,0,0,0,396,180,108,39,33,1340,18,1322
360594052004,36, New York,059, Nassau County,249,103,92,0,11,0,0,0,0,0,249,103,92,0,11,741,0,741
360594053011,36, New York,059, Nassau County,257,146,107,0,39,20,20,20,0,0,237,126,87,0,39,770,54,716
360594053012,36, New York,059, Nassau County,183,73,62,0,11,14,0,0,0,0,169,73,62,0,11,494,48,446
360594053013,36, New York,059, Nassau County,414,144,102,19,23,4,4,0,0,4,410,140,102,19,19,1324,45,1279
360594053021,36, New York,059, Nassau County,250,104,98,0,6,6,6,0,0,6,244,98,98,0,0,753,14,739
360594053022,36, New York,059, Nassau County,250,41,41,0,0,0,0,0,0,0,250,41,41,0,0,605,9,596
360594053023,36, New York,059, Nassau County,269,71,58,0,13,0,0,0,0,0,269,71,58,0,13,566,13,553
360594053024,36, New York,059, Nassau County,319,231,176,0,55,24,24,0,0,24,295,207,176,0,31,873,24,849
360594053025,36, New York,059, Nassau County,261,89,89,0,0,13,0,0,0,0,248,89,89,0,0,874,164,710
360594054001,36, New York,059, Nassau County,529,352,324,0,28,29,29,29,0,0,500,323,295,0,28,788,83,705
360594054002,36, New York,059, Nassau County,182,87,38,30,19,7,0,0,0,0,175,87,38,30,19,715,29,686
360594054003,36, New York,059, Nassau County,306,105,91,0,14,0,0,0,0,0,306,105,91,0,14,1151,24,1127
360594054004,36, New York,059, Nassau County,419,191,191,0,0,64,0,0,0,0,355,191,191,0,0,1121,0,1121
360594054005,36, New York,059, Nassau County,204,154,85,0,69,0,0,0,0,0,204,154,85,0,69,442,0,442
360594054006,36, New York,059, Nassau County,402,142,142,0,0,0,0,0,0,0,402,142,142,0,0,1336,13,1323
360594055001,36, New York,059, Nassau County,314,36,36,0,0,0,0,0,0,0,314,36,36,0,0,1149,0,1149
360594055002,36, New York,059, Nassau County,339,195,195,0,0,0,0,0,0,0,339,195,195,0,0,976,0,976
360594055003,36, New York,059, Nassau County,277,125,75,16,34,0,0,0,0,0,277,125,75,16,34,765,0,765
360594055004,36, New York,059, Nassau County,222,115,115,0,0,0,0,0,0,0,222,115,115,0,0,682,23,659
360594055005,36, New York,059, Nassau County,311,92,52,0,40,40,0,0,0,0,271,92,52,0,40,740,112,628
360594056001,36, New York,059, Nassau County,372,201,133,29,39,12,0,0,0,0,360,201,133,29,39,934,58,876
360594056002,36, New York,059, Nassau County,175,91,70,21,0,0,0,0,0,0,175,91,70,21,0,475,19,456
360594056003,36, New York,059, Nassau County,288,75,75,0,0,0,0,0,0,0,288,75,75,0,0,697,2,695
360594056004,36, New York,059, Nassau County,202,104,87,0,17,8,0,0,0,0,194,104,87,0,17,748,32,716
360594057001,36, New York,059, Nassau County,234,163,113,19,31,0,0,0,0,0,234,163,113,19,31,680,0,680
360594057002,36, New York,059, Nassau County,305,157,130,19,8,0,0,0,0,0,305,157,130,19,8,777,7,770
360594057003,36, New York,059, Nassau County,327,204,162,0,42,63,55,21,0,34,264,149,141,0,8,851,129,722
360594057004,36, New York,059, Nassau County,294,163,145,0,18,0,0,0,0,0,294,163,145,0,18,835,8,827
360594057005,36, New York,059, Nassau County,214,101,93,0,8,8,8,0,0,8,206,93,93,0,0,562,8,554
360594058001,36, New York,059, Nassau County,484,152,152,0,0,2,2,2,0,0,482,150,150,0,0,1393,0,1393
360594058002,36, New York,059, Nassau County,186,98,77,0,21,5,0,0,0,0,181,98,77,0,21,630,52,578
360594058003,36, New York,059, Nassau County,248,113,93,0,20,0,0,0,0,0,248,113,93,0,20,828,151,677
360594058004,36, New York,059, Nassau County,115,59,50,0,9,9,9,0,0,9,106,50,50,0,0,353,19,334
360594059001,36, New York,059, Nassau County,393,148,131,9,8,0,0,0,0,0,393,148,131,9,8,1233,30,1203
360594059002,36, New York,059, Nassau County,222,85,56,0,29,0,0,0,0,0,222,85,56,0,29,695,0,695
360594059003,36, New York,059, Nassau County,305,202,183,10,9,8,0,0,0,0,297,202,183,10,9,951,53,898
360594059004,36, New York,059, Nassau County,255,141,90,40,11,0,0,0,0,0,255,141,90,40,11,529,0,529
360594059005,36, New York,059, Nassau County,217,122,112,0,10,10,10,0,0,10,207,112,112,0,0,709,20,689
360594060011,36, New York,059, Nassau County,324,262,121,0,141,0,0,0,0,0,324,262,121,0,141,824,122,702
360594060012,36, New York,059, Nassau County,406,161,106,21,34,18,18,18,0,0,388,143,88,21,34,1254,66,1188
360594060013,36, New York,059, Nassau County,207,44,31,0,13,0,0,0,0,0,207,44,31,0,13,531,9,522
360594060014,36, New York,059, Nassau County,393,225,196,0,29,0,0,0,0,0,393,225,196,0,29,1018,8,1010
360594060021,36, New York,059, Nassau County,300,67,67,0,0,19,12,12,0,0,281,55,55,0,0,761,63,698
360594060022,36, New York,059, Nassau County,421,303,237,5,61,27,24,0,0,24,394,279,237,5,37,911,0,911
360594060023,36, New York,059, Nassau County,165,28,28,0,0,0,0,0,0,0,165,28,28,0,0,576,12,564
360594061001,36, New York,059, Nassau County,160,54,48,6,0,0,0,0,0,0,160,54,48,6,0,440,4,436
360594061002,36, New York,059, Nassau County,339,123,88,26,9,14,0,0,0,0,325,123,88,26,9,1226,73,1153
360594061003,36, New York,059, Nassau County,159,66,54,7,5,4,0,0,0,0,155,66,54,7,5,514,19,495
360594062011,36, New York,059, Nassau County,252,163,111,35,17,0,0,0,0,0,252,163,111,35,17,894,27,867
360594062012,36, New York,059, Nassau County,253,179,152,0,27,7,7,7,0,0,246,172,145,0,27,810,38,772
360594062013,36, New York,059, Nassau County,201,79,30,0,49,0,0,0,0,0,201,79,30,0,49,670,4,666
360594062021,36, New York,059, Nassau County,710,467,330,75,62,75,75,0,75,0,635,392,330,0,62,1994,262,1732
360594062022,36, New York,059, Nassau County,204,115,21,0,94,25,25,0,0,25,179,90,21,0,69,498,0,498
360594062023,36, New York,059, Nassau County,127,52,28,0,24,11,11,0,0,11,116,41,28,0,13,460,60,400
360594062024,36, New York,059, Nassau County,268,178,75,26,77,12,12,12,0,0,256,166,63,26,77,1027,75,952
360594063001,36, New York,059, Nassau County,304,108,108,0,0,0,0,0,0,0,304,108,108,0,0,750,7,743
360594063002,36, New York,059, Nassau County,276,91,91,0,0,0,0,0,0,0,276,91,91,0,0,707,33,674
360594063003,36, New York,059, Nassau County,246,144,144,0,0,0,0,0,0,0,246,144,144,0,0,659,0,659
360594063004,36, New York,059, Nassau County,235,112,112,0,0,0,0,0,0,0,235,112,112,0,0,708,26,682
360594064001,36, New York,059, Nassau County,198,88,88,0,0,0,0,0,0,0,198,88,88,0,0,489,0,489
360594064002,36, New York,059, Nassau County,188,138,138,0,0,0,0,0,0,0,188,138,138,0,0,410,0,410
360594064003,36, New York,059, Nassau County,226,55,55,0,0,0,0,0,0,0,226,55,55,0,0,628,0,628
360594064004,36, New York,059, Nassau County,85,48,48,0,0,0,0,0,0,0,85,48,48,0,0,743,64,679
360594064005,36, New York,059, Nassau County,396,206,206,0,0,0,0,0,0,0,396,206,206,0,0,1130,16,1114
360594064006,36, New York,059, Nassau County,287,211,211,0,0,19,0,0,0,0,268,211,211,0,0,629,39,590
360594064007,36, New York,059, Nassau County,309,123,123,0,0,0,0,0,0,0,309,123,123,0,0,774,0,774
360594065011,36, New York,059, Nassau County,454,190,145,45,0,0,0,0,0,0,454,190,145,45,0,1172,0,1172
360594065012,36, New York,059, Nassau County,338,159,159,0,0,0,0,0,0,0,338,159,159,0,0,867,0,867
360594065013,36, New York,059, Nassau County,98,29,29,0,0,16,0,0,0,0,82,29,29,0,0,305,60,245
360594065014,36, New York,059, Nassau County,531,383,366,0,17,33,33,17,0,16,498,350,349,0,1,1601,72,1529
360594065015,36, New York,059, Nassau County,203,128,128,0,0,0,0,0,0,0,203,128,128,0,0,760,6,754
360594065016,36, New York,059, Nassau County,163,96,96,0,0,0,0,0,0,0,163,96,96,0,0,341,0,341
360594066001,36, New York,059, Nassau County,347,234,220,0,14,6,6,0,0,6,341,228,220,0,8,751,6,745
360594066002,36, New York,059, Nassau County,313,119,119,0,0,0,0,0,0,0,313,119,119,0,0,676,0,676
360594066003,36, New York,059, Nassau County,216,96,82,0,14,0,0,0,0,0,216,96,82,0,14,480,0,480
360594066004,36, New York,059, Nassau County,410,134,134,0,0,0,0,0,0,0,410,134,134,0,0,1175,13,1162
360594067011,36, New York,059, Nassau County,218,153,110,39,4,26,0,0,0,0,192,153,110,39,4,363,23,340
360594067012,36, New York,059, Nassau County,281,145,101,0,44,46,29,29,0,0,235,116,72,0,44,740,43,697
360594067013,36, New York,059, Nassau County,79,65,0,52,13,0,0,0,0,0,79,65,0,52,13,234,49,185
360594067021,36, New York,059, Nassau County,779,624,20,36,568,198,188,0,0,188,581,436,20,36,380,1610,389,1221
360594067022,36, New York,059, Nassau County,259,120,31,65,24,7,7,0,0,7,252,113,31,65,17,781,42,739
360594067023,36, New York,059, Nassau County,161,36,36,0,0,25,25,25,0,0,136,11,11,0,0,519,41,478
360594068011,36, New York,059, Nassau County,401,160,89,0,71,25,7,0,0,7,376,153,89,0,64,914,148,766
360594068012,36, New York,059, Nassau County,207,93,18,0,75,54,25,0,0,25,153,68,18,0,50,634,167,467
360594068013,36, New York,059, Nassau County,367,208,164,8,36,35,16,16,0,0,332,192,148,8,36,713,46,667
360594068021,36, New York,059, Nassau County,584,299,106,30,163,61,44,0,0,44,523,255,106,30,119,1326,131,1195
360594068022,36, New York,059, Nassau County,751,468,280,41,147,81,81,0,22,59,670,387,280,19,88,1286,65,1221
360594069001,36, New York,059, Nassau County,261,121,93,28,0,41,28,0,28,0,220,93,93,0,0,921,185,736
360594069002,36, New York,059, Nassau County,608,327,128,16,183,37,37,0,0,37,571,290,128,16,146,1393,132,1261
360594069003,36, New York,059, Nassau County,329,234,156,46,32,56,56,24,0,32,273,178,132,46,0,948,228,720
360594069004,36, New York,059, Nassau County,270,204,127,16,61,14,0,0,0,0,256,204,127,16,61,714,88,626
360594070001,36, New York,059, Nassau County,308,285,113,0,172,101,78,78,0,0,207,207,35,0,172,591,258,333
360594070002,36, New York,059, Nassau County,455,335,39,39,257,178,178,0,39,139,277,157,39,0,118,1065,266,799
360594070003,36, New York,059, Nassau County,176,77,77,0,0,0,0,0,0,0,176,77,77,0,0,385,0,385
360594070004,36, New York,059, Nassau County,328,153,5,29,119,53,53,0,29,24,275,100,5,0,95,873,107,766
360594070005,36, New York,059, Nassau County,213,185,21,23,141,0,0,0,0,0,213,185,21,23,141,512,39,473
360594070006,36, New York,059, Nassau County,507,292,147,78,67,0,0,0,0,0,507,292,147,78,67,1529,178,1351
360594071011,36, New York,059, Nassau County,180,94,0,0,94,28,28,0,0,28,152,66,0,0,66,883,175,708
360594071012,36, New York,059, Nassau County,284,115,34,40,41,25,0,0,0,0,259,115,34,40,41,920,82,838
360594071013,36, New York,059, Nassau County,227,38,38,0,0,0,0,0,0,0,227,38,38,0,0,796,16,780
360594071014,36, New York,059, Nassau County,469,138,106,0,32,63,32,0,0,32,406,106,106,0,0,1385,244,1141
360594071021,36, New York,059, Nassau County,261,151,74,8,69,0,0,0,0,0,261,151,74,8,69,755,0,755
360594071022,36, New York,059, Nassau County,561,329,109,20,200,0,0,0,0,0,561,329,109,20,200,1812,69,1743
360594071023,36, New York,059, Nassau County,245,73,11,19,43,22,22,0,4,18,223,51,11,15,25,900,66,834
360594071024,36, New York,059, Nassau County,404,286,174,63,49,12,0,0,0,0,392,286,174,63,49,1167,24,1143
360594072011,36, New York,059, Nassau County,125,83,47,17,19,97,55,36,0,19,28,28,11,17,0,235,179,56
360594072012,36, New York,059, Nassau County,285,129,48,30,51,30,30,0,30,0,255,99,48,0,51,591,5,586
360594072013,36, New York,059, Nassau County,546,404,121,67,216,250,207,54,0,153,296,197,67,67,63,899,249,650
360594072031,36, New York,059, Nassau County,404,265,158,19,88,51,25,0,0,25,353,240,158,19,63,1416,120,1296
360594072032,36, New York,059, Nassau County,290,194,89,16,89,96,82,17,10,55,194,112,72,6,34,626,156,470
360594072041,36, New York,059, Nassau County,107,0,0,0,0,0,0,0,0,0,107,0,0,0,0,245,0,245
360594072042,36, New York,059, Nassau County,557,304,136,0,168,29,6,0,0,6,528,298,136,0,162,1228,72,1156
360594072043,36, New York,059, Nassau County,78,54,38,0,16,5,0,0,0,0,73,54,38,0,16,362,46,316
360594073011,36, New York,059, Nassau County,122,48,8,27,13,27,8,0,8,0,95,40,8,19,13,344,60,284
360594073012,36, New York,059, Nassau County,844,118,118,0,0,15,8,8,0,0,829,110,110,0,0,2226,67,2159
360594073013,36, New York,059, Nassau County,43,35,26,0,9,9,9,0,0,9,34,26,26,0,0,99,20,79
360594073021,36, New York,059, Nassau County,67,38,38,0,0,0,0,0,0,0,67,38,38,0,0,334,69,265
360594073022,36, New York,059, Nassau County,269,79,40,0,39,39,39,0,0,39,230,40,40,0,0,697,46,651
360594073023,36, New York,059, Nassau County,219,112,60,52,0,0,0,0,0,0,219,112,60,52,0,768,207,561
360594073024,36, New York,059, Nassau County,523,274,245,0,29,9,9,0,0,9,514,265,245,0,20,1630,49,1581
360594074011,36, New York,059, Nassau County,159,91,37,0,54,39,39,0,0,39,120,52,37,0,15,426,39,387
360594074012,36, New York,059, Nassau County,229,112,73,28,11,0,0,0,0,0,229,112,73,28,11,497,30,467
360594074013,36, New York,059, Nassau County,396,106,90,0,16,13,13,13,0,0,383,93,77,0,16,1043,101,942
360594074014,36, New York,059, Nassau County,257,127,35,72,20,0,0,0,0,0,257,127,35,72,20,976,86,890
360594074015,36, New York,059, Nassau County,219,134,51,10,73,0,0,0,0,0,219,134,51,10,73,807,133,674
360594074021,36, New York,059, Nassau County,376,131,72,33,26,8,8,0,0,8,368,123,72,33,18,1288,70,1218
360594074022,36, New York,059, Nassau County,375,267,108,96,63,4,0,0,0,0,371,267,108,96,63,882,93,789
360594075011,36, New York,059, Nassau County,411,233,187,38,8,11,11,11,0,0,400,222,176,38,8,1009,54,955
360594075012,36, New York,059, Nassau County,330,266,83,59,124,72,72,0,0,72,258,194,83,59,52,473,18,455
360594075013,36, New York,059, Nassau County,188,100,75,0,25,0,0,0,0,0,188,100,75,0,25,706,4,702
360594075021,36, New York,059, Nassau County,418,280,224,0,56,0,0,0,0,0,418,280,224,0,56,1265,21,1244
360594075022,36, New York,059, Nassau County,210,44,44,0,0,0,0,0,0,0,210,44,44,0,0,734,0,734
360594075023,36, New York,059, Nassau County,292,209,173,36,0,11,0,0,0,0,281,209,173,36,0,931,83,848
360594075024,36, New York,059, Nassau County,471,203,108,0,95,30,30,0,0,30,441,173,108,0,65,1382,148,1234
360594076001,36, New York,059, Nassau County,206,109,87,0,22,0,0,0,0,0,206,109,87,0,22,744,0,744
360594076002,36, New York,059, Nassau County,277,47,47,0,0,0,0,0,0,0,277,47,47,0,0,685,17,668
360594076003,36, New York,059, Nassau County,158,98,84,0,14,0,0,0,0,0,158,98,84,0,14,610,20,590
360594076004,36, New York,059, Nassau County,435,171,159,0,12,0,0,0,0,0,435,171,159,0,12,1016,23,993
360594076005,36, New York,059, Nassau County,213,37,37,0,0,0,0,0,0,0,213,37,37,0,0,632,14,618
360594076006,36, New York,059, Nassau County,171,95,85,0,10,0,0,0,0,0,171,95,85,0,10,440,0,440
360594077001,36, New York,059, Nassau County,248,115,75,0,40,0,0,0,0,0,248,115,75,0,40,756,24,732
360594077002,36, New York,059, Nassau County,361,178,160,0,18,16,0,0,0,0,345,178,160,0,18,1094,55,1039
360594077003,36, New York,059, Nassau County,399,164,126,28,10,44,9,9,0,0,355,155,117,28,10,1018,115,903
360594077004,36, New York,059, Nassau County,237,161,161,0,0,0,0,0,0,0,237,161,161,0,0,682,33,649
360594078011,36, New York,059, Nassau County,409,171,143,16,12,12,0,0,0,0,397,171,143,16,12,1212,54,1158
360594078012,36, New York,059, Nassau County,606,152,142,0,10,0,0,0,0,0,606,152,142,0,10,1436,84,1352
360594078013,36, New York,059, Nassau County,358,158,112,46,0,30,30,30,0,0,328,128,82,46,0,953,0,953
360594078014,36, New York,059, Nassau County,235,49,45,0,4,0,0,0,0,0,235,49,45,0,4,628,6,622
360594078021,36, New York,059, Nassau County,101,28,28,0,0,0,0,0,0,0,101,28,28,0,0,402,26,376
360594079001,36, New York,059, Nassau County,398,186,178,0,8,0,0,0,0,0,398,186,178,0,8,966,0,966
360594079002,36, New York,059, Nassau County,455,149,123,9,17,0,0,0,0,0,455,149,123,9,17,1019,0,1019
360594079003,36, New York,059, Nassau County,405,61,61,0,0,61,0,0,0,0,344,61,61,0,0,1519,222,1297
360594079004,36, New York,059, Nassau County,274,78,78,0,0,0,0,0,0,0,274,78,78,0,0,839,8,831
360594080001,36, New York,059, Nassau County,350,187,172,0,15,0,0,0,0,0,350,187,172,0,15,1190,0,1190
360594080002,36, New York,059, Nassau County,283,173,173,0,0,0,0,0,0,0,283,173,173,0,0,623,0,623
360594080003,36, New York,059, Nassau County,222,75,75,0,0,0,0,0,0,0,222,75,75,0,0,679,16,663
360594080004,36, New York,059, Nassau County,343,251,251,0,0,0,0,0,0,0,343,251,251,0,0,883,0,883
360594080005,36, New York,059, Nassau County,205,77,60,0,17,0,0,0,0,0,205,77,60,0,17,554,23,531
360594080006,36, New York,059, Nassau County,190,65,48,17,0,17,17,0,17,0,173,48,48,0,0,612,37,575
360594081001,36, New York,059, Nassau County,299,80,58,0,22,22,22,0,0,22,277,58,58,0,0,823,36,787
360594081002,36, New York,059, Nassau County,268,131,131,0,0,0,0,0,0,0,268,131,131,0,0,649,29,620
360594081003,36, New York,059, Nassau County,177,45,31,14,0,1,0,0,0,0,176,45,31,14,0,1104,596,508
360594081004,36, New York,059, Nassau County,248,66,66,0,0,0,0,0,0,0,248,66,66,0,0,742,0,742
360594081005,36, New York,059, Nassau County,366,191,97,0,94,14,0,0,0,0,352,191,97,0,94,1191,29,1162
360594081006,36, New York,059, Nassau County,253,149,132,0,17,0,0,0,0,0,253,149,132,0,17,819,3,816
360594082001,36, New York,059, Nassau County,248,98,90,0,8,0,0,0,0,0,248,98,90,0,8,661,0,661
360594082002,36, New York,059, Nassau County,201,51,51,0,0,17,17,17,0,0,184,34,34,0,0,697,28,669
360594082003,36, New York,059, Nassau County,203,81,61,16,4,12,12,12,0,0,191,69,49,16,4,613,54,559
360594082004,36, New York,059, Nassau County,279,100,100,0,0,23,23,23,0,0,256,77,77,0,0,650,46,604
360594082005,36, New York,059, Nassau County,451,188,130,0,58,69,58,0,0,58,382,130,130,0,0,850,40,810
360594082006,36, New York,059, Nassau County,160,100,100,0,0,0,0,0,0,0,160,100,100,0,0,498,71,427
360594082007,36, New York,059, Nassau County,306,192,192,0,0,0,0,0,0,0,306,192,192,0,0,819,0,819
360594083001,36, New York,059, Nassau County,201,107,55,0,52,0,0,0,0,0,201,107,55,0,52,547,0,547
360594083002,36, New York,059, Nassau County,125,112,112,0,0,0,0,0,0,0,125,112,112,0,0,278,0,278
360594083003,36, New York,059, Nassau County,323,254,237,17,0,16,16,16,0,0,307,238,221,17,0,973,40,933
360594083004,36, New York,059, Nassau County,130,82,62,0,20,0,0,0,0,0,130,82,62,0,20,335,0,335
360594083005,36, New York,059, Nassau County,289,71,71,0,0,0,0,0,0,0,289,71,71,0,0,1046,19,1027
360594083006,36, New York,059, Nassau County,433,154,154,0,0,0,0,0,0,0,433,154,154,0,0,910,43,867
360594083007,36, New York,059, Nassau County,199,89,67,9,13,0,0,0,0,0,199,89,67,9,13,622,0,622
360594084001,36, New York,059, Nassau County,211,93,93,0,0,0,0,0,0,0,211,93,93,0,0,531,0,531
360594084002,36, New York,059, Nassau County,329,79,79,0,0,0,0,0,0,0,329,79,79,0,0,895,0,895
360594084003,36, New York,059, Nassau County,137,48,48,0,0,0,0,0,0,0,137,48,48,0,0,460,7,453
360594084004,36, New York,059, Nassau County,473,229,206,0,23,0,0,0,0,0,473,229,206,0,23,1143,0,1143
360594085001,36, New York,059, Nassau County,564,217,217,0,0,0,0,0,0,0,564,217,217,0,0,1503,10,1493
360594085002,36, New York,059, Nassau County,259,72,72,0,0,21,21,21,0,0,238,51,51,0,0,715,44,671
360594085003,36, New York,059, Nassau County,226,100,89,0,11,0,0,0,0,0,226,100,89,0,11,498,21,477
360594085004,36, New York,059, Nassau County,443,158,148,10,0,0,0,0,0,0,443,158,148,10,0,1329,44,1285
360594085005,36, New York,059, Nassau County,328,140,117,0,23,0,0,0,0,0,328,140,117,0,23,884,10,874
360594086001,36, New York,059, Nassau County,337,180,145,0,35,0,0,0,0,0,337,180,145,0,35,998,17,981
360594086002,36, New York,059, Nassau County,440,227,203,24,0,0,0,0,0,0,440,227,203,24,0,1333,22,1311
360594086003,36, New York,059, Nassau County,293,99,76,23,0,6,6,6,0,0,287,93,70,23,0,876,45,831
360594087001,36, New York,059, Nassau County,358,189,163,0,26,0,0,0,0,0,358,189,163,0,26,965,15,950
360594087002,36, New York,059, Nassau County,94,21,21,0,0,0,0,0,0,0,94,21,21,0,0,374,0,374
360594087003,36, New York,059, Nassau County,138,53,53,0,0,0,0,0,0,0,138,53,53,0,0,380,10,370
360594087004,36, New York,059, Nassau County,228,72,34,0,38,0,0,0,0,0,228,72,34,0,38,662,0,662
360594087005,36, New York,059, Nassau County,225,109,109,0,0,9,9,9,0,0,216,100,100,0,0,849,98,751
360594087006,36, New York,059, Nassau County,231,150,150,0,0,16,16,16,0,0,215,134,134,0,0,493,33,460
360594088001,36, New York,059, Nassau County,114,17,17,0,0,0,0,0,0,0,114,17,17,0,0,433,21,412
360594088002,36, New York,059, Nassau County,266,162,120,19,23,0,0,0,0,0,266,162,120,19,23,834,0,834
360594088003,36, New York,059, Nassau County,528,172,151,0,21,0,0,0,0,0,528,172,151,0,21,1362,0,1362
360594088004,36, New York,059, Nassau County,245,78,78,0,0,0,0,0,0,0,245,78,78,0,0,689,23,666
360594088005,36, New York,059, Nassau County,283,78,68,0,10,14,14,14,0,0,269,64,54,0,10,723,29,694
360594088006,36, New York,059, Nassau County,389,68,68,0,0,0,0,0,0,0,389,68,68,0,0,1263,91,1172
360594089001,36, New York,059, Nassau County,359,85,85,0,0,0,0,0,0,0,359,85,85,0,0,1172,13,1159
360594089002,36, New York,059, Nassau County,334,121,87,22,12,22,0,0,0,0,312,121,87,22,12,927,29,898
360594089003,36, New York,059, Nassau County,246,72,72,0,0,0,0,0,0,0,246,72,72,0,0,647,0,647
360594089004,36, New York,059, Nassau County,334,96,80,0,16,0,0,0,0,0,334,96,80,0,16,833,0,833
360594089005,36, New York,059, Nassau County,440,225,203,0,22,0,0,0,0,0,440,225,203,0,22,1302,54,1248
360594090001,36, New York,059, Nassau County,339,143,143,0,0,8,8,8,0,0,331,135,135,0,0,1041,16,1025
360594090002,36, New York,059, Nassau County,155,85,79,0,6,0,0,0,0,0,155,85,79,0,6,556,0,556
360594090003,36, New York,059, Nassau County,394,78,74,0,4,8,0,0,0,0,386,78,74,0,4,911,31,880
360594090004,36, New York,059, Nassau County,313,145,102,29,14,0,0,0,0,0,313,145,102,29,14,756,0,756
360594090005,36, New York,059, Nassau County,370,94,76,0,18,0,0,0,0,0,370,94,76,0,18,1076,11,1065
360594091001,36, New York,059, Nassau County,363,149,115,0,34,24,0,0,0,0,339,149,115,0,34,1076,63,1013
360594091002,36, New York,059, Nassau County,245,96,46,0,50,0,0,0,0,0,245,96,46,0,50,821,7,814
360594091003,36, New York,059, Nassau County,216,83,64,0,19,0,0,0,0,0,216,83,64,0,19,647,0,647
360594091004,36, New York,059, Nassau County,349,88,76,8,4,0,0,0,0,0,349,88,76,8,4,965,0,965
360594091005,36, New York,059, Nassau County,192,81,77,0,4,23,23,23,0,0,169,58,54,0,4,532,45,487
360594092001,36, New York,059, Nassau County,297,17,8,0,9,0,0,0,0,0,297,17,8,0,9,872,0,872
360594092002,36, New York,059, Nassau County,333,41,21,20,0,0,0,0,0,0,333,41,21,20,0,900,24,876
360594092003,36, New York,059, Nassau County,193,50,50,0,0,5,0,0,0,0,188,50,50,0,0,598,65,533
360594092004,36, New York,059, Nassau County,156,57,57,0,0,0,0,0,0,0,156,57,57,0,0,555,0,555
360594092005,36, New York,059, Nassau County,386,271,207,36,28,18,18,18,0,0,368,253,189,36,28,1058,148,910
360594092006,36, New York,059, Nassau County,316,132,132,0,0,0,0,0,0,0,316,132,132,0,0,753,0,753
360594093001,36, New York,059, Nassau County,285,143,126,0,17,0,0,0,0,0,285,143,126,0,17,841,0,841
360594093002,36, New York,059, Nassau County,283,117,99,0,18,0,0,0,0,0,283,117,99,0,18,774,6,768
360594093003,36, New York,059, Nassau County,380,204,156,32,16,27,0,0,0,0,353,204,156,32,16,942,111,831
360594093004,36, New York,059, Nassau County,232,95,87,0,8,0,0,0,0,0,232,95,87,0,8,624,26,598
360594094001,36, New York,059, Nassau County,354,152,137,0,15,0,0,0,0,0,354,152,137,0,15,1117,40,1077
360594094002,36, New York,059, Nassau County,357,148,142,0,6,18,9,9,0,0,339,139,133,0,6,1181,60,1121
360594094003,36, New York,059, Nassau County,360,111,111,0,0,40,0,0,0,0,320,111,111,0,0,1189,142,1047
360594095001,36, New York,059, Nassau County,302,113,113,0,0,0,0,0,0,0,302,113,113,0,0,1188,146,1042
360594095002,36, New York,059, Nassau County,475,236,236,0,0,14,14,14,0,0,461,222,222,0,0,1374,52,1322
360594095003,36, New York,059, Nassau County,232,114,106,0,8,11,11,11,0,0,221,103,95,0,8,586,12,574
360594096001,36, New York,059, Nassau County,332,123,123,0,0,0,0,0,0,0,332,123,123,0,0,971,0,971
360594096002,36, New York,059, Nassau County,404,265,207,0,58,24,0,0,0,0,380,265,207,0,58,970,84,886
360594096003,36, New York,059, Nassau County,464,215,215,0,0,13,0,0,0,0,451,215,215,0,0,1126,81,1045
360594096004,36, New York,059, Nassau County,238,118,104,0,14,0,0,0,0,0,238,118,104,0,14,616,17,599
360594097001,36, New York,059, Nassau County,138,71,62,9,0,0,0,0,0,0,138,71,62,9,0,417,8,409
360594097002,36, New York,059, Nassau County,294,116,100,0,16,0,0,0,0,0,294,116,100,0,16,905,19,886
360594097003,36, New York,059, Nassau County,300,132,132,0,0,0,0,0,0,0,300,132,132,0,0,724,6,718
360594097004,36, New York,059, Nassau County,384,109,109,0,0,28,0,0,0,0,356,109,109,0,0,1042,75,967
360594098001,36, New York,059, Nassau County,485,299,193,50,56,0,0,0,0,0,485,299,193,50,56,1763,126,1637
360594098002,36, New York,059, Nassau County,305,97,97,0,0,0,0,0,0,0,305,97,97,0,0,1041,114,927
360594098003,36, New York,059, Nassau County,251,136,95,0,41,5,5,0,0,5,246,131,95,0,36,887,15,872
360594098004,36, New York,059, Nassau County,347,95,95,0,0,0,0,0,0,0,347,95,95,0,0,1215,6,1209
360594099001,36, New York,059, Nassau County,273,167,116,22,29,0,0,0,0,0,273,167,116,22,29,713,18,695
360594099002,36, New York,059, Nassau County,462,233,141,0,92,41,0,0,0,0,421,233,141,0,92,1099,110,989
360594099003,36, New York,059, Nassau County,435,147,7,0,140,0,0,0,0,0,435,147,7,0,140,1692,59,1633
360594099004,36, New York,059, Nassau County,295,170,96,13,61,0,0,0,0,0,295,170,96,13,61,1073,87,986
360594099005,36, New York,059, Nassau County,300,195,97,86,12,0,0,0,0,0,300,195,97,86,12,993,0,993
360594099006,36, New York,059, Nassau County,256,15,15,0,0,0,0,0,0,0,256,15,15,0,0,656,0,656
360594100001,36, New York,059, Nassau County,190,130,108,0,22,0,0,0,0,0,190,130,108,0,22,591,26,565
360594100002,36, New York,059, Nassau County,417,82,61,0,21,0,0,0,0,0,417,82,61,0,21,1424,90,1334
360594100003,36, New York,059, Nassau County,410,137,112,0,25,0,0,0,0,0,410,137,112,0,25,1499,40,1459
360594101001,36, New York,059, Nassau County,224,69,49,0,20,0,0,0,0,0,224,69,49,0,20,762,0,762
360594101002,36, New York,059, Nassau County,360,211,211,0,0,0,0,0,0,0,360,211,211,0,0,746,0,746
360594101003,36, New York,059, Nassau County,295,95,95,0,0,0,0,0,0,0,295,95,95,0,0,861,9,852
360594101004,36, New York,059, Nassau County,245,109,69,25,15,23,0,0,0,0,222,109,69,25,15,643,46,597
360594101005,36, New York,059, Nassau County,344,107,107,0,0,24,0,0,0,0,320,107,107,0,0,1039,48,991
360594101006,36, New York,059, Nassau County,246,116,116,0,0,41,0,0,0,0,205,116,116,0,0,687,143,544
360594102001,36, New York,059, Nassau County,285,58,58,0,0,0,0,0,0,0,285,58,58,0,0,816,21,795
360594102002,36, New York,059, Nassau County,230,121,91,5,25,7,0,0,0,0,223,121,91,5,25,677,7,670
360594102003,36, New York,059, Nassau County,154,40,14,0,26,0,0,0,0,0,154,40,14,0,26,335,8,327
360594102004,36, New York,059, Nassau County,297,207,149,0,58,0,0,0,0,0,297,207,149,0,58,886,40,846
360594103001,36, New York,059, Nassau County,385,203,173,0,30,16,0,0,0,0,369,203,173,0,30,1072,69,1003
360594103002,36, New York,059, Nassau County,301,167,161,0,6,0,0,0,0,0,301,167,161,0,6,840,4,836
360594103003,36, New York,059, Nassau County,321,252,171,6,75,0,0,0,0,0,321,252,171,6,75,870,0,870
360594103004,36, New York,059, Nassau County,160,83,39,0,44,0,0,0,0,0,160,83,39,0,44,405,15,390
360594103005,36, New York,059, Nassau County,365,189,132,17,40,0,0,0,0,0,365,189,132,17,40,1528,51,1477
360594104001,36, New York,059, Nassau County,332,77,55,0,22,8,0,0,0,0,324,77,55,0,22,1058,19,1039
360594104002,36, New York,059, Nassau County,244,156,122,0,34,21,21,0,0,21,223,135,122,0,13,770,27,743
360594104003,36, New York,059, Nassau County,157,30,30,0,0,0,0,0,0,0,157,30,30,0,0,548,10,538
360594104004,36, New York,059, Nassau County,403,90,66,0,24,0,0,0,0,0,403,90,66,0,24,1673,34,1639
360594105001,36, New York,059, Nassau County,259,199,164,0,35,0,0,0,0,0,259,199,164,0,35,707,0,707
360594105002,36, New York,059, Nassau County,401,210,140,0,70,0,0,0,0,0,401,210,140,0,70,1091,0,1091
360594105003,36, New York,059, Nassau County,516,215,123,70,22,42,22,0,0,22,474,193,123,70,0,1662,117,1545
360594105004,36, New York,059, Nassau County,242,107,91,16,0,0,0,0,0,0,242,107,91,16,0,688,27,661
360594105005,36, New York,059, Nassau County,330,111,99,0,12,0,0,0,0,0,330,111,99,0,12,807,36,771
360594105006,36, New York,059, Nassau County,271,64,64,0,0,0,0,0,0,0,271,64,64,0,0,1187,82,1105
360594106001,36, New York,059, Nassau County,355,118,98,20,0,0,0,0,0,0,355,118,98,20,0,1046,86,960
360594106002,36, New York,059, Nassau County,422,187,173,14,0,0,0,0,0,0,422,187,173,14,0,1012,55,957
360594106003,36, New York,059, Nassau County,255,191,162,0,29,29,29,0,0,29,226,162,162,0,0,901,244,657
360594106004,36, New York,059, Nassau County,194,91,80,11,0,70,0,0,0,0,124,91,80,11,0,628,122,506
360594106005,36, New York,059, Nassau County,361,88,88,0,0,0,0,0,0,0,361,88,88,0,0,1327,0,1327
360594106006,36, New York,059, Nassau County,408,108,108,0,0,0,0,0,0,0,408,108,108,0,0,977,0,977
360594106007,36, New York,059, Nassau County,141,46,46,0,0,0,0,0,0,0,141,46,46,0,0,449,10,439
360594107001,36, New York,059, Nassau County,262,166,166,0,0,0,0,0,0,0,262,166,166,0,0,593,0,593
360594107002,36, New York,059, Nassau County,114,53,53,0,0,0,0,0,0,0,114,53,53,0,0,388,0,388
360594107003,36, New York,059, Nassau County,285,164,133,0,31,0,0,0,0,0,285,164,133,0,31,877,0,877
360594107004,36, New York,059, Nassau County,261,92,61,31,0,31,31,0,31,0,230,61,61,0,0,627,0,627
360594107005,36, New York,059, Nassau County,456,380,244,124,12,38,12,12,0,0,418,368,232,124,12,1100,119,981
360594107006,36, New York,059, Nassau County,427,378,258,19,101,0,0,0,0,0,427,378,258,19,101,1278,123,1155
360594108001,36, New York,059, Nassau County,212,77,77,0,0,0,0,0,0,0,212,77,77,0,0,549,21,528
360594108002,36, New York,059, Nassau County,367,137,111,0,26,0,0,0,0,0,367,137,111,0,26,1224,4,1220
360594108003,36, New York,059, Nassau County,263,137,103,0,34,9,0,0,0,0,254,137,103,0,34,615,54,561
360594108004,36, New York,059, Nassau County,474,263,223,15,25,0,0,0,0,0,474,263,223,15,25,1349,0,1349
360594109001,36, New York,059, Nassau County,533,250,205,9,36,81,13,1,0,12,452,237,204,9,24,1604,219,1385
360594109002,36, New York,059, Nassau County,402,225,213,11,1,1,1,0,0,1,401,224,213,11,0,1591,154,1437
360594109003,36, New York,059, Nassau County,347,88,32,15,41,4,0,0,0,0,343,88,32,15,41,963,61,902
360594109004,36, New York,059, Nassau County,236,102,79,4,19,0,0,0,0,0,236,102,79,4,19,585,7,578
360594110001,36, New York,059, Nassau County,169,135,94,27,14,67,56,29,27,0,102,79,65,0,14,459,207,252
360594110002,36, New York,059, Nassau County,123,55,19,0,36,25,12,0,0,12,98,43,19,0,24,282,72,210
360594110003,36, New York,059, Nassau County,316,107,45,41,21,41,41,0,41,0,275,66,45,0,21,667,49,618
360594110004,36, New York,059, Nassau County,315,118,49,0,69,45,45,30,0,15,270,73,19,0,54,918,46,872
360594110005,36, New York,059, Nassau County,384,258,218,0,40,8,0,0,0,0,376,258,218,0,40,1040,28,1012
360594111001,36, New York,059, Nassau County,320,221,94,71,56,48,48,0,28,20,272,173,94,43,36,687,89,598
360594111002,36, New York,059, Nassau County,189,98,47,15,36,16,2,2,0,0,173,96,45,15,36,601,119,482
360594111003,36, New York,059, Nassau County,326,199,186,0,13,54,54,41,0,13,272,145,145,0,0,940,61,879
360594111004,36, New York,059, Nassau County,159,64,37,0,27,27,27,0,0,27,132,37,37,0,0,435,49,386
360594112001,36, New York,059, Nassau County,302,125,125,0,0,0,0,0,0,0,302,125,125,0,0,822,4,818
360594112002,36, New York,059, Nassau County,159,85,85,0,0,0,0,0,0,0,159,85,85,0,0,979,83,896
360594112003,36, New York,059, Nassau County,373,188,166,22,0,0,0,0,0,0,373,188,166,22,0,1260,68,1192
360594112004,36, New York,059, Nassau County,524,167,167,0,0,0,0,0,0,0,524,167,167,0,0,957,0,957
360594112005,36, New York,059, Nassau County,275,157,157,0,0,0,0,0,0,0,275,157,157,0,0,757,31,726
360594113011,36, New York,059, Nassau County,336,190,190,0,0,0,0,0,0,0,336,190,190,0,0,922,0,922
360594113012,36, New York,059, Nassau County,452,256,220,35,1,46,35,0,35,0,406,221,220,0,1,1137,65,1072
360594113013,36, New York,059, Nassau County,267,169,163,6,0,0,0,0,0,0,267,169,163,6,0,759,8,751
360594113021,36, New York,059, Nassau County,328,115,115,0,0,0,0,0,0,0,328,115,115,0,0,781,13,768
360594113022,36, New York,059, Nassau County,98,43,43,0,0,0,0,0,0,0,98,43,43,0,0,351,0,351
360594113023,36, New York,059, Nassau County,256,137,137,0,0,0,0,0,0,0,256,137,137,0,0,850,9,841
360594113024,36, New York,059, Nassau County,710,230,200,0,30,0,0,0,0,0,710,230,200,0,30,1578,0,1578
360594113025,36, New York,059, Nassau County,314,113,91,22,0,0,0,0,0,0,314,113,91,22,0,906,0,906
360594114001,36, New York,059, Nassau County,223,166,142,0,24,0,0,0,0,0,223,166,142,0,24,722,94,628
360594114002,36, New York,059, Nassau County,266,210,167,43,0,0,0,0,0,0,266,210,167,43,0,964,27,937
360594114003,36, New York,059, Nassau County,324,208,199,0,9,0,0,0,0,0,324,208,199,0,9,867,9,858
360594114004,36, New York,059, Nassau County,172,86,86,0,0,0,0,0,0,0,172,86,86,0,0,361,0,361
360594114005,36, New York,059, Nassau County,222,116,116,0,0,0,0,0,0,0,222,116,116,0,0,597,0,597
360594114006,36, New York,059, Nassau County,206,124,124,0,0,0,0,0,0,0,206,124,124,0,0,579,0,579
360594115001,36, New York,059, Nassau County,250,127,113,0,14,3,0,0,0,0,247,127,113,0,14,650,11,639
360594115002,36, New York,059, Nassau County,278,112,101,8,3,8,8,0,8,0,270,104,101,0,3,756,23,733
360594115003,36, New York,059, Nassau County,282,119,116,3,0,0,0,0,0,0,282,119,116,3,0,769,0,769
360594116001,36, New York,059, Nassau County,379,205,205,0,0,0,0,0,0,0,379,205,205,0,0,1015,0,1015
360594116002,36, New York,059, Nassau County,79,49,28,0,21,0,0,0,0,0,79,49,28,0,21,264,4,260
360594116003,36, New York,059, Nassau County,481,383,346,37,0,0,0,0,0,0,481,383,346,37,0,1760,0,1760
360594116004,36, New York,059, Nassau County,392,98,98,0,0,0,0,0,0,0,392,98,98,0,0,1356,36,1320
360594116005,36, New York,059, Nassau County,112,6,6,0,0,0,0,0,0,0,112,6,6,0,0,305,35,270
360594117001,36, New York,059, Nassau County,457,238,173,0,65,82,65,0,0,65,375,173,173,0,0,1188,345,843
360594117002,36, New York,059, Nassau County,658,278,255,0,23,0,0,0,0,0,658,278,255,0,23,1770,29,1741
360594117003,36, New York,059, Nassau County,325,147,119,0,28,17,17,17,0,0,308,130,102,0,28,884,34,850
360594117004,36, New York,059, Nassau County,403,179,126,53,0,8,0,0,0,0,395,179,126,53,0,993,15,978
360594117005,36, New York,059, Nassau County,187,99,67,0,32,0,0,0,0,0,187,99,67,0,32,493,19,474
360594118001,36, New York,059, Nassau County,230,70,70,0,0,0,0,0,0,0,230,70,70,0,0,768,11,757
360594118002,36, New York,059, Nassau County,311,213,145,0,68,34,25,25,0,0,277,188,120,0,68,637,71,566
360594118003,36, New York,059, Nassau County,171,89,59,0,30,14,0,0,0,0,157,89,59,0,30,379,50,329
360594118004,36, New York,059, Nassau County,474,179,178,0,1,0,0,0,0,0,474,179,178,0,1,1123,10,1113
360594118005,36, New York,059, Nassau County,347,236,223,0,13,0,0,0,0,0,347,236,223,0,13,1009,37,972
360594118006,36, New York,059, Nassau County,235,93,93,0,0,0,0,0,0,0,235,93,93,0,0,1050,33,1017
360594119011,36, New York,059, Nassau County,426,166,136,30,0,30,30,0,30,0,396,136,136,0,0,1132,74,1058
360594119012,36, New York,059, Nassau County,180,53,32,21,0,39,39,18,21,0,141,14,14,0,0,581,83,498
360594119013,36, New York,059, Nassau County,212,63,56,0,7,0,0,0,0,0,212,63,56,0,7,857,82,775
360594119021,36, New York,059, Nassau County,449,174,158,16,0,18,0,0,0,0,431,174,158,16,0,1363,105,1258
360594119022,36, New York,059, Nassau County,216,118,115,0,3,0,0,0,0,0,216,118,115,0,3,543,6,537
360594119023,36, New York,059, Nassau County,367,122,68,0,54,9,0,0,0,0,358,122,68,0,54,997,27,970
360594120001,36, New York,059, Nassau County,288,174,174,0,0,22,22,22,0,0,266,152,152,0,0,796,62,734
360594120002,36, New York,059, Nassau County,80,58,58,0,0,0,0,0,0,0,80,58,58,0,0,269,0,269
360594120003,36, New York,059, Nassau County,330,243,94,28,121,82,82,8,0,74,248,161,86,28,47,951,127,824
360594120004,36, New York,059, Nassau County,324,191,137,0,54,6,0,0,0,0,318,191,137,0,54,886,21,865
360594120005,36, New York,059, Nassau County,141,26,26,0,0,0,0,0,0,0,141,26,26,0,0,425,0,425
360594120006,36, New York,059, Nassau County,424,50,28,0,22,0,0,0,0,0,424,50,28,0,22,1450,0,1450
360594121001,36, New York,059, Nassau County,164,12,12,0,0,0,0,0,0,0,164,12,12,0,0,658,13,645
360594121002,36, New York,059, Nassau County,321,136,86,0,50,0,0,0,0,0,321,136,86,0,50,832,0,832
360594121003,36, New York,059, Nassau County,343,120,120,0,0,13,0,0,0,0,330,120,120,0,0,990,78,912
360594121004,36, New York,059, Nassau County,269,116,116,0,0,0,0,0,0,0,269,116,116,0,0,961,67,894
360594121005,36, New York,059, Nassau County,533,292,183,0,109,0,0,0,0,0,533,292,183,0,109,1274,16,1258
360594122001,36, New York,059, Nassau County,168,83,68,0,15,0,0,0,0,0,168,83,68,0,15,656,0,656
360594122002,36, New York,059, Nassau County,405,156,51,13,92,13,13,0,13,0,392,143,51,0,92,1087,2,1085
360594122003,36, New York,059, Nassau County,152,62,62,0,0,0,0,0,0,0,152,62,62,0,0,540,0,540
360594122004,36, New York,059, Nassau County,196,130,75,11,44,20,0,0,0,0,176,130,75,11,44,538,57,481
360594122005,36, New York,059, Nassau County,408,234,181,0,53,53,53,0,0,53,355,181,181,0,0,958,53,905
360594123011,36, New York,059, Nassau County,506,152,120,15,17,84,0,0,0,0,422,152,120,15,17,1342,113,1229
360594123012,36, New York,059, Nassau County,426,238,108,0,130,0,0,0,0,0,426,238,108,0,130,1519,30,1489
360594123021,36, New York,059, Nassau County,150,36,36,0,0,0,0,0,0,0,150,36,36,0,0,520,24,496
360594123022,36, New York,059, Nassau County,333,199,132,16,51,0,0,0,0,0,333,199,132,16,51,945,0,945
360594123023,36, New York,059, Nassau County,261,88,88,0,0,0,0,0,0,0,261,88,88,0,0,754,16,738
360594123024,36, New York,059, Nassau County,202,93,93,0,0,0,0,0,0,0,202,93,93,0,0,497,68,429
360594124001,36, New York,059, Nassau County,316,181,149,0,32,0,0,0,0,0,316,181,149,0,32,738,0,738
360594124002,36, New York,059, Nassau County,224,94,7,45,42,0,0,0,0,0,224,94,7,45,42,1008,42,966
360594124003,36, New York,059, Nassau County,209,145,100,0,45,0,0,0,0,0,209,145,100,0,45,715,18,697
360594124004,36, New York,059, Nassau County,277,112,67,45,0,0,0,0,0,0,277,112,67,45,0,1429,158,1271
360594124005,36, New York,059, Nassau County,287,195,195,0,0,0,0,0,0,0,287,195,195,0,0,764,66,698
360594125001,36, New York,059, Nassau County,434,190,109,62,19,0,0,0,0,0,434,190,109,62,19,1081,13,1068
360594125002,36, New York,059, Nassau County,399,197,153,31,13,10,0,0,0,0,389,197,153,31,13,994,32,962
360594125003,36, New York,059, Nassau County,332,112,100,6,6,0,0,0,0,0,332,112,100,6,6,796,0,796
360594126001,36, New York,059, Nassau County,325,111,76,0,35,0,0,0,0,0,325,111,76,0,35,932,0,932
360594126002,36, New York,059, Nassau County,291,165,165,0,0,0,0,0,0,0,291,165,165,0,0,625,13,612
360594126003,36, New York,059, Nassau County,500,255,246,9,0,0,0,0,0,0,500,255,246,9,0,1185,26,1159
360594127001,36, New York,059, Nassau County,434,234,229,0,5,38,5,0,0,5,396,229,229,0,0,1084,141,943
360594127002,36, New York,059, Nassau County,339,237,228,0,9,9,9,0,0,9,330,228,228,0,0,750,9,741
360594127003,36, New York,059, Nassau County,498,231,218,0,13,22,22,22,0,0,476,209,196,0,13,1319,53,1266
360594128001,36, New York,059, Nassau County,240,111,100,0,11,11,11,0,0,11,229,100,100,0,0,621,22,599
360594128002,36, New York,059, Nassau County,372,107,56,14,37,9,0,0,0,0,363,107,56,14,37,1006,19,987
360594128003,36, New York,059, Nassau County,276,160,118,42,0,0,0,0,0,0,276,160,118,42,0,812,12,800
360594129001,36, New York,059, Nassau County,332,43,35,0,8,9,0,0,0,0,323,43,35,0,8,1041,69,972
360594129002,36, New York,059, Nassau County,321,133,98,10,25,0,0,0,0,0,321,133,98,10,25,1044,0,1044
360594129003,36, New York,059, Nassau County,448,93,93,0,0,0,0,0,0,0,448,93,93,0,0,1408,0,1408
360594129004,36, New York,059, Nassau County,571,344,220,17,107,28,28,0,17,11,543,316,220,0,96,1387,54,1333
360594130011,36, New York,059, Nassau County,392,162,152,0,10,0,0,0,0,0,392,162,152,0,10,1054,0,1054
360594130012,36, New York,059, Nassau County,341,153,146,0,7,0,0,0,0,0,341,153,146,0,7,1130,0,1130
360594130013,36, New York,059, Nassau County,256,72,48,9,15,0,0,0,0,0,256,72,48,9,15,851,70,781
360594130021,36, New York,059, Nassau County,396,160,116,35,9,19,19,19,0,0,377,141,97,35,9,875,55,820
360594130022,36, New York,059, Nassau County,387,207,117,73,17,0,0,0,0,0,387,207,117,73,17,861,0,861
360594130023,36, New York,059, Nassau County,224,61,53,8,0,0,0,0,0,0,224,61,53,8,0,754,0,754
360594130024,36, New York,059, Nassau County,289,191,150,10,31,35,23,0,0,23,254,168,150,10,8,783,35,748
360594131001,36, New York,059, Nassau County,261,90,77,0,13,0,0,0,0,0,261,90,77,0,13,937,76,861
360594131002,36, New York,059, Nassau County,219,87,49,30,8,0,0,0,0,0,219,87,49,30,8,679,9,670
360594131003,36, New York,059, Nassau County,250,95,95,0,0,0,0,0,0,0,250,95,95,0,0,883,25,858
360594131004,36, New York,059, Nassau County,280,141,141,0,0,0,0,0,0,0,280,141,141,0,0,753,14,739
360594131005,36, New York,059, Nassau County,243,67,67,0,0,0,0,0,0,0,243,67,67,0,0,725,32,693
360594132001,36, New York,059, Nassau County,271,100,100,0,0,63,63,63,0,0,208,37,37,0,0,889,249,640
360594132002,36, New York,059, Nassau County,209,68,68,0,0,0,0,0,0,0,209,68,68,0,0,516,28,488
360594132003,36, New York,059, Nassau County,506,89,73,0,16,11,0,0,0,0,495,89,73,0,16,1854,57,1797
360594132004,36, New York,059, Nassau County,109,45,45,0,0,0,0,0,0,0,109,45,45,0,0,309,36,273
360594132005,36, New York,059, Nassau County,432,88,88,0,0,0,0,0,0,0,432,88,88,0,0,1232,0,1232
360594133001,36, New York,059, Nassau County,127,17,17,0,0,0,0,0,0,0,127,17,17,0,0,418,0,418
360594133002,36, New York,059, Nassau County,233,131,131,0,0,0,0,0,0,0,233,131,131,0,0,526,0,526
360594133003,36, New York,059, Nassau County,118,35,35,0,0,0,0,0,0,0,118,35,35,0,0,410,22,388
360594133004,36, New York,059, Nassau County,223,76,76,0,0,0,0,0,0,0,223,76,76,0,0,655,0,655
360594133005,36, New York,059, Nassau County,354,110,110,0,0,0,0,0,0,0,354,110,110,0,0,914,0,914
360594133006,36, New York,059, Nassau County,561,333,333,0,0,0,0,0,0,0,561,333,333,0,0,1575,37,1538
360594133007,36, New York,059, Nassau County,230,99,99,0,0,0,0,0,0,0,230,99,99,0,0,519,0,519
360594134001,36, New York,059, Nassau County,249,81,81,0,0,0,0,0,0,0,249,81,81,0,0,529,0,529
360594134002,36, New York,059, Nassau County,584,294,241,9,44,0,0,0,0,0,584,294,241,9,44,1519,0,1519
360594134003,36, New York,059, Nassau County,457,233,224,0,9,9,0,0,0,0,448,233,224,0,9,1241,34,1207
360594134004,36, New York,059, Nassau County,352,246,192,16,38,0,0,0,0,0,352,246,192,16,38,802,0,802
360594135001,36, New York,059, Nassau County,405,283,283,0,0,0,0,0,0,0,405,283,283,0,0,1006,0,1006
360594135002,36, New York,059, Nassau County,289,151,80,0,71,10,0,0,0,0,279,151,80,0,71,888,30,858
360594135003,36, New York,059, Nassau County,430,285,90,53,142,81,81,0,0,81,349,204,90,53,61,1128,0,1128
360594135004,36, New York,059, Nassau County,468,78,55,23,0,0,0,0,0,0,468,78,55,23,0,1293,29,1264
360594135005,36, New York,059, Nassau County,280,155,90,0,65,7,0,0,0,0,273,155,90,0,65,827,15,812
360594135006,36, New York,059, Nassau County,195,60,60,0,0,0,0,0,0,0,195,60,60,0,0,606,26,580
360594136001,36, New York,059, Nassau County,341,218,159,0,59,50,50,0,0,50,291,168,159,0,9,1009,50,959
360594136002,36, New York,059, Nassau County,386,111,111,0,0,0,0,0,0,0,386,111,111,0,0,924,10,914
360594136003,36, New York,059, Nassau County,141,25,25,0,0,0,0,0,0,0,141,25,25,0,0,552,32,520
360594136004,36, New York,059, Nassau County,409,188,188,0,0,33,33,33,0,0,376,155,155,0,0,1226,64,1162
360594136005,36, New York,059, Nassau County,275,156,112,34,10,0,0,0,0,0,275,156,112,34,10,545,15,530
360594137001,36, New York,059, Nassau County,279,155,137,0,18,0,0,0,0,0,279,155,137,0,18,818,34,784
360594137002,36, New York,059, Nassau County,171,76,76,0,0,0,0,0,0,0,171,76,76,0,0,470,5,465
360594137003,36, New York,059, Nassau County,170,39,39,0,0,18,0,0,0,0,152,39,39,0,0,514,61,453
360594137004,36, New York,059, Nassau County,259,108,74,0,34,0,0,0,0,0,259,108,74,0,34,912,51,861
360594137005,36, New York,059, Nassau County,428,256,228,17,11,10,0,0,0,0,418,256,228,17,11,1280,46,1234
360594138031,36, New York,059, Nassau County,284,118,45,0,73,52,52,0,0,52,232,66,45,0,21,670,52,618
360594138032,36, New York,059, Nassau County,174,116,57,0,59,0,0,0,0,0,174,116,57,0,59,439,0,439
360594138033,36, New York,059, Nassau County,226,116,32,22,62,0,0,0,0,0,226,116,32,22,62,832,12,820
360594138034,36, New York,059, Nassau County,487,132,80,0,52,15,0,0,0,0,472,132,80,0,52,1534,38,1496
360594138041,36, New York,059, Nassau County,380,158,158,0,0,21,0,0,0,0,359,158,158,0,0,1460,68,1392
360594138042,36, New York,059, Nassau County,307,111,63,0,48,0,0,0,0,0,307,111,63,0,48,965,30,935
360594138043,36, New York,059, Nassau County,249,102,58,0,44,0,0,0,0,0,249,102,58,0,44,636,71,565
360594139001,36, New York,059, Nassau County,314,232,206,0,26,121,121,121,0,0,193,111,85,0,26,710,70,640
360594139002,36, New York,059, Nassau County,400,242,169,31,42,51,0,0,0,0,349,242,169,31,42,1278,136,1142
360594139003,36, New York,059, Nassau County,414,243,145,52,46,46,22,0,0,22,368,221,145,52,24,1106,105,1001
360594139004,36, New York,059, Nassau County,235,78,69,0,9,0,0,0,0,0,235,78,69,0,9,978,0,978
360594139005,36, New York,059, Nassau County,337,229,128,17,84,40,40,0,0,40,297,189,128,17,44,1096,27,1069
360594140011,36, New York,059, Nassau County,315,209,148,14,47,0,0,0,0,0,315,209,148,14,47,1118,13,1105
360594140012,36, New York,059, Nassau County,247,98,83,0,15,0,0,0,0,0,247,98,83,0,15,850,0,850
360594140013,36, New York,059, Nassau County,115,39,39,0,0,21,21,21,0,0,94,18,18,0,0,338,124,214
360594140014,36, New York,059, Nassau County,472,449,82,0,367,0,0,0,0,0,472,449,82,0,367,888,27,861
360594140021,36, New York,059, Nassau County,244,62,44,18,0,0,0,0,0,0,244,62,44,18,0,685,23,662
360594140022,36, New York,059, Nassau County,515,295,117,55,123,0,0,0,0,0,515,295,117,55,123,1525,40,1485
360594140023,36, New York,059, Nassau County,347,207,114,24,69,0,0,0,0,0,347,207,114,24,69,1074,19,1055
360594141001,36, New York,059, Nassau County,207,131,113,4,14,0,0,0,0,0,207,131,113,4,14,506,8,498
360594141002,36, New York,059, Nassau County,164,99,31,17,51,0,0,0,0,0,164,99,31,17,51,649,0,649
360594141003,36, New York,059, Nassau County,434,252,78,130,44,0,0,0,0,0,434,252,78,130,44,1053,0,1053
360594141004,36, New York,059, Nassau County,229,162,138,0,24,18,18,0,0,18,211,144,138,0,6,675,25,650
360594141005,36, New York,059, Nassau County,366,186,125,28,33,0,0,0,0,0,366,186,125,28,33,1056,27,1029
360594141006,36, New York,059, Nassau County,292,85,85,0,0,0,0,0,0,0,292,85,85,0,0,912,28,884
360594142011,36, New York,059, Nassau County,605,384,269,43,72,46,28,28,0,0,559,356,241,43,72,1489,111,1378
360594142012,36, New York,059, Nassau County,326,177,177,0,0,0,0,0,0,0,326,177,177,0,0,751,0,751
360594142013,36, New York,059, Nassau County,340,239,35,39,165,0,0,0,0,0,340,239,35,39,165,1535,118,1417
360594142021,36, New York,059, Nassau County,299,202,70,25,107,100,69,0,0,69,199,133,70,25,38,685,153,532
360594142022,36, New York,059, Nassau County,231,33,11,0,22,71,0,0,0,0,160,33,11,0,22,416,14,402
360594142023,36, New York,059, Nassau County,329,196,160,22,14,14,14,0,0,14,315,182,160,22,0,1129,41,1088
360594142024,36, New York,059, Nassau County,154,141,31,104,6,0,0,0,0,0,154,141,31,104,6,411,21,390
360594143011,36, New York,059, Nassau County,363,253,123,0,130,0,0,0,0,0,363,253,123,0,130,1220,125,1095
360594143012,36, New York,059, Nassau County,245,177,95,7,75,0,0,0,0,0,245,177,95,7,75,586,0,586
360594143031,36, New York,059, Nassau County,221,140,77,14,49,0,0,0,0,0,221,140,77,14,49,671,44,627
360594143032,36, New York,059, Nassau County,217,112,34,0,78,0,0,0,0,0,217,112,34,0,78,1012,0,1012
360594143033,36, New York,059, Nassau County,427,86,45,20,21,20,20,0,20,0,407,66,45,0,21,457,6,451
360594143034,36, New York,059, Nassau County,242,135,134,0,1,0,0,0,0,0,242,135,134,0,1,734,21,713
360594143041,36, New York,059, Nassau County,471,216,69,0,147,27,0,0,0,0,444,216,69,0,147,1521,118,1403
360594143042,36, New York,059, Nassau County,176,105,9,19,77,25,25,0,0,25,151,80,9,19,52,701,42,659
360594144001,36, New York,059, Nassau County,149,43,10,33,0,0,0,0,0,0,149,43,10,33,0,359,19,340
360594144002,36, New York,059, Nassau County,240,77,38,0,39,0,0,0,0,0,240,77,38,0,39,479,0,479
360594144003,36, New York,059, Nassau County,335,202,169,0,33,24,0,0,0,0,311,202,169,0,33,583,115,468
360594144004,36, New York,059, Nassau County,195,107,52,0,55,65,34,0,0,34,130,73,52,0,21,495,158,337
360594144005,36, New York,059, Nassau County,342,150,60,54,36,17,1,1,0,0,325,149,59,54,36,1083,133,950
360594145011,36, New York,059, Nassau County,386,166,108,13,45,0,0,0,0,0,386,166,108,13,45,1309,56,1253
360594145012,36, New York,059, Nassau County,470,297,234,9,54,49,0,0,0,0,421,297,234,9,54,1602,130,1472
360594145013,36, New York,059, Nassau County,228,55,43,0,12,0,0,0,0,0,228,55,43,0,12,865,47,818
360594145014,36, New York,059, Nassau County,248,131,108,0,23,23,23,0,0,23,225,108,108,0,0,716,23,693
360594145021,36, New York,059, Nassau County,445,197,141,19,37,0,0,0,0,0,445,197,141,19,37,1342,48,1294
360594145022,36, New York,059, Nassau County,269,79,20,37,22,10,10,0,0,10,259,69,20,37,12,1084,52,1032
360594145023,36, New York,059, Nassau County,115,33,33,0,0,0,0,0,0,0,115,33,33,0,0,760,30,730
360594146001,36, New York,059, Nassau County,242,114,63,21,30,0,0,0,0,0,242,114,63,21,30,879,85,794
360594146002,36, New York,059, Nassau County,311,180,169,0,11,0,0,0,0,0,311,180,169,0,11,778,11,767
360594146003,36, New York,059, Nassau County,169,39,39,0,0,0,0,0,0,0,169,39,39,0,0,617,0,617
360594146004,36, New York,059, Nassau County,195,125,116,9,0,0,0,0,0,0,195,125,116,9,0,478,1,477
360594147001,36, New York,059, Nassau County,500,234,222,0,12,7,0,0,0,0,493,234,222,0,12,1205,19,1186
360594147002,36, New York,059, Nassau County,433,155,62,0,93,20,20,0,0,20,413,135,62,0,73,1258,89,1169
360594147003,36, New York,059, Nassau County,320,182,182,0,0,38,38,38,0,0,282,144,144,0,0,955,38,917
360594148001,36, New York,059, Nassau County,236,121,121,0,0,0,0,0,0,0,236,121,121,0,0,855,28,827
360594148002,36, New York,059, Nassau County,300,176,81,0,95,0,0,0,0,0,300,176,81,0,95,964,61,903
360594148003,36, New York,059, Nassau County,318,73,61,0,12,13,0,0,0,0,305,73,61,0,12,939,25,914
360594148004,36, New York,059, Nassau County,195,57,57,0,0,18,18,18,0,0,177,39,39,0,0,579,34,545
360594148005,36, New York,059, Nassau County,319,56,39,0,17,35,0,0,0,0,284,56,39,0,17,629,70,559
360594148006,36, New York,059, Nassau County,144,104,88,16,0,0,0,0,0,0,144,104,88,16,0,360,0,360
360594148007,36, New York,059, Nassau County,305,187,187,0,0,0,0,0,0,0,305,187,187,0,0,605,12,593
360594149001,36, New York,059, Nassau County,393,293,293,0,0,0,0,0,0,0,393,293,293,0,0,996,0,996
360594149002,36, New York,059, Nassau County,341,55,55,0,0,0,0,0,0,0,341,55,55,0,0,1095,49,1046
360594149003,36, New York,059, Nassau County,340,107,107,0,0,0,0,0,0,0,340,107,107,0,0,1244,0,1244
360594149004,36, New York,059, Nassau County,458,280,280,0,0,0,0,0,0,0,458,280,280,0,0,1307,0,1307
360594149005,36, New York,059, Nassau County,224,46,46,0,0,0,0,0,0,0,224,46,46,0,0,568,7,561
360594149006,36, New York,059, Nassau County,311,242,242,0,0,0,0,0,0,0,311,242,242,0,0,776,8,768
360594150001,36, New York,059, Nassau County,387,234,234,0,0,0,0,0,0,0,387,234,234,0,0,965,18,947
360594150002,36, New York,059, Nassau County,507,249,195,0,54,0,0,0,0,0,507,249,195,0,54,1412,17,1395
360594150003,36, New York,059, Nassau County,197,24,24,0,0,0,0,0,0,0,197,24,24,0,0,638,42,596
360594150004,36, New York,059, Nassau County,171,95,35,0,60,0,0,0,0,0,171,95,35,0,60,412,0,412
360594150005,36, New York,059, Nassau County,368,181,181,0,0,30,30,30,0,0,338,151,151,0,0,984,66,918
360594151011,36, New York,059, Nassau County,427,162,105,14,43,13,9,0,0,9,414,153,105,14,34,976,12,964
360594151012,36, New York,059, Nassau County,312,98,86,0,12,3,0,0,0,0,309,98,86,0,12,877,26,851
360594151021,36, New York,059, Nassau County,376,197,197,0,0,8,0,0,0,0,368,197,197,0,0,890,17,873
360594151022,36, New York,059, Nassau County,310,202,181,0,21,0,0,0,0,0,310,202,181,0,21,687,0,687
360594151023,36, New York,059, Nassau County,230,53,53,0,0,0,0,0,0,0,230,53,53,0,0,643,0,643
360594151024,36, New York,059, Nassau County,307,68,68,0,0,0,0,0,0,0,307,68,68,0,0,782,5,777
360594151025,36, New York,059, Nassau County,309,134,65,40,29,0,0,0,0,0,309,134,65,40,29,730,0,730
360594152011,36, New York,059, Nassau County,400,161,156,0,5,0,0,0,0,0,400,161,156,0,5,1145,0,1145
360594152012,36, New York,059, Nassau County,360,206,160,35,11,10,0,0,0,0,350,206,160,35,11,847,20,827
360594152013,36, New York,059, Nassau County,224,82,82,0,0,0,0,0,0,0,224,82,82,0,0,599,3,596
360594152021,36, New York,059, Nassau County,155,98,86,12,0,0,0,0,0,0,155,98,86,12,0,576,6,570
360594152022,36, New York,059, Nassau County,208,38,24,0,14,0,0,0,0,0,208,38,24,0,14,693,0,693
360594152023,36, New York,059, Nassau County,191,87,52,33,2,0,0,0,0,0,191,87,52,33,2,495,0,495
360594152024,36, New York,059, Nassau County,594,310,289,0,21,0,0,0,0,0,594,310,289,0,21,1510,0,1510
360594153001,36, New York,059, Nassau County,230,126,117,9,0,0,0,0,0,0,230,126,117,9,0,630,0,630
360594153002,36, New York,059, Nassau County,239,140,125,0,15,10,0,0,0,0,229,140,125,0,15,656,36,620
360594153003,36, New York,059, Nassau County,191,123,123,0,0,0,0,0,0,0,191,123,123,0,0,548,0,548
360594153004,36, New York,059, Nassau County,214,82,67,0,15,0,0,0,0,0,214,82,67,0,15,679,35,644
360594153005,36, New York,059, Nassau County,152,88,57,0,31,0,0,0,0,0,152,88,57,0,31,541,18,523
360594153006,36, New York,059, Nassau County,552,187,173,0,14,0,0,0,0,0,552,187,173,0,14,1721,86,1635
360594154011,36, New York,059, Nassau County,94,38,38,0,0,0,0,0,0,0,94,38,38,0,0,326,12,314
360594154012,36, New York,059, Nassau County,149,91,59,14,18,10,10,0,0,10,139,81,59,14,8,504,37,467
360594154013,36, New York,059, Nassau County,845,383,357,0,26,28,9,9,0,0,817,374,348,0,26,2183,75,2108
360594154014,36, New York,059, Nassau County,265,29,26,0,3,0,0,0,0,0,265,29,26,0,3,962,46,916
360594154021,36, New York,059, Nassau County,591,245,219,12,14,18,6,0,0,6,573,239,219,12,8,1671,54,1617
360594154022,36, New York,059, Nassau County,357,176,176,0,0,0,0,0,0,0,357,176,176,0,0,829,0,829
360594154023,36, New York,059, Nassau County,284,198,190,0,8,0,0,0,0,0,284,198,190,0,8,810,11,799
360594155001,36, New York,059, Nassau County,428,165,146,6,13,0,0,0,0,0,428,165,146,6,13,1152,5,1147
360594155002,36, New York,059, Nassau County,325,122,110,5,7,0,0,0,0,0,325,122,110,5,7,887,2,885
360594156001,36, New York,059, Nassau County,309,127,127,0,0,2,0,0,0,0,307,127,127,0,0,910,6,904
360594156002,36, New York,059, Nassau County,209,124,111,0,13,11,0,0,0,0,198,124,111,0,13,564,48,516
360594156003,36, New York,059, Nassau County,345,179,179,0,0,0,0,0,0,0,345,179,179,0,0,895,0,895
360594156004,36, New York,059, Nassau County,224,75,75,0,0,0,0,0,0,0,224,75,75,0,0,553,0,553
360594156005,36, New York,059, Nassau County,267,91,91,0,0,0,0,0,0,0,267,91,91,0,0,738,23,715
360594156006,36, New York,059, Nassau County,136,86,60,11,15,18,18,7,11,0,118,68,53,0,15,355,52,303
360594157001,36, New York,059, Nassau County,560,374,247,33,94,12,0,0,0,0,548,374,247,33,94,1492,100,1392
360594157002,36, New York,059, Nassau County,272,144,133,0,11,18,18,18,0,0,254,126,115,0,11,704,37,667
360594157003,36, New York,059, Nassau County,361,58,36,0,22,18,0,0,0,0,343,58,36,0,22,1020,66,954
360594157004,36, New York,059, Nassau County,383,270,200,0,70,0,0,0,0,0,383,270,200,0,70,845,36,809
360594158021,36, New York,059, Nassau County,337,140,127,0,13,0,0,0,0,0,337,140,127,0,13,1107,0,1107
360594158022,36, New York,059, Nassau County,566,249,174,0,75,34,34,0,0,34,532,215,174,0,41,1718,31,1687
360594158023,36, New York,059, Nassau County,188,82,74,0,8,0,0,0,0,0,188,82,74,0,8,572,0,572
360594158024,36, New York,059, Nassau County,303,131,90,0,41,0,0,0,0,0,303,131,90,0,41,969,0,969
360594158025,36, New York,059, Nassau County,327,199,143,44,12,0,0,0,0,0,327,199,143,44,12,837,21,816
360594160001,36, New York,059, Nassau County,354,222,218,0,4,21,21,17,0,4,333,201,201,0,0,1012,37,975
360594160002,36, New York,059, Nassau County,314,78,59,0,19,19,19,0,0,19,295,59,59,0,0,848,19,829
360594160003,36, New York,059, Nassau County,275,146,115,16,15,0,0,0,0,0,275,146,115,16,15,724,13,711
360594160004,36, New York,059, Nassau County,230,76,49,0,27,0,0,0,0,0,230,76,49,0,27,732,5,727
360594161001,36, New York,059, Nassau County,341,151,151,0,0,0,0,0,0,0,341,151,151,0,0,981,21,960
360594161002,36, New York,059, Nassau County,539,199,160,0,39,0,0,0,0,0,539,199,160,0,39,1896,14,1882
360594161003,36, New York,059, Nassau County,618,376,259,0,117,0,0,0,0,0,618,376,259,0,117,1826,28,1798
360594161004,36, New York,059, Nassau County,170,96,45,0,51,0,0,0,0,0,170,96,45,0,51,605,0,605
360594162011,36, New York,059, Nassau County,346,112,78,32,2,0,0,0,0,0,346,112,78,32,2,1083,41,1042
360594162012,36, New York,059, Nassau County,298,151,125,11,15,4,4,0,0,4,294,147,125,11,11,885,35,850
360594162013,36, New York,059, Nassau County,349,84,54,0,30,15,6,6,0,0,334,78,48,0,30,1064,55,1009
360594162021,36, New York,059, Nassau County,148,27,27,0,0,14,0,0,0,0,134,27,27,0,0,776,47,729
360594162022,36, New York,059, Nassau County,318,79,44,0,35,12,12,12,0,0,306,67,32,0,35,978,45,933
360594162023,36, New York,059, Nassau County,241,69,69,0,0,0,0,0,0,0,241,69,69,0,0,629,57,572
360594162024,36, New York,059, Nassau County,429,251,150,0,101,43,43,0,0,43,386,208,150,0,58,983,134,849
360594163001,36, New York,059, Nassau County,417,148,148,0,0,24,24,24,0,0,393,124,124,0,0,1102,11,1091
360594163002,36, New York,059, Nassau County,151,0,0,0,0,0,0,0,0,0,151,0,0,0,0,361,0,361
360594163003,36, New York,059, Nassau County,199,47,47,0,0,0,0,0,0,0,199,47,47,0,0,553,2,551
360594163004,36, New York,059, Nassau County,174,80,74,0,6,4,0,0,0,0,170,80,74,0,6,474,11,463
360594164011,36, New York,059, Nassau County,276,121,107,0,14,0,0,0,0,0,276,121,107,0,14,1157,36,1121
360594164012,36, New York,059, Nassau County,374,188,114,0,74,20,20,20,0,0,354,168,94,0,74,1944,89,1855
360594164013,36, New York,059, Nassau County,160,55,55,0,0,0,0,0,0,0,160,55,55,0,0,695,40,655
360594164021,36, New York,059, Nassau County,197,93,93,0,0,0,0,0,0,0,197,93,93,0,0,701,7,694
360594164022,36, New York,059, Nassau County,374,132,126,0,6,0,0,0,0,0,374,132,126,0,6,1276,11,1265
360594165001,36, New York,059, Nassau County,217,145,49,0,96,66,66,0,0,66,151,79,49,0,30,647,0,647
360594165002,36, New York,059, Nassau County,217,177,32,0,145,60,60,0,0,60,157,117,32,0,85,635,101,534
360594165003,36, New York,059, Nassau County,356,106,36,59,11,0,0,0,0,0,356,106,36,59,11,1794,66,1728
360594165004,36, New York,059, Nassau County,318,124,86,0,38,0,0,0,0,0,318,124,86,0,38,688,0,688
360594165005,36, New York,059, Nassau County,390,179,179,0,0,0,0,0,0,0,390,179,179,0,0,936,18,918
360594166001,36, New York,059, Nassau County,221,19,0,0,19,16,0,0,0,0,205,19,0,0,19,751,32,719
360594166002,36, New York,059, Nassau County,252,65,65,0,0,0,0,0,0,0,252,65,65,0,0,1085,23,1062
360594166003,36, New York,059, Nassau County,88,11,11,0,0,0,0,0,0,0,88,11,11,0,0,306,0,306
360594166004,36, New York,059, Nassau County,128,68,44,0,24,0,0,0,0,0,128,68,44,0,24,617,82,535
360594166005,36, New York,059, Nassau County,146,52,11,41,0,0,0,0,0,0,146,52,11,41,0,481,49,432
360594166006,36, New York,059, Nassau County,258,179,108,0,71,0,0,0,0,0,258,179,108,0,71,1003,50,953
360594167011,36, New York,059, Nassau County,318,56,56,0,0,0,0,0,0,0,318,56,56,0,0,845,0,845
360594167012,36, New York,059, Nassau County,302,68,57,0,11,0,0,0,0,0,302,68,57,0,11,1204,68,1136
360594167013,36, New York,059, Nassau County,152,59,59,0,0,0,0,0,0,0,152,59,59,0,0,380,21,359
360594167014,36, New York,059, Nassau County,227,113,57,0,56,22,11,0,0,11,205,102,57,0,45,587,34,553
360594167015,36, New York,059, Nassau County,267,107,68,0,39,0,0,0,0,0,267,107,68,0,39,881,30,851
360594167021,36, New York,059, Nassau County,249,0,0,0,0,0,0,0,0,0,249,0,0,0,0,1201,25,1176
360594167022,36, New York,059, Nassau County,361,58,51,0,7,7,7,0,0,7,354,51,51,0,0,1099,33,1066
360594167023,36, New York,059, Nassau County,412,122,82,29,11,25,12,0,9,3,387,110,82,20,8,1409,140,1269
360594168011,36, New York,059, Nassau County,314,108,84,18,6,22,0,0,0,0,292,108,84,18,6,980,73,907
360594168012,36, New York,059, Nassau County,281,143,123,15,5,0,0,0,0,0,281,143,123,15,5,727,9,718
360594168021,36, New York,059, Nassau County,341,119,74,0,45,17,0,0,0,0,324,119,74,0,45,1658,115,1543
360594168022,36, New York,059, Nassau County,609,174,152,0,22,0,0,0,0,0,609,174,152,0,22,1846,89,1757
360594169001,36, New York,059, Nassau County,310,40,40,0,0,83,0,0,0,0,227,40,40,0,0,971,113,858
360594169002,36, New York,059, Nassau County,399,146,118,0,28,9,9,9,0,0,390,137,109,0,28,1184,95,1089
360594169003,36, New York,059, Nassau County,264,52,42,10,0,16,0,0,0,0,248,52,42,10,0,909,61,848
360595170001,36, New York,059, Nassau County,462,148,73,0,75,21,0,0,0,0,441,148,73,0,75,1144,105,1039
360595170002,36, New York,059, Nassau County,194,57,41,0,16,16,16,0,0,16,178,41,41,0,0,512,27,485
360595170003,36, New York,059, Nassau County,394,107,73,27,7,24,0,0,0,0,370,107,73,27,7,903,46,857
360595171011,36, New York,059, Nassau County,286,139,112,0,27,27,27,0,0,27,259,112,112,0,0,960,123,837
360595171012,36, New York,059, Nassau County,301,170,54,68,48,13,0,0,0,0,288,170,54,68,48,838,138,700
360595171013,36, New York,059, Nassau County,277,63,63,0,0,0,0,0,0,0,277,63,63,0,0,1131,48,1083
360595171014,36, New York,059, Nassau County,248,58,43,0,15,48,7,0,0,7,200,51,43,0,8,779,79,700
360595171015,36, New York,059, Nassau County,162,110,82,0,28,28,28,0,0,28,134,82,82,0,0,289,50,239
360595171021,36, New York,059, Nassau County,307,91,66,0,25,0,0,0,0,0,307,91,66,0,25,879,21,858
360595171022,36, New York,059, Nassau County,350,134,125,0,9,0,0,0,0,0,350,134,125,0,9,996,15,981
360595172011,36, New York,059, Nassau County,507,372,232,41,99,86,75,75,0,0,421,297,157,41,99,1495,391,1104
360595172012,36, New York,059, Nassau County,207,117,0,0,117,93,83,0,0,83,114,34,0,0,34,559,123,436
360595172013,36, New York,059, Nassau County,87,65,0,0,65,18,18,0,0,18,69,47,0,0,47,279,99,180
360595172021,36, New York,059, Nassau County,426,61,21,40,0,135,0,0,0,0,291,61,21,40,0,1321,364,957
360595172022,36, New York,059, Nassau County,545,346,118,0,228,293,228,0,0,228,252,118,118,0,0,827,112,715
360595173011,36, New York,059, Nassau County,360,136,98,38,0,0,0,0,0,0,360,136,98,38,0,929,36,893
360595173012,36, New York,059, Nassau County,168,44,11,0,33,33,33,0,0,33,135,11,11,0,0,583,66,517
360595173013,36, New York,059, Nassau County,376,142,129,13,0,0,0,0,0,0,376,142,129,13,0,1088,14,1074
360595173021,36, New York,059, Nassau County,412,280,116,133,31,27,27,27,0,0,385,253,89,133,31,696,57,639
360595173022,36, New York,059, Nassau County,210,135,108,0,27,0,0,0,0,0,210,135,108,0,27,449,22,427
360595173023,36, New York,059, Nassau County,340,130,81,0,49,0,0,0,0,0,340,130,81,0,49,1116,212,904
360595173024,36, New York,059, Nassau County,464,134,76,0,58,34,34,0,0,34,430,100,76,0,24,1066,19,1047
360595174001,36, New York,059, Nassau County,347,154,130,24,0,12,0,0,0,0,335,154,130,24,0,979,59,920
360595174002,36, New York,059, Nassau County,436,294,282,12,0,0,0,0,0,0,436,294,282,12,0,960,0,960
360595174003,36, New York,059, Nassau County,213,111,93,0,18,0,0,0,0,0,213,111,93,0,18,635,31,604
360595174004,36, New York,059, Nassau County,137,31,20,11,0,0,0,0,0,0,137,31,20,11,0,553,0,553
360595174005,36, New York,059, Nassau County,215,72,63,0,9,0,0,0,0,0,215,72,63,0,9,538,7,531
360595175001,36, New York,059, Nassau County,329,113,100,0,13,0,0,0,0,0,329,113,100,0,13,1050,0,1050
360595175002,36, New York,059, Nassau County,424,201,117,0,84,0,0,0,0,0,424,201,117,0,84,1260,41,1219
360595175003,36, New York,059, Nassau County,275,171,117,10,44,12,12,0,0,12,263,159,117,10,32,648,53,595
360595176001,36, New York,059, Nassau County,197,135,94,0,41,0,0,0,0,0,197,135,94,0,41,588,22,566
360595176002,36, New York,059, Nassau County,442,115,94,0,21,0,0,0,0,0,442,115,94,0,21,1314,17,1297
360595176003,36, New York,059, Nassau County,179,103,44,0,59,12,12,0,0,12,167,91,44,0,47,545,8,537
360595176004,36, New York,059, Nassau County,400,187,187,0,0,0,0,0,0,0,400,187,187,0,0,1074,24,1050
360595177011,36, New York,059, Nassau County,356,188,181,0,7,2,0,0,0,0,354,188,181,0,7,861,13,848
360595177012,36, New York,059, Nassau County,685,327,292,15,20,30,14,0,0,14,655,313,292,15,6,1570,53,1517
360595177013,36, New York,059, Nassau County,545,210,205,5,0,0,0,0,0,0,545,210,205,5,0,1452,3,1449
360595177014,36, New York,059, Nassau County,663,217,192,0,25,15,15,15,0,0,648,202,177,0,25,1522,44,1478
360595177051,36, New York,059, Nassau County,878,493,466,5,22,17,13,8,0,5,861,480,458,5,17,1862,23,1839
360595178011,36, New York,059, Nassau County,417,229,219,0,10,3,3,0,0,3,414,226,219,0,7,1005,30,975
360595178012,36, New York,059, Nassau County,412,129,114,0,15,36,3,0,0,3,376,126,114,0,12,1088,76,1012
360595178013,36, New York,059, Nassau County,337,144,122,3,19,21,18,8,3,7,316,126,114,0,12,891,27,864
360595178021,36, New York,059, Nassau County,279,97,87,0,10,0,0,0,0,0,279,97,87,0,10,726,44,682
360595178022,36, New York,059, Nassau County,280,52,52,0,0,35,12,12,0,0,245,40,40,0,0,696,34,662
360595178023,36, New York,059, Nassau County,457,316,211,0,105,0,0,0,0,0,457,316,211,0,105,978,18,960
360595179011,36, New York,059, Nassau County,442,223,197,0,26,13,13,0,0,13,429,210,197,0,13,1160,13,1147
360595179012,36, New York,059, Nassau County,563,199,191,0,8,8,0,0,0,0,555,199,191,0,8,1843,113,1730
360595179013,36, New York,059, Nassau County,338,115,115,0,0,0,0,0,0,0,338,115,115,0,0,942,53,889
360595179021,36, New York,059, Nassau County,809,152,119,3,30,19,3,0,3,0,790,149,119,0,30,2355,102,2253
360595180001,36, New York,059, Nassau County,119,106,106,0,0,0,0,0,0,0,119,106,106,0,0,145,0,145
360595180002,36, New York,059, Nassau County,118,56,56,0,0,41,41,41,0,0,77,15,15,0,0,633,198,435
360595180003,36, New York,059, Nassau County,177,105,105,0,0,0,0,0,0,0,177,105,105,0,0,647,66,581
360595180004,36, New York,059, Nassau County,364,85,85,0,0,0,0,0,0,0,364,85,85,0,0,1352,11,1341
360595180005,36, New York,059, Nassau County,394,330,165,47,118,67,67,0,0,67,327,263,165,47,51,851,67,784
360595180006,36, New York,059, Nassau County,282,70,70,0,0,0,0,0,0,0,282,70,70,0,0,1210,186,1024
360595181001,36, New York,059, Nassau County,185,98,98,0,0,0,0,0,0,0,185,98,98,0,0,666,44,622
360595181002,36, New York,059, Nassau County,302,129,129,0,0,0,0,0,0,0,302,129,129,0,0,748,26,722
360595181003,36, New York,059, Nassau County,247,147,147,0,0,0,0,0,0,0,247,147,147,0,0,634,25,609
360595182011,36, New York,059, Nassau County,301,57,48,5,4,4,4,0,0,4,297,53,48,5,0,882,54,828
360595182012,36, New York,059, Nassau County,449,192,178,14,0,14,13,13,0,0,435,179,165,14,0,1247,96,1151
360595182013,36, New York,059, Nassau County,405,210,201,5,4,6,6,2,0,4,399,204,199,5,0,1077,30,1047
360595182031,36, New York,059, Nassau County,293,183,171,0,12,11,0,0,0,0,282,183,171,0,12,989,81,908
360595182032,36, New York,059, Nassau County,183,57,57,0,0,0,0,0,0,0,183,57,57,0,0,563,55,508
360595182033,36, New York,059, Nassau County,392,143,83,0,60,13,13,13,0,0,379,130,70,0,60,1031,13,1018
360595182041,36, New York,059, Nassau County,476,177,177,0,0,0,0,0,0,0,476,177,177,0,0,1196,25,1171
360595182042,36, New York,059, Nassau County,471,201,191,0,10,11,11,11,0,0,460,190,180,0,10,1212,56,1156
360595182043,36, New York,059, Nassau County,482,209,183,0,26,0,0,0,0,0,482,209,183,0,26,1163,9,1154
360595183001,36, New York,059, Nassau County,263,152,152,0,0,29,29,29,0,0,234,123,123,0,0,666,44,622
360595183002,36, New York,059, Nassau County,407,180,180,0,0,38,13,13,0,0,369,167,167,0,0,1093,171,922
360595183003,36, New York,059, Nassau County,449,331,331,0,0,0,0,0,0,0,449,331,331,0,0,1010,4,1006
360595183004,36, New York,059, Nassau County,430,236,182,46,8,0,0,0,0,0,430,236,182,46,8,1061,10,1051
360595184001,36, New York,059, Nassau County,282,178,178,0,0,0,0,0,0,0,282,178,178,0,0,574,20,554
360595184002,36, New York,059, Nassau County,321,168,117,51,0,0,0,0,0,0,321,168,117,51,0,952,44,908
360595184003,36, New York,059, Nassau County,597,357,337,0,20,11,11,0,0,11,586,346,337,0,9,1394,75,1319
360595185011,36, New York,059, Nassau County,413,201,201,0,0,0,0,0,0,0,413,201,201,0,0,1165,133,1032
360595185012,36, New York,059, Nassau County,763,336,282,0,54,24,24,24,0,0,739,312,258,0,54,1674,58,1616
360595185013,36, New York,059, Nassau County,587,340,262,0,78,0,0,0,0,0,587,340,262,0,78,1462,0,1462
360595185021,36, New York,059, Nassau County,173,91,68,23,0,0,0,0,0,0,173,91,68,23,0,549,16,533
360595185022,36, New York,059, Nassau County,330,95,80,0,15,11,0,0,0,0,319,95,80,0,15,1244,49,1195
360595185023,36, New York,059, Nassau County,161,113,111,2,0,10,10,8,2,0,151,103,103,0,0,251,55,196
360595186001,36, New York,059, Nassau County,274,101,93,0,8,10,0,0,0,0,264,101,93,0,8,716,29,687
360595186002,36, New York,059, Nassau County,376,176,140,9,27,6,6,0,0,6,370,170,140,9,21,866,40,826
360595186003,36, New York,059, Nassau County,367,200,188,12,0,0,0,0,0,0,367,200,188,12,0,784,0,784
360595186004,36, New York,059, Nassau County,199,118,118,0,0,0,0,0,0,0,199,118,118,0,0,380,0,380
360595187001,36, New York,059, Nassau County,288,169,169,0,0,0,0,0,0,0,288,169,169,0,0,634,16,618
360595187002,36, New York,059, Nassau County,329,151,124,9,18,77,0,0,0,0,252,151,124,9,18,746,131,615
360595187003,36, New York,059, Nassau County,277,107,107,0,0,0,0,0,0,0,277,107,107,0,0,774,13,761
360595187004,36, New York,059, Nassau County,201,79,62,0,17,7,7,0,0,7,194,72,62,0,10,526,0,526
360595187005,36, New York,059, Nassau County,154,111,103,0,8,8,8,0,0,8,146,103,103,0,0,399,8,391
360595187006,36, New York,059, Nassau County,314,215,208,0,7,24,0,0,0,0,290,215,208,0,7,687,67,620
360595188001,36, New York,059, Nassau County,169,61,61,0,0,0,0,0,0,0,169,61,61,0,0,479,7,472
360595188002,36, New York,059, Nassau County,356,221,221,0,0,11,0,0,0,0,345,221,221,0,0,805,26,779
360595188003,36, New York,059, Nassau County,346,178,159,0,19,19,19,0,0,19,327,159,159,0,0,933,38,895
360595189001,36, New York,059, Nassau County,171,31,31,0,0,0,0,0,0,0,171,31,31,0,0,546,25,521
360595189002,36, New York,059, Nassau County,92,13,13,0,0,0,0,0,0,0,92,13,13,0,0,370,16,354
360595189003,36, New York,059, Nassau County,380,285,285,0,0,0,0,0,0,0,380,285,285,0,0,1038,9,1029
360595189004,36, New York,059, Nassau County,237,55,55,0,0,0,0,0,0,0,237,55,55,0,0,899,16,883
360595189005,36, New York,059, Nassau County,323,128,128,0,0,68,68,68,0,0,255,60,60,0,0,903,86,817
360595189006,36, New York,059, Nassau County,422,212,212,0,0,0,0,0,0,0,422,212,212,0,0,1179,8,1171
360595190001,36, New York,059, Nassau County,481,142,108,34,0,0,0,0,0,0,481,142,108,34,0,978,0,978
360595190002,36, New York,059, Nassau County,202,155,102,53,0,0,0,0,0,0,202,155,102,53,0,269,0,269
360595190003,36, New York,059, Nassau County,281,149,121,28,0,0,0,0,0,0,281,149,121,28,0,813,2,811
360595190004,36, New York,059, Nassau County,103,46,46,0,0,0,0,0,0,0,103,46,46,0,0,254,29,225
360595190005,36, New York,059, Nassau County,312,137,128,0,9,0,0,0,0,0,312,137,128,0,9,899,12,887
360595190006,36, New York,059, Nassau County,306,78,75,3,0,0,0,0,0,0,306,78,75,3,0,1201,15,1186
360595191001,36, New York,059, Nassau County,248,60,29,31,0,14,0,0,0,0,234,60,29,31,0,632,33,599
360595191002,36, New York,059, Nassau County,202,69,31,19,19,0,0,0,0,0,202,69,31,19,19,739,21,718
360595191003,36, New York,059, Nassau County,219,91,51,0,40,0,0,0,0,0,219,91,51,0,40,491,0,491
360595191004,36, New York,059, Nassau County,159,43,43,0,0,0,0,0,0,0,159,43,43,0,0,774,0,774
360595191005,36, New York,059, Nassau County,350,118,118,0,0,0,0,0,0,0,350,118,118,0,0,834,20,814
360595191006,36, New York,059, Nassau County,507,131,84,47,0,177,0,0,0,0,330,131,84,47,0,1172,195,977
360595192001,36, New York,059, Nassau County,492,133,133,0,0,57,0,0,0,0,435,133,133,0,0,1711,218,1493
360595192002,36, New York,059, Nassau County,190,100,91,0,9,0,0,0,0,0,190,100,91,0,9,470,0,470
360595192003,36, New York,059, Nassau County,145,109,99,0,10,0,0,0,0,0,145,109,99,0,10,347,0,347
360595192004,36, New York,059, Nassau County,350,165,157,0,8,7,0,0,0,0,343,165,157,0,8,1000,40,960
360595192005,36, New York,059, Nassau County,257,107,46,41,20,0,0,0,0,0,257,107,46,41,20,599,2,597
360595192006,36, New York,059, Nassau County,241,108,76,32,0,0,0,0,0,0,241,108,76,32,0,622,9,613
360595193001,36, New York,059, Nassau County,150,80,70,0,10,0,0,0,0,0,150,80,70,0,10,701,147,554
360595193002,36, New York,059, Nassau County,454,184,59,125,0,101,101,0,101,0,353,83,59,24,0,1176,122,1054
360595193003,36, New York,059, Nassau County,273,110,110,0,0,0,0,0,0,0,273,110,110,0,0,940,23,917
360595193004,36, New York,059, Nassau County,350,168,155,0,13,0,0,0,0,0,350,168,155,0,13,1086,0,1086
360595193005,36, New York,059, Nassau County,232,13,13,0,0,13,0,0,0,0,219,13,13,0,0,712,22,690
360595194001,36, New York,059, Nassau County,530,76,56,0,20,0,0,0,0,0,530,76,56,0,20,1226,0,1226
360595194002,36, New York,059, Nassau County,161,49,49,0,0,0,0,0,0,0,161,49,49,0,0,554,27,527
360595194003,36, New York,059, Nassau County,272,112,78,0,34,0,0,0,0,0,272,112,78,0,34,808,11,797
360595194004,36, New York,059, Nassau County,315,94,94,0,0,54,0,0,0,0,261,94,94,0,0,957,95,862
360595195001,36, New York,059, Nassau County,307,129,116,0,13,0,0,0,0,0,307,129,116,0,13,755,8,747
360595195002,36, New York,059, Nassau County,173,29,18,11,0,9,0,0,0,0,164,29,18,11,0,632,65,567
360595195003,36, New York,059, Nassau County,417,113,98,0,15,25,15,0,0,15,392,98,98,0,0,1157,59,1098
360595195004,36, New York,059, Nassau County,232,95,85,10,0,29,10,0,10,0,203,85,85,0,0,664,73,591
360595195005,36, New York,059, Nassau County,450,313,276,37,0,0,0,0,0,0,450,313,276,37,0,1048,9,1039
360595196011,36, New York,059, Nassau County,525,220,205,0,15,24,24,9,0,15,501,196,196,0,0,1395,39,1356
360595196012,36, New York,059, Nassau County,214,69,69,0,0,0,0,0,0,0,214,69,69,0,0,509,3,506
360595196013,36, New York,059, Nassau County,229,129,129,0,0,0,0,0,0,0,229,129,129,0,0,603,0,603
360595196014,36, New York,059, Nassau County,257,165,155,0,10,0,0,0,0,0,257,165,155,0,10,767,8,759
360595196021,36, New York,059, Nassau County,259,121,97,4,20,4,4,4,0,0,255,117,93,4,20,590,29,561
360595196022,36, New York,059, Nassau County,338,142,142,0,0,0,0,0,0,0,338,142,142,0,0,794,2,792
360595197021,36, New York,059, Nassau County,599,275,275,0,0,0,0,0,0,0,599,275,275,0,0,1553,168,1385
360595197022,36, New York,059, Nassau County,152,68,67,1,0,15,15,15,0,0,137,53,52,1,0,502,63,439
360595197023,36, New York,059, Nassau County,549,228,228,0,0,0,0,0,0,0,549,228,228,0,0,1398,0,1398
360595197024,36, New York,059, Nassau County,254,152,144,0,8,0,0,0,0,0,254,152,144,0,8,683,64,619
360595197031,36, New York,059, Nassau County,368,242,231,0,11,0,0,0,0,0,368,242,231,0,11,940,0,940
360595197032,36, New York,059, Nassau County,357,137,115,0,22,0,0,0,0,0,357,137,115,0,22,924,0,924
360595197033,36, New York,059, Nassau County,229,91,91,0,0,0,0,0,0,0,229,91,91,0,0,665,0,665
360595197041,36, New York,059, Nassau County,427,197,149,9,39,0,0,0,0,0,427,197,149,9,39,1094,5,1089
360595197042,36, New York,059, Nassau County,269,125,101,10,14,0,0,0,0,0,269,125,101,10,14,637,16,621
360595197043,36, New York,059, Nassau County,140,77,77,0,0,6,0,0,0,0,134,77,77,0,0,473,29,444
360595198011,36, New York,059, Nassau County,291,172,161,0,11,0,0,0,0,0,291,172,161,0,11,782,20,762
360595198012,36, New York,059, Nassau County,372,174,169,5,0,0,0,0,0,0,372,174,169,5,0,953,12,941
360595198021,36, New York,059, Nassau County,305,76,54,0,22,0,0,0,0,0,305,76,54,0,22,992,18,974
360595198022,36, New York,059, Nassau County,405,255,233,12,10,0,0,0,0,0,405,255,233,12,10,916,0,916
360595198023,36, New York,059, Nassau County,393,267,222,0,45,12,12,12,0,0,381,255,210,0,45,1004,39,965
360595198024,36, New York,059, Nassau County,311,134,123,11,0,0,0,0,0,0,311,134,123,11,0,783,0,783
360595199001,36, New York,059, Nassau County,187,78,78,0,0,0,0,0,0,0,187,78,78,0,0,622,25,597
360595199002,36, New York,059, Nassau County,694,244,206,38,0,60,38,0,38,0,634,206,206,0,0,1711,109,1602
360595199003,36, New York,059, Nassau County,263,112,112,0,0,0,0,0,0,0,263,112,112,0,0,740,0,740
360595199004,36, New York,059, Nassau County,167,47,47,0,0,0,0,0,0,0,167,47,47,0,0,525,47,478
360595199005,36, New York,059, Nassau County,220,102,95,0,7,16,0,0,0,0,204,102,95,0,7,628,68,560
360595200011,36, New York,059, Nassau County,438,46,46,0,0,0,0,0,0,0,438,46,46,0,0,1495,15,1480
360595200012,36, New York,059, Nassau County,529,203,193,0,10,0,0,0,0,0,529,203,193,0,10,1460,0,1460
360595200013,36, New York,059, Nassau County,282,131,103,12,16,0,0,0,0,0,282,131,103,12,16,778,18,760
360595200014,36, New York,059, Nassau County,383,202,103,18,81,41,0,0,0,0,342,202,103,18,81,1091,125,966
360595200015,36, New York,059, Nassau County,295,152,152,0,0,0,0,0,0,0,295,152,152,0,0,793,0,793
360595200021,36, New York,059, Nassau County,170,69,53,8,8,8,8,0,0,8,162,61,53,8,0,572,8,564
360595200022,36, New York,059, Nassau County,360,199,188,0,11,0,0,0,0,0,360,199,188,0,11,1125,11,1114
360595200023,36, New York,059, Nassau County,320,124,98,0,26,4,4,4,0,0,316,120,94,0,26,806,49,757
360595200024,36, New York,059, Nassau County,352,105,63,0,42,0,0,0,0,0,352,105,63,0,42,900,17,883
360595201001,36, New York,059, Nassau County,260,153,153,0,0,0,0,0,0,0,260,153,153,0,0,497,10,487
360595201002,36, New York,059, Nassau County,168,24,24,0,0,0,0,0,0,0,168,24,24,0,0,461,9,452
360595201003,36, New York,059, Nassau County,281,165,147,0,18,15,0,0,0,0,266,165,147,0,18,716,29,687
360595201004,36, New York,059, Nassau County,626,95,95,0,0,27,0,0,0,0,599,95,95,0,0,1591,54,1537
360595201005,36, New York,059, Nassau County,290,131,92,34,5,0,0,0,0,0,290,131,92,34,5,1089,63,1026
360595202001,36, New York,059, Nassau County,281,171,156,0,15,15,15,0,0,15,266,156,156,0,0,743,34,709
360595202002,36, New York,059, Nassau County,164,75,56,0,19,0,0,0,0,0,164,75,56,0,19,430,0,430
360595202003,36, New York,059, Nassau County,243,153,102,4,47,35,35,35,0,0,208,118,67,4,47,589,90,499
360595202004,36, New York,059, Nassau County,165,22,8,0,14,0,0,0,0,0,165,22,8,0,14,682,8,674
360595203001,36, New York,059, Nassau County,134,69,69,0,0,0,0,0,0,0,134,69,69,0,0,563,0,563
360595203002,36, New York,059, Nassau County,242,147,147,0,0,0,0,0,0,0,242,147,147,0,0,769,78,691
360595203003,36, New York,059, Nassau County,258,109,109,0,0,9,9,9,0,0,249,100,100,0,0,586,0,586
360595203004,36, New York,059, Nassau County,86,30,30,0,0,0,0,0,0,0,86,30,30,0,0,254,14,240
360595203005,36, New York,059, Nassau County,149,51,39,12,0,16,0,0,0,0,133,51,39,12,0,546,114,432
360595203006,36, New York,059, Nassau County,236,112,112,0,0,0,0,0,0,0,236,112,112,0,0,799,0,799
360595203007,36, New York,059, Nassau County,332,142,126,0,16,0,0,0,0,0,332,142,126,0,16,786,6,780
360595204011,36, New York,059, Nassau County,305,106,84,0,22,0,0,0,0,0,305,106,84,0,22,1094,36,1058
360595204012,36, New York,059, Nassau County,198,86,68,0,18,16,11,0,0,11,182,75,68,0,7,668,30,638
360595204013,36, New York,059, Nassau County,350,109,109,0,0,0,0,0,0,0,350,109,109,0,0,940,0,940
360595204014,36, New York,059, Nassau County,196,130,60,60,10,2,0,0,0,0,194,130,60,60,10,608,81,527
360595204021,36, New York,059, Nassau County,282,187,156,22,9,9,9,0,0,9,273,178,156,22,0,815,21,794
360595204022,36, New York,059, Nassau County,405,193,159,34,0,0,0,0,0,0,405,193,159,34,0,1153,9,1144
360595204023,36, New York,059, Nassau County,299,120,88,0,32,20,20,0,0,20,279,100,88,0,12,1223,121,1102
360595205011,36, New York,059, Nassau County,197,99,77,12,10,12,0,0,0,0,185,99,77,12,10,749,85,664
360595205012,36, New York,059, Nassau County,289,109,57,0,52,0,0,0,0,0,289,109,57,0,52,962,25,937
360595205013,36, New York,059, Nassau County,189,103,35,24,44,0,0,0,0,0,189,103,35,24,44,663,15,648
360595205014,36, New York,059, Nassau County,250,88,61,0,27,7,7,0,0,7,243,81,61,0,20,894,10,884
360595205021,36, New York,059, Nassau County,257,71,71,0,0,0,0,0,0,0,257,71,71,0,0,683,9,674
360595205022,36, New York,059, Nassau County,292,133,81,30,22,17,5,0,0,5,275,128,81,30,17,942,46,896
360595205023,36, New York,059, Nassau County,361,139,139,0,0,17,17,17,0,0,344,122,122,0,0,1028,57,971
360595205024,36, New York,059, Nassau County,241,61,34,6,21,22,0,0,0,0,219,61,34,6,21,721,72,649
360595205025,36, New York,059, Nassau County,277,104,95,0,9,0,0,0,0,0,277,104,95,0,9,743,17,726
360595206001,36, New York,059, Nassau County,423,168,168,0,0,0,0,0,0,0,423,168,168,0,0,1436,41,1395
360595206002,36, New York,059, Nassau County,268,89,86,0,3,8,0,0,0,0,260,89,86,0,3,846,17,829
360595206003,36, New York,059, Nassau County,132,67,67,0,0,0,0,0,0,0,132,67,67,0,0,405,65,340
360595206004,36, New York,059, Nassau County,285,142,122,0,20,0,0,0,0,0,285,142,122,0,20,573,10,563
360595206005,36, New York,059, Nassau County,204,53,53,0,0,0,0,0,0,0,204,53,53,0,0,604,9,595
360595206006,36, New York,059, Nassau County,240,72,72,0,0,0,0,0,0,0,240,72,72,0,0,693,0,693
360595207001,36, New York,059, Nassau County,220,50,50,0,0,11,11,11,0,0,209,39,39,0,0,963,153,810
360595207002,36, New York,059, Nassau County,302,100,89,0,11,0,0,0,0,0,302,100,89,0,11,945,10,935
360595207003,36, New York,059, Nassau County,450,233,212,0,21,10,10,10,0,0,440,223,202,0,21,1246,20,1226
360595207004,36, New York,059, Nassau County,252,95,41,0,54,0,0,0,0,0,252,95,41,0,54,716,42,674
360595208001,36, New York,059, Nassau County,214,43,32,4,7,0,0,0,0,0,214,43,32,4,7,653,5,648
360595208002,36, New York,059, Nassau County,252,91,91,0,0,25,0,0,0,0,227,91,91,0,0,858,69,789
360595208003,36, New York,059, Nassau County,286,176,176,0,0,0,0,0,0,0,286,176,176,0,0,833,0,833
360595208004,36, New York,059, Nassau County,347,114,56,0,58,0,0,0,0,0,347,114,56,0,58,975,7,968
360595209001,36, New York,059, Nassau County,223,123,123,0,0,0,0,0,0,0,223,123,123,0,0,530,0,530
360595209002,36, New York,059, Nassau County,296,116,86,0,30,0,0,0,0,0,296,116,86,0,30,754,0,754
360595209003,36, New York,059, Nassau County,272,74,74,0,0,26,0,0,0,0,246,74,74,0,0,700,58,642
360595209004,36, New York,059, Nassau County,192,56,56,0,0,7,0,0,0,0,185,56,56,0,0,726,26,700
360595209005,36, New York,059, Nassau County,290,96,36,30,30,21,21,0,0,21,269,75,36,30,9,1006,196,810
360595210001,36, New York,059, Nassau County,222,40,22,18,0,7,7,0,7,0,215,33,22,11,0,788,14,774
360595210002,36, New York,059, Nassau County,141,19,19,0,0,6,0,0,0,0,135,19,19,0,0,429,22,407
360595210003,36, New York,059, Nassau County,285,186,177,0,9,0,0,0,0,0,285,186,177,0,9,943,41,902
360595210004,36, New York,059, Nassau County,242,56,56,0,0,76,0,0,0,0,166,56,56,0,0,548,0,548
360595210005,36, New York,059, Nassau County,355,174,121,8,45,0,0,0,0,0,355,174,121,8,45,879,0,879
360595211001,36, New York,059, Nassau County,213,113,113,0,0,0,0,0,0,0,213,113,113,0,0,814,57,757
360595211002,36, New York,059, Nassau County,172,67,51,0,16,0,0,0,0,0,172,67,51,0,16,650,0,650
360595211003,36, New York,059, Nassau County,291,116,91,0,25,10,0,0,0,0,281,116,91,0,25,823,31,792
360595211004,36, New York,059, Nassau County,294,133,95,0,38,27,27,0,0,27,267,106,95,0,11,701,38,663
360595211005,36, New York,059, Nassau County,146,92,92,0,0,0,0,0,0,0,146,92,92,0,0,492,26,466
360595212001,36, New York,059, Nassau County,285,128,128,0,0,0,0,0,0,0,285,128,128,0,0,797,0,797
360595212002,36, New York,059, Nassau County,117,28,20,0,8,0,0,0,0,0,117,28,20,0,8,434,0,434
360595212003,36, New York,059, Nassau County,373,151,128,0,23,9,9,0,0,9,364,142,128,0,14,997,37,960
360595213011,36, New York,059, Nassau County,294,122,100,0,22,0,0,0,0,0,294,122,100,0,22,852,10,842
360595213012,36, New York,059, Nassau County,424,207,180,7,20,0,0,0,0,0,424,207,180,7,20,1209,66,1143
360595213021,36, New York,059, Nassau County,386,148,138,0,10,8,0,0,0,0,378,148,138,0,10,1140,24,1116
360595213022,36, New York,059, Nassau County,688,193,193,0,0,43,26,26,0,0,645,167,167,0,0,2020,130,1890
360595213023,36, New York,059, Nassau County,194,78,78,0,0,0,0,0,0,0,194,78,78,0,0,486,0,486
360595213024,36, New York,059, Nassau County,261,156,147,9,0,12,0,0,0,0,249,156,147,9,0,688,68,620
360595214001,36, New York,059, Nassau County,316,116,116,0,0,0,0,0,0,0,316,116,116,0,0,1086,75,1011
360595214002,36, New York,059, Nassau County,299,167,167,0,0,0,0,0,0,0,299,167,167,0,0,664,0,664
360595214003,36, New York,059, Nassau County,389,124,124,0,0,0,0,0,0,0,389,124,124,0,0,1021,0,1021
360595214004,36, New York,059, Nassau County,381,214,174,0,40,0,0,0,0,0,381,214,174,0,40,925,9,916
360595214005,36, New York,059, Nassau County,342,91,91,0,0,0,0,0,0,0,342,91,91,0,0,1189,0,1189
360595215001,36, New York,059, Nassau County,287,65,65,0,0,32,11,11,0,0,255,54,54,0,0,793,145,648
360595215002,36, New York,059, Nassau County,259,58,58,0,0,0,0,0,0,0,259,58,58,0,0,723,27,696
360595215003,36, New York,059, Nassau County,342,118,118,0,0,12,0,0,0,0,330,118,118,0,0,991,29,962
360595215004,36, New York,059, Nassau County,224,120,120,0,0,0,0,0,0,0,224,120,120,0,0,591,23,568
360595215005,36, New York,059, Nassau County,413,168,162,0,6,41,41,41,0,0,372,127,121,0,6,915,49,866
360595216011,36, New York,059, Nassau County,226,85,78,0,7,0,0,0,0,0,226,85,78,0,7,663,8,655
360595216012,36, New York,059, Nassau County,313,187,187,0,0,0,0,0,0,0,313,187,187,0,0,991,13,978
360595216013,36, New York,059, Nassau County,258,85,85,0,0,12,0,0,0,0,246,85,85,0,0,863,61,802
360595216014,36, New York,059, Nassau County,426,189,162,0,27,0,0,0,0,0,426,189,162,0,27,1071,0,1071
360595216021,36, New York,059, Nassau County,237,131,126,0,5,0,0,0,0,0,237,131,126,0,5,675,0,675
360595216022,36, New York,059, Nassau County,229,92,69,0,23,13,13,0,0,13,216,79,69,0,10,699,22,677
360595216023,36, New York,059, Nassau County,194,104,104,0,0,0,0,0,0,0,194,104,104,0,0,492,35,457
360595216024,36, New York,059, Nassau County,187,70,67,0,3,0,0,0,0,0,187,70,67,0,3,488,0,488
360595217001,36, New York,059, Nassau County,308,124,124,0,0,22,0,0,0,0,286,124,124,0,0,862,43,819
360595217002,36, New York,059, Nassau County,300,194,194,0,0,0,0,0,0,0,300,194,194,0,0,713,32,681
360595217003,36, New York,059, Nassau County,189,57,57,0,0,0,0,0,0,0,189,57,57,0,0,643,0,643
360595217004,36, New York,059, Nassau County,227,77,77,0,0,0,0,0,0,0,227,77,77,0,0,718,10,708
360595217005,36, New York,059, Nassau County,215,76,31,45,0,0,0,0,0,0,215,76,31,45,0,578,10,568
360595218011,36, New York,059, Nassau County,202,70,70,0,0,0,0,0,0,0,202,70,70,0,0,565,21,544
360595218012,36, New York,059, Nassau County,315,158,158,0,0,0,0,0,0,0,315,158,158,0,0,774,0,774
360595218013,36, New York,059, Nassau County,264,77,77,0,0,0,0,0,0,0,264,77,77,0,0,724,0,724
360595218014,36, New York,059, Nassau County,390,95,95,0,0,9,0,0,0,0,381,95,95,0,0,970,48,922
360595218021,36, New York,059, Nassau County,189,44,40,0,4,0,0,0,0,0,189,44,40,0,4,411,0,411
360595218022,36, New York,059, Nassau County,469,186,149,0,37,0,0,0,0,0,469,186,149,0,37,1560,23,1537
360595218023,36, New York,059, Nassau County,356,156,102,48,6,5,0,0,0,0,351,156,102,48,6,1002,16,986
360595219021,36, New York,059, Nassau County,364,139,114,11,14,10,0,0,0,0,354,139,114,11,14,974,31,943
360595219022,36, New York,059, Nassau County,249,73,61,0,12,0,0,0,0,0,249,73,61,0,12,704,16,688
360595219023,36, New York,059, Nassau County,405,185,185,0,0,0,0,0,0,0,405,185,185,0,0,1069,0,1069
360595219024,36, New York,059, Nassau County,280,148,138,0,10,0,0,0,0,0,280,148,138,0,10,655,12,643
360595220001,36, New York,059, Nassau County,491,217,78,49,90,0,0,0,0,0,491,217,78,49,90,1643,38,1605
360595220002,36, New York,059, Nassau County,323,65,50,15,0,22,0,0,0,0,301,65,50,15,0,984,109,875
360595220003,36, New York,059, Nassau County,212,98,94,0,4,42,4,0,0,4,170,94,94,0,0,932,268,664
360595220004,36, New York,059, Nassau County,198,82,22,0,60,0,0,0,0,0,198,82,22,0,60,812,0,812
360595220005,36, New York,059, Nassau County,519,119,65,0,54,0,0,0,0,0,519,119,65,0,54,1688,50,1638
360595227001,36, New York,059, Nassau County,549,194,179,0,15,0,0,0,0,0,549,194,179,0,15,1589,19,1570
360595227002,36, New York,059, Nassau County,328,116,73,8,35,45,35,0,0,35,283,81,73,8,0,895,54,841
360595227003,36, New York,059, Nassau County,531,329,329,0,0,0,0,0,0,0,531,329,329,0,0,1228,0,1228
360599801001,36, New York,059, Nassau County,0,0,0,0,0,0,0,0,0,0,0,0,0,0,0,0,0,0
360599811001,36, New York,059, Nassau County,0,0,0,0,0,0,0,0,0,0,0,0,0,0,0,0,0,0
360599821001,36, New York,059, Nassau County,0,0,0,0,0,0,0,0,0,0,0,0,0,0,0,10,0,10
360599901000,36, New York,059, Nassau County,0,0,0,0,0,0,0,0,0,0,0,0,0,0,0,0,0,0
360599902000,36, New York,059, Nassau County,0,0,0,0,0,0,0,0,0,0,0,0,0,0,0,0,0,0
360599903010,36, New York,059, Nassau County,0,0,0,0,0,0,0,0,0,0,0,0,0,0,0,0,0,0
360599903020,36, New York,059, Nassau County,0,0,0,0,0,0,0,0,0,0,0,0,0,0,0,0,0,0
360599904000,36, New York,059, Nassau County,0,0,0,0,0,0,0,0,0,0,0,0,0,0,0,0,0,0
360039402001,36, New York,003, Allegany County,0,0,0,0,0,0,0,0,0,0,0,0,0,0,0,0,0,0
360039501001,36, New York,003, Allegany County,252,90,59,14,17,19,14,7,0,7,233,76,52,14,10,753,73,680
360039501002,36, New York,003, Allegany County,131,37,29,0,8,23,9,3,0,6,108,28,26,0,2,406,67,339
360039501003,36, New York,003, Allegany County,242,119,112,4,3,5,0,0,0,0,237,119,112,4,3,697,14,683
360039503001,36, New York,003, Allegany County,397,159,135,8,16,16,6,6,0,0,381,153,129,8,16,1020,88,932
360039503002,36, New York,003, Allegany County,323,155,118,24,13,43,40,34,2,4,280,115,84,22,9,868,158,710
360039503003,36, New York,003, Allegany County,331,173,167,6,0,3,3,3,0,0,328,170,164,6,0,1018,137,881
360039504011,36, New York,003, Allegany County,334,112,78,10,24,17,12,4,0,8,317,100,74,10,16,883,44,839
360039504012,36, New York,003, Allegany County,114,44,24,10,10,12,8,0,0,8,102,36,24,10,2,331,40,291
360039504021,36, New York,003, Allegany County,146,63,35,9,19,26,25,3,9,13,120,38,32,0,6,473,87,386
360039504022,36, New York,003, Allegany County,153,97,86,4,7,26,23,19,0,4,127,74,67,4,3,518,60,458
360039504023,36, New York,003, Allegany County,158,72,47,5,20,12,9,4,0,5,146,63,43,5,15,663,79,584
360039505001,36, New York,003, Allegany County,342,151,88,4,59,39,32,0,0,32,303,119,88,4,27,1149,103,1046
360039505002,36, New York,003, Allegany County,224,140,78,21,41,24,24,0,0,24,200,116,78,21,17,577,38,539
360039505003,36, New York,003, Allegany County,253,103,79,8,16,29,16,0,0,16,224,87,79,8,0,715,54,661
360039505004,36, New York,003, Allegany County,145,42,26,2,14,16,0,0,0,0,129,42,26,2,14,484,64,420
360039506001,36, New York,003, Allegany County,163,57,42,0,15,18,8,0,0,8,145,49,42,0,7,478,68,410
360039506002,36, New York,003, Allegany County,191,113,55,14,44,47,22,0,0,22,144,91,55,14,22,645,201,444
360039506003,36, New York,003, Allegany County,174,84,68,0,16,16,16,0,0,16,158,68,68,0,0,631,85,546
360039506004,36, New York,003, Allegany County,248,77,43,34,0,52,37,6,31,0,196,40,37,3,0,704,115,589
360039507001,36, New York,003, Allegany County,300,73,56,10,7,29,12,11,0,1,271,61,45,10,6,1002,250,752
360039507002,36, New York,003, Allegany County,415,142,68,30,44,37,26,0,12,14,378,116,68,18,30,1370,196,1174
360039507003,36, New York,003, Allegany County,205,38,13,0,25,0,0,0,0,0,205,38,13,0,25,860,140,720
360039508001,36, New York,003, Allegany County,249,120,80,15,25,26,26,14,0,12,223,94,66,15,13,667,85,582
360039508002,36, New York,003, Allegany County,310,107,100,0,7,10,7,4,0,3,300,100,96,0,4,996,107,889
360039508003,36, New York,003, Allegany County,174,62,58,0,4,0,0,0,0,0,174,62,58,0,4,987,371,616
360039509001,36, New York,003, Allegany County,301,166,99,3,64,111,109,59,3,47,190,57,40,0,17,857,260,597
360039509002,36, New York,003, Allegany County,271,114,52,3,59,35,30,10,0,20,236,84,42,3,39,841,133,708
360039509003,36, New York,003, Allegany County,281,129,28,51,50,45,11,0,0,11,236,118,28,51,39,922,305,617
360039509004,36, New York,003, Allegany County,130,39,37,0,2,6,6,4,0,2,124,33,33,0,0,368,11,357
360039510001,36, New York,003, Allegany County,279,57,33,0,24,26,24,0,0,24,253,33,33,0,0,836,142,694
360039510002,36, New York,003, Allegany County,328,109,77,23,9,14,11,8,0,3,314,98,69,23,6,877,65,812
360039510003,36, New York,003, Allegany County,243,72,61,6,5,23,17,11,6,0,220,55,50,0,5,755,48,707
360039511001,36, New York,003, Allegany County,118,36,28,8,0,2,0,0,0,0,116,36,28,8,0,431,29,402
360039511002,36, New York,003, Allegany County,136,23,23,0,0,3,0,0,0,0,133,23,23,0,0,592,32,560
360039511003,36, New York,003, Allegany County,356,255,220,0,35,24,24,24,0,0,332,231,196,0,35,1124,129,995
360039511004,36, New York,003, Allegany County,174,81,76,3,2,28,28,28,0,0,146,53,48,3,2,604,94,510
360039512011,36, New York,003, Allegany County,231,106,69,14,23,53,43,21,6,16,178,63,48,8,7,737,178,559
360039512012,36, New York,003, Allegany County,186,101,55,8,38,13,5,0,0,5,173,96,55,8,33,597,104,493
360039512013,36, New York,003, Allegany County,142,24,15,9,0,13,9,0,9,0,129,15,15,0,0,521,90,431
360039512021,36, New York,003, Allegany County,152,43,29,0,14,28,14,0,0,14,124,29,29,0,0,439,83,356
360039512022,36, New York,003, Allegany County,285,64,32,6,26,32,28,3,3,22,253,36,29,3,4,759,72,687
360039512023,36, New York,003, Allegany County,204,93,41,24,28,21,20,6,0,14,183,73,35,24,14,612,77,535
360039513011,36, New York,003, Allegany County,149,49,31,10,8,0,0,0,0,0,149,49,31,10,8,467,45,422
360039513012,36, New York,003, Allegany County,132,47,39,0,8,16,12,10,0,2,116,35,29,0,6,422,59,363
360039513021,36, New York,003, Allegany County,140,69,23,19,27,13,7,0,2,5,127,62,23,17,22,429,63,366
360039513022,36, New York,003, Allegany County,184,76,61,8,7,20,14,8,6,0,164,62,53,2,7,634,61,573
360039513023,36, New York,003, Allegany County,177,60,45,8,7,26,14,12,2,0,151,46,33,6,7,478,76,402
360259701011,36, New York,025, Delaware County,189,38,36,0,2,28,4,4,0,0,161,34,32,0,2,662,114,548
360259701012,36, New York,025, Delaware County,182,68,57,4,7,20,7,0,0,7,162,61,57,4,0,518,78,440
360259701021,36, New York,025, Delaware County,283,109,65,17,27,0,0,0,0,0,283,109,65,17,27,1037,76,961
360259701022,36, New York,025, Delaware County,381,117,34,18,65,31,31,0,0,31,350,86,34,18,34,1408,62,1346
360259702001,36, New York,025, Delaware County,185,56,39,10,7,13,13,0,10,3,172,43,39,0,4,657,46,611
360259702002,36, New York,025, Delaware County,199,60,34,20,6,3,0,0,0,0,196,60,34,20,6,661,84,577
360259702003,36, New York,025, Delaware County,202,14,14,0,0,0,0,0,0,0,202,14,14,0,0,697,59,638
360259702004,36, New York,025, Delaware County,222,81,49,11,21,2,0,0,0,0,220,81,49,11,21,654,36,618
360259703001,36, New York,025, Delaware County,210,74,64,5,5,20,0,0,0,0,190,74,64,5,5,734,90,644
360259703002,36, New York,025, Delaware County,214,39,27,0,12,21,5,0,0,5,193,34,27,0,7,608,88,520
360259703003,36, New York,025, Delaware County,305,115,63,27,25,47,47,12,19,16,258,68,51,8,9,794,75,719
360259704011,36, New York,025, Delaware County,292,183,60,37,86,44,44,0,0,44,248,139,60,37,42,668,62,606
360259704012,36, New York,025, Delaware County,252,48,12,16,20,20,20,0,0,20,232,28,12,16,0,702,85,617
360259704021,36, New York,025, Delaware County,255,65,47,18,0,28,28,28,0,0,227,37,19,18,0,757,98,659
360259704022,36, New York,025, Delaware County,201,29,7,0,22,22,22,0,0,22,179,7,7,0,0,784,126,658
360259704023,36, New York,025, Delaware County,190,87,87,0,0,32,32,32,0,0,158,55,55,0,0,593,90,503
360259704024,36, New York,025, Delaware County,73,54,0,22,32,54,54,0,22,32,19,0,0,0,0,252,125,127
360259704025,36, New York,025, Delaware County,127,73,68,0,5,5,5,0,0,5,122,68,68,0,0,486,103,383
360259705011,36, New York,025, Delaware County,252,79,50,5,24,38,21,8,5,8,214,58,42,0,16,974,109,865
360259705012,36, New York,025, Delaware County,265,90,23,19,48,62,56,0,13,43,203,34,23,6,5,822,180,642
360259705021,36, New York,025, Delaware County,207,103,38,37,28,11,9,5,4,0,196,94,33,33,28,609,35,574
360259705022,36, New York,025, Delaware County,166,36,24,7,5,8,6,1,3,2,158,30,23,4,3,509,76,433
360259706011,36, New York,025, Delaware County,258,176,160,0,16,69,58,58,0,0,189,118,102,0,16,859,348,511
360259706012,36, New York,025, Delaware County,144,104,0,55,49,0,0,0,0,0,144,104,0,55,49,381,0,381
360259706013,36, New York,025, Delaware County,195,43,22,21,0,21,21,0,21,0,174,22,22,0,0,566,50,516
360259706021,36, New York,025, Delaware County,251,128,101,0,27,0,0,0,0,0,251,128,101,0,27,705,70,635
360259706022,36, New York,025, Delaware County,459,271,190,0,81,168,168,131,0,37,291,103,59,0,44,1242,372,870
360259706023,36, New York,025, Delaware County,186,105,54,0,51,29,29,0,0,29,157,76,54,0,22,570,154,416
360259707001,36, New York,025, Delaware County,150,55,48,0,7,27,7,3,0,4,123,48,45,0,3,464,57,407
360259707002,36, New York,025, Delaware County,156,66,47,3,16,13,3,3,0,0,143,63,44,3,16,602,47,555
360259707003,36, New York,025, Delaware County,190,89,80,5,4,14,4,0,0,4,176,85,80,5,0,493,60,433
360259707004,36, New York,025, Delaware County,149,55,30,0,25,6,0,0,0,0,143,55,30,0,25,430,22,408
360259708001,36, New York,025, Delaware County,201,63,35,5,23,26,21,0,0,21,175,42,35,5,2,564,79,485
360259708002,36, New York,025, Delaware County,109,51,0,51,0,0,0,0,0,0,109,51,0,51,0,717,165,552
360259708003,36, New York,025, Delaware County,296,116,37,13,66,18,13,4,0,9,278,103,33,13,57,759,60,699
360259708004,36, New York,025, Delaware County,210,100,67,4,29,22,22,0,0,22,188,78,67,4,7,701,151,550
360259709001,36, New York,025, Delaware County,0,0,0,0,0,0,0,0,0,0,0,0,0,0,0,0,0,0
360259710001,36, New York,025, Delaware County,226,47,39,2,6,26,6,6,0,0,200,41,33,2,6,753,106,647
360259710002,36, New York,025, Delaware County,169,48,33,9,6,20,4,2,0,2,149,44,31,9,4,486,53,433
360259710003,36, New York,025, Delaware County,284,160,98,23,39,63,35,6,0,29,221,125,92,23,10,875,230,645
360259711001,36, New York,025, Delaware County,189,58,44,0,14,0,0,0,0,0,189,58,44,0,14,638,58,580
360259711002,36, New York,025, Delaware County,199,21,16,5,0,7,0,0,0,0,192,21,16,5,0,453,31,422
360259711003,36, New York,025, Delaware County,230,118,105,5,8,12,8,0,0,8,218,110,105,5,0,711,49,662
360259712001,36, New York,025, Delaware County,211,58,50,0,8,0,0,0,0,0,211,58,50,0,8,675,17,658
360259712002,36, New York,025, Delaware County,278,115,105,0,10,60,23,23,0,0,218,92,82,0,10,763,141,622
360259712003,36, New York,025, Delaware County,121,75,30,0,45,0,0,0,0,0,121,75,30,0,45,405,80,325
360259712004,36, New York,025, Delaware County,142,55,55,0,0,7,0,0,0,0,135,55,55,0,0,401,51,350
360259712005,36, New York,025, Delaware County,129,77,45,32,0,33,25,0,25,0,96,52,45,7,0,402,39,363
360259713001,36, New York,025, Delaware County,224,77,65,0,12,51,23,11,0,12,173,54,54,0,0,674,122,552
360259713002,36, New York,025, Delaware County,93,49,49,0,0,0,0,0,0,0,93,49,49,0,0,276,6,270
360259713003,36, New York,025, Delaware County,162,77,52,25,0,28,25,0,25,0,134,52,52,0,0,485,34,451
360259714001,36, New York,025, Delaware County,358,73,62,11,0,10,0,0,0,0,348,73,62,11,0,936,70,866
360259714002,36, New York,025, Delaware County,189,68,39,0,29,0,0,0,0,0,189,68,39,0,29,570,29,541
360259714003,36, New York,025, Delaware County,103,39,27,0,12,6,6,0,0,6,97,33,27,0,6,420,21,399
360259714004,36, New York,025, Delaware County,113,34,0,13,21,34,27,0,13,14,79,7,0,0,7,467,79,388
360070001001,36, New York,007, Broome County,169,27,0,13,14,21,14,0,0,14,148,13,0,13,0,720,173,547
360070001002,36, New York,007, Broome County,91,19,13,0,6,0,0,0,0,0,91,19,13,0,6,331,61,270
360070001003,36, New York,007, Broome County,286,128,38,0,90,147,71,0,0,71,139,57,38,0,19,623,246,377
360070001004,36, New York,007, Broome County,93,43,12,0,31,19,9,0,0,9,74,34,12,0,22,684,112,572
360070002001,36, New York,007, Broome County,168,91,39,33,19,34,24,0,5,19,134,67,39,28,0,723,165,558
360070002002,36, New York,007, Broome County,145,46,16,20,10,30,30,0,20,10,115,16,16,0,0,573,63,510
360070002003,36, New York,007, Broome County,289,115,64,1,50,53,41,0,0,41,236,74,64,1,9,1294,314,980
360070003001,36, New York,007, Broome County,273,130,100,18,12,42,12,0,0,12,231,118,100,18,0,926,155,771
360070003002,36, New York,007, Broome County,99,57,15,36,6,52,52,15,36,1,47,5,0,0,5,318,112,206
360070003003,36, New York,007, Broome County,153,67,21,12,34,46,46,0,12,34,107,21,21,0,0,523,159,364
360070004001,36, New York,007, Broome County,209,155,0,45,110,101,101,0,24,77,108,54,0,21,33,624,275,349
360070004002,36, New York,007, Broome County,221,75,32,8,35,11,11,11,0,0,210,64,21,8,35,907,82,825
360070005001,36, New York,007, Broome County,154,71,9,0,62,54,41,9,0,32,100,30,0,0,30,520,242,278
360070005002,36, New York,007, Broome County,82,63,7,0,56,57,51,0,0,51,25,12,7,0,5,367,246,121
360070005003,36, New York,007, Broome County,170,69,4,0,65,47,41,0,0,41,123,28,4,0,24,593,125,468
360070006001,36, New York,007, Broome County,248,200,165,0,35,110,105,105,0,0,138,95,60,0,35,308,73,235
360070006002,36, New York,007, Broome County,93,19,7,12,0,17,7,7,0,0,76,12,0,12,0,367,67,300
360070006003,36, New York,007, Broome County,130,100,25,5,70,57,40,0,5,35,73,60,25,0,35,493,183,310
360070007001,36, New York,007, Broome County,178,76,54,0,22,9,9,9,0,0,169,67,45,0,22,677,78,599
360070007002,36, New York,007, Broome County,339,58,30,28,0,0,0,0,0,0,339,58,30,28,0,941,35,906
360070007003,36, New York,007, Broome County,176,67,21,16,30,58,44,5,16,23,118,23,16,0,7,490,122,368
360070007004,36, New York,007, Broome County,151,105,12,0,93,48,48,0,0,48,103,57,12,0,45,537,68,469
360070009001,36, New York,007, Broome County,270,109,23,27,59,37,34,0,7,27,233,75,23,20,32,964,189,775
360070009002,36, New York,007, Broome County,171,124,32,5,87,111,111,32,0,79,60,13,0,5,8,383,142,241
360070011001,36, New York,007, Broome County,72,48,0,0,48,32,32,0,0,32,40,16,0,0,16,269,104,165
360070011002,36, New York,007, Broome County,184,150,0,64,86,119,96,0,64,32,65,54,0,0,54,1061,371,690
360070012001,36, New York,007, Broome County,15,0,0,0,0,0,0,0,0,0,15,0,0,0,0,621,433,188
360070012002,36, New York,007, Broome County,19,0,0,0,0,0,0,0,0,0,19,0,0,0,0,673,399,274
360070013001,36, New York,007, Broome County,51,12,12,0,0,24,0,0,0,0,27,12,12,0,0,268,132,136
360070013002,36, New York,007, Broome County,85,53,0,5,48,35,35,0,5,30,50,18,0,0,18,1138,945,193
360070013003,36, New York,007, Broome County,88,67,21,0,46,46,46,0,0,46,42,21,21,0,0,404,175,229
360070013004,36, New York,007, Broome County,78,56,0,0,56,33,33,0,0,33,45,23,0,0,23,465,230,235
360070014011,36, New York,007, Broome County,74,61,61,0,0,0,0,0,0,0,74,61,61,0,0,332,66,266
360070014012,36, New York,007, Broome County,43,0,0,0,0,21,0,0,0,0,22,0,0,0,0,935,714,221
360070014013,36, New York,007, Broome County,5,0,0,0,0,0,0,0,0,0,5,0,0,0,0,419,234,185
360070014021,36, New York,007, Broome County,267,85,85,0,0,19,0,0,0,0,248,85,85,0,0,754,90,664
360070014022,36, New York,007, Broome County,0,0,0,0,0,0,0,0,0,0,0,0,0,0,0,568,438,130
360070014023,36, New York,007, Broome County,210,101,0,0,101,101,101,0,0,101,109,0,0,0,0,1483,961,522
360070015001,36, New York,007, Broome County,104,15,0,7,8,0,0,0,0,0,104,15,0,7,8,371,4,367
360070015002,36, New York,007, Broome County,294,68,68,0,0,0,0,0,0,0,294,68,68,0,0,1220,116,1104
360070015003,36, New York,007, Broome County,251,161,140,9,12,0,0,0,0,0,251,161,140,9,12,795,31,764
360070015004,36, New York,007, Broome County,121,27,13,0,14,0,0,0,0,0,121,27,13,0,14,333,0,333
360070015005,36, New York,007, Broome County,281,122,78,0,44,0,0,0,0,0,281,122,78,0,44,928,63,865
360070016001,36, New York,007, Broome County,97,43,12,31,0,0,0,0,0,0,97,43,12,31,0,333,28,305
360070016002,36, New York,007, Broome County,239,100,77,0,23,0,0,0,0,0,239,100,77,0,23,876,166,710
360070016003,36, New York,007, Broome County,235,91,59,0,32,24,24,0,0,24,211,67,59,0,8,677,34,643
360070017001,36, New York,007, Broome County,88,57,32,23,2,2,2,0,0,2,86,55,32,23,0,548,170,378
360070017002,36, New York,007, Broome County,254,227,48,0,179,43,34,0,0,34,211,193,48,0,145,556,83,473
360070017003,36, New York,007, Broome County,288,99,69,14,16,14,14,0,14,0,274,85,69,0,16,779,22,757
360070017004,36, New York,007, Broome County,226,144,37,0,107,31,31,0,0,31,195,113,37,0,76,782,155,627
360070017005,36, New York,007, Broome County,192,135,41,19,75,74,62,41,10,11,118,73,0,9,64,544,173,371
360070018001,36, New York,007, Broome County,163,117,46,0,71,62,62,46,0,16,101,55,0,0,55,619,233,386
360070018002,36, New York,007, Broome County,261,139,0,0,139,40,40,0,0,40,221,99,0,0,99,991,128,863
360070018003,36, New York,007, Broome County,76,48,48,0,0,0,0,0,0,0,76,48,48,0,0,308,56,252
360070018004,36, New York,007, Broome County,266,69,54,0,15,8,8,0,0,8,258,61,54,0,7,656,46,610
360070018005,36, New York,007, Broome County,155,129,92,37,0,0,0,0,0,0,155,129,92,37,0,511,42,469
360070102001,36, New York,007, Broome County,224,105,80,25,0,37,25,0,25,0,187,80,80,0,0,642,50,592
360070102002,36, New York,007, Broome County,486,293,177,15,101,114,114,13,0,101,372,179,164,15,0,1296,341,955
360070102003,36, New York,007, Broome County,153,44,44,0,0,0,0,0,0,0,153,44,44,0,0,529,27,502
360070102004,36, New York,007, Broome County,248,11,11,0,0,0,0,0,0,0,248,11,11,0,0,607,40,567
360070102005,36, New York,007, Broome County,246,94,75,19,0,0,0,0,0,0,246,94,75,19,0,954,0,954
360070119011,36, New York,007, Broome County,197,51,8,36,7,39,39,4,31,4,158,12,4,5,3,602,71,531
360070119012,36, New York,007, Broome County,395,184,115,14,55,41,29,4,0,25,354,155,111,14,30,1050,81,969
360070119013,36, New York,007, Broome County,160,50,41,0,9,55,2,0,0,2,105,48,41,0,7,586,271,315
360070119021,36, New York,007, Broome County,310,104,79,7,18,17,17,12,0,5,293,87,67,7,13,889,74,815
360070119022,36, New York,007, Broome County,348,176,141,9,26,86,81,81,0,0,262,95,60,9,26,1102,221,881
360070119031,36, New York,007, Broome County,401,203,157,36,10,33,26,26,0,0,368,177,131,36,10,952,134,818
360070119032,36, New York,007, Broome County,353,174,88,7,79,53,52,35,0,17,300,122,53,7,62,972,123,849
360070120001,36, New York,007, Broome County,441,171,131,31,9,25,15,11,4,0,416,156,120,27,9,1198,82,1116
360070121011,36, New York,007, Broome County,191,60,43,13,4,0,0,0,0,0,191,60,43,13,4,735,33,702
360070121012,36, New York,007, Broome County,262,79,53,7,19,0,0,0,0,0,262,79,53,7,19,742,55,687
360070121013,36, New York,007, Broome County,318,189,95,30,64,28,24,0,0,24,290,165,95,30,40,735,49,686
360070121014,36, New York,007, Broome County,318,134,112,16,6,42,22,0,16,6,276,112,112,0,0,797,67,730
360070121021,36, New York,007, Broome County,426,152,126,8,18,40,25,7,0,18,386,127,119,8,0,1063,86,977
360070121022,36, New York,007, Broome County,210,111,83,19,9,0,0,0,0,0,210,111,83,19,9,626,6,620
360070121023,36, New York,007, Broome County,214,86,43,25,18,18,18,0,0,18,196,68,43,25,0,619,76,543
360070121024,36, New York,007, Broome County,245,87,54,10,23,0,0,0,0,0,245,87,54,10,23,651,2,649
360070121031,36, New York,007, Broome County,191,73,37,0,36,30,16,16,0,0,161,57,21,0,36,618,95,523
360070121032,36, New York,007, Broome County,198,46,3,23,20,11,11,0,11,0,187,35,3,12,20,543,32,511
360070121033,36, New York,007, Broome County,435,201,123,0,78,64,64,39,0,25,371,137,84,0,53,1351,185,1166
360070122011,36, New York,007, Broome County,105,44,44,0,0,0,0,0,0,0,105,44,44,0,0,381,43,338
360070122012,36, New York,007, Broome County,266,146,118,7,21,0,0,0,0,0,266,146,118,7,21,857,38,819
360070122013,36, New York,007, Broome County,125,15,9,6,0,0,0,0,0,0,125,15,9,6,0,410,0,410
360070122021,36, New York,007, Broome County,277,93,89,0,4,18,0,0,0,0,259,93,89,0,4,655,45,610
360070122022,36, New York,007, Broome County,302,113,84,7,22,45,22,0,0,22,257,91,84,7,0,773,130,643
360070122023,36, New York,007, Broome County,256,130,44,73,13,54,54,0,54,0,202,76,44,19,13,760,79,681
360070122024,36, New York,007, Broome County,272,186,130,3,53,48,48,26,0,22,224,138,104,3,31,679,152,527
360070123001,36, New York,007, Broome County,258,60,20,0,40,11,11,0,0,11,247,49,20,0,29,991,111,880
360070123002,36, New York,007, Broome County,235,88,88,0,0,12,0,0,0,0,223,88,88,0,0,816,73,743
360070123003,36, New York,007, Broome County,296,143,125,0,18,18,18,0,0,18,278,125,125,0,0,668,27,641
360070123004,36, New York,007, Broome County,388,183,166,0,17,59,59,59,0,0,329,124,107,0,17,992,226,766
360070124001,36, New York,007, Broome County,86,32,27,5,0,0,0,0,0,0,86,32,27,5,0,310,12,298
360070124002,36, New York,007, Broome County,283,146,107,8,31,36,30,2,4,24,247,116,105,4,7,703,77,626
360070124003,36, New York,007, Broome County,281,86,52,7,27,13,13,13,0,0,268,73,39,7,27,706,46,660
360070125011,36, New York,007, Broome County,510,126,41,67,18,9,9,0,0,9,501,117,41,67,9,1249,22,1227
360070125012,36, New York,007, Broome County,290,163,146,17,0,23,0,0,0,0,267,163,146,17,0,987,201,786
360070125021,36, New York,007, Broome County,317,206,181,0,25,16,14,10,0,4,301,192,171,0,21,861,91,770
360070125022,36, New York,007, Broome County,189,96,63,7,26,12,12,0,0,12,177,84,63,7,14,558,31,527
360070125023,36, New York,007, Broome County,314,86,86,0,0,0,0,0,0,0,314,86,86,0,0,942,23,919
360070126001,36, New York,007, Broome County,399,257,197,19,41,1,0,0,0,0,398,257,197,19,41,1002,103,899
360070126002,36, New York,007, Broome County,341,212,144,68,0,18,18,18,0,0,323,194,126,68,0,1013,143,870
360070126003,36, New York,007, Broome County,217,74,74,0,0,27,0,0,0,0,190,74,74,0,0,403,94,309
360070126004,36, New York,007, Broome County,82,45,13,32,0,0,0,0,0,0,82,45,13,32,0,261,56,205
360070126005,36, New York,007, Broome County,212,80,45,0,35,30,0,0,0,0,182,80,45,0,35,880,206,674
360070126006,36, New York,007, Broome County,106,42,0,9,33,45,15,0,0,15,61,27,0,9,18,446,162,284
360070127011,36, New York,007, Broome County,358,123,85,0,38,38,38,0,0,38,320,85,85,0,0,993,85,908
360070127012,36, New York,007, Broome County,199,49,19,0,30,0,0,0,0,0,199,49,19,0,30,717,0,717
360070127013,36, New York,007, Broome County,257,45,45,0,0,13,0,0,0,0,244,45,45,0,0,793,98,695
360070127014,36, New York,007, Broome County,102,17,17,0,0,0,0,0,0,0,102,17,17,0,0,591,238,353
360070127015,36, New York,007, Broome County,339,112,112,0,0,0,0,0,0,0,339,112,112,0,0,1150,16,1134
360070127021,36, New York,007, Broome County,261,45,45,0,0,15,15,15,0,0,246,30,30,0,0,533,34,499
360070127022,36, New York,007, Broome County,305,164,72,29,63,24,18,0,0,18,281,146,72,29,45,902,94,808
360070127023,36, New York,007, Broome County,381,92,61,17,14,1,0,0,0,0,380,92,61,17,14,1061,166,895
360070127024,36, New York,007, Broome County,459,102,102,0,0,0,0,0,0,0,459,102,102,0,0,1135,0,1135
360070128001,36, New York,007, Broome County,185,53,53,0,0,18,18,18,0,0,167,35,35,0,0,777,132,645
360070128002,36, New York,007, Broome County,310,166,89,8,69,63,58,14,0,44,247,108,75,8,25,1098,234,864
360070128003,36, New York,007, Broome County,222,92,57,4,31,3,0,0,0,0,219,92,57,4,31,712,69,643
360070128004,36, New York,007, Broome County,212,46,46,0,0,0,0,0,0,0,212,46,46,0,0,779,47,732
360070128005,36, New York,007, Broome County,132,28,28,0,0,0,0,0,0,0,132,28,28,0,0,390,0,390
360070129001,36, New York,007, Broome County,360,86,86,0,0,0,0,0,0,0,360,86,86,0,0,1168,20,1148
360070130001,36, New York,007, Broome County,407,146,118,14,14,8,0,0,0,0,399,146,118,14,14,1081,27,1054
360070130002,36, New York,007, Broome County,142,60,40,20,0,50,50,30,20,0,92,10,10,0,0,346,113,233
360070130003,36, New York,007, Broome County,234,78,68,0,10,0,0,0,0,0,234,78,68,0,10,647,31,616
360070130004,36, New York,007, Broome County,385,194,177,17,0,24,24,24,0,0,361,170,153,17,0,1039,81,958
360070131001,36, New York,007, Broome County,160,45,33,0,12,0,0,0,0,0,160,45,33,0,12,498,56,442
360070131002,36, New York,007, Broome County,261,106,61,0,45,22,0,0,0,0,239,106,61,0,45,901,280,621
360070131003,36, New York,007, Broome County,138,21,21,0,0,9,0,0,0,0,129,21,21,0,0,972,242,730
360070132011,36, New York,007, Broome County,263,110,66,28,16,15,5,0,0,5,248,105,66,28,11,715,63,652
360070132012,36, New York,007, Broome County,319,148,76,8,64,16,16,0,0,16,303,132,76,8,48,858,49,809
360070132021,36, New York,007, Broome County,319,125,100,6,19,30,19,0,0,19,289,106,100,6,0,1132,142,990
360070132022,36, New York,007, Broome County,325,130,102,16,12,14,0,0,0,0,311,130,102,16,12,920,100,820
360070132023,36, New York,007, Broome County,171,50,29,16,5,5,5,0,0,5,166,45,29,16,0,483,47,436
360070133011,36, New York,007, Broome County,260,116,76,40,0,0,0,0,0,0,260,116,76,40,0,666,14,652
360070133012,36, New York,007, Broome County,213,95,0,0,95,0,0,0,0,0,213,95,0,0,95,421,0,421
360070133013,36, New York,007, Broome County,338,176,35,41,100,15,0,0,0,0,323,176,35,41,100,1014,59,955
360070133014,36, New York,007, Broome County,188,67,49,0,18,0,0,0,0,0,188,67,49,0,18,578,44,534
360070133015,36, New York,007, Broome County,220,97,40,0,57,44,44,0,0,44,176,53,40,0,13,1083,112,971
360070133031,36, New York,007, Broome County,389,103,93,10,0,0,0,0,0,0,389,103,93,10,0,987,38,949
360070133032,36, New York,007, Broome County,476,189,142,0,47,18,13,13,0,0,458,176,129,0,47,1216,36,1180
360070133041,36, New York,007, Broome County,195,103,103,0,0,0,0,0,0,0,195,103,103,0,0,463,10,453
360070133042,36, New York,007, Broome County,584,125,94,15,16,32,16,0,0,16,552,109,94,15,0,1407,100,1307
360070133043,36, New York,007, Broome County,347,109,109,0,0,0,0,0,0,0,347,109,109,0,0,919,0,919
360070133044,36, New York,007, Broome County,447,234,208,0,26,146,116,116,0,0,301,118,92,0,26,794,108,686
360070133045,36, New York,007, Broome County,280,84,76,0,8,16,0,0,0,0,264,84,76,0,8,836,53,783
360070134001,36, New York,007, Broome County,188,120,120,0,0,26,0,0,0,0,162,120,120,0,0,494,55,439
360070134002,36, New York,007, Broome County,275,159,22,0,137,30,14,14,0,0,245,145,8,0,137,971,150,821
360070134003,36, New York,007, Broome County,139,63,56,7,0,13,0,0,0,0,126,63,56,7,0,520,57,463
360070134004,36, New York,007, Broome County,405,213,24,0,189,194,170,7,0,163,211,43,17,0,26,1146,387,759
360070135001,36, New York,007, Broome County,131,82,13,46,23,77,77,8,46,23,54,5,5,0,0,358,168,190
360070135002,36, New York,007, Broome County,164,120,16,0,104,115,106,8,0,98,49,14,8,0,6,572,401,171
360070135003,36, New York,007, Broome County,143,118,51,25,42,45,38,0,0,38,98,80,51,25,4,461,143,318
360070136001,36, New York,007, Broome County,225,112,38,13,61,11,11,11,0,0,214,101,27,13,61,684,117,567
360070136002,36, New York,007, Broome County,71,37,13,8,16,26,16,0,0,16,45,21,13,8,0,317,64,253
360070136003,36, New York,007, Broome County,301,218,73,0,145,86,52,15,0,37,215,166,58,0,108,1053,443,610
360070136004,36, New York,007, Broome County,107,82,46,0,36,36,36,0,0,36,71,46,46,0,0,337,56,281
360070136005,36, New York,007, Broome County,146,53,53,0,0,0,0,0,0,0,146,53,53,0,0,513,110,403
360070137001,36, New York,007, Broome County,330,133,45,0,88,124,90,34,0,56,206,43,11,0,32,1188,322,866
360070137002,36, New York,007, Broome County,89,28,8,0,20,8,8,8,0,0,81,20,0,0,20,448,96,352
360070137003,36, New York,007, Broome County,365,201,19,55,127,46,46,0,0,46,319,155,19,55,81,1001,103,898
360070138001,36, New York,007, Broome County,355,135,44,10,81,43,43,0,0,43,312,92,44,10,38,1133,136,997
360070138002,36, New York,007, Broome County,141,87,13,33,41,0,0,0,0,0,141,87,13,33,41,385,0,385
360070138003,36, New York,007, Broome County,195,52,39,0,13,0,0,0,0,0,195,52,39,0,13,587,54,533
360070138004,36, New York,007, Broome County,179,56,34,0,22,20,20,14,0,6,159,36,20,0,16,690,59,631
360070139001,36, New York,007, Broome County,28,28,0,0,28,16,16,0,0,16,12,12,0,0,12,87,6,81
360070139002,36, New York,007, Broome County,93,62,47,0,15,45,40,40,0,0,48,22,7,0,15,464,286,178
360070139003,36, New York,007, Broome County,268,92,22,0,70,55,25,0,0,25,213,67,22,0,45,939,267,672
360070140001,36, New York,007, Broome County,195,71,60,0,11,4,0,0,0,0,191,71,60,0,11,707,52,655
360070140002,36, New York,007, Broome County,209,136,0,0,136,27,21,0,0,21,182,115,0,0,115,585,128,457
360070140003,36, New York,007, Broome County,205,137,60,30,47,53,45,0,30,15,152,92,60,0,32,695,312,383
360070141001,36, New York,007, Broome County,165,65,65,0,0,0,0,0,0,0,165,65,65,0,0,557,15,542
360070141002,36, New York,007, Broome County,156,58,26,0,32,36,0,0,0,0,120,58,26,0,32,404,83,321
360070141003,36, New York,007, Broome County,195,98,32,49,17,49,49,0,49,0,146,49,32,0,17,859,252,607
360070141004,36, New York,007, Broome County,210,78,27,23,28,0,0,0,0,0,210,78,27,23,28,724,55,669
360070142001,36, New York,007, Broome County,386,52,45,0,7,0,0,0,0,0,386,52,45,0,7,1123,29,1094
360070142002,36, New York,007, Broome County,107,34,23,0,11,0,0,0,0,0,107,34,23,0,11,704,92,612
360070142003,36, New York,007, Broome County,218,95,42,30,23,0,0,0,0,0,218,95,42,30,23,579,49,530
360070143011,36, New York,007, Broome County,571,169,169,0,0,46,29,29,0,0,525,140,140,0,0,1264,92,1172
360070143012,36, New York,007, Broome County,194,44,43,1,0,0,0,0,0,0,194,44,43,1,0,896,473,423
360070143013,36, New York,007, Broome County,95,40,31,0,9,9,9,0,0,9,86,31,31,0,0,525,143,382
360070143014,36, New York,007, Broome County,292,85,85,0,0,28,0,0,0,0,264,85,85,0,0,739,87,652
360070143015,36, New York,007, Broome County,307,159,145,0,14,32,32,32,0,0,275,127,113,0,14,663,76,587
360070143021,36, New York,007, Broome County,169,90,68,0,22,13,13,13,0,0,156,77,55,0,22,987,359,628
360070143022,36, New York,007, Broome County,142,55,39,8,8,0,0,0,0,0,142,55,39,8,8,418,10,408
360070143023,36, New York,007, Broome County,151,40,13,0,27,0,0,0,0,0,151,40,13,0,27,314,7,307
360070144001,36, New York,007, Broome County,258,103,78,0,25,11,11,0,0,11,247,92,78,0,14,811,63,748
360070144002,36, New York,007, Broome County,347,153,113,40,0,0,0,0,0,0,347,153,113,40,0,810,5,805
360070144003,36, New York,007, Broome County,188,37,37,0,0,15,0,0,0,0,173,37,37,0,0,721,58,663
360070144004,36, New York,007, Broome County,206,97,47,0,50,39,39,0,0,39,167,58,47,0,11,638,92,546
360070144005,36, New York,007, Broome County,370,232,103,0,129,44,44,16,0,28,326,188,87,0,101,896,119,777
360070145001,36, New York,007, Broome County,213,56,33,9,14,31,23,0,9,14,182,33,33,0,0,649,103,546
360070145002,36, New York,007, Broome County,364,118,89,0,29,0,0,0,0,0,364,118,89,0,29,1038,24,1014
360070145003,36, New York,007, Broome County,194,36,36,0,0,0,0,0,0,0,194,36,36,0,0,610,23,587
360070145004,36, New York,007, Broome County,226,69,69,0,0,0,0,0,0,0,226,69,69,0,0,568,0,568
360070146001,36, New York,007, Broome County,267,144,88,0,56,8,8,0,0,8,259,136,88,0,48,883,26,857
360070146002,36, New York,007, Broome County,553,140,140,0,0,0,0,0,0,0,553,140,140,0,0,1468,0,1468
360070146003,36, New York,007, Broome County,260,69,60,0,9,20,9,0,0,9,240,60,60,0,0,674,42,632
360070146004,36, New York,007, Broome County,472,297,183,114,0,40,0,0,0,0,432,297,183,114,0,1319,133,1186
360050001000,36, New York,005, Bronx County,0,0,0,0,0,0,0,0,0,0,0,0,0,0,0,0,0,0
360050001001,36, New York,005, Bronx County,0,0,0,0,0,0,0,0,0,0,0,0,0,0,0,0,0,0
360050002000,36, New York,005, Bronx County,0,0,0,0,0,0,0,0,0,0,0,0,0,0,0,0,0,0
360050002001,36, New York,005, Bronx County,258,75,50,25,0,0,0,0,0,0,258,75,50,25,0,902,62,840
360050002002,36, New York,005, Bronx County,496,181,59,72,50,68,50,0,41,9,428,131,59,31,41,1597,344,1253
360050002003,36, New York,005, Bronx County,322,197,159,0,38,0,0,0,0,0,322,197,159,0,38,779,36,743
360050004000,36, New York,005, Bronx County,0,0,0,0,0,0,0,0,0,0,0,0,0,0,0,0,0,0
360050004001,36, New York,005, Bronx County,162,20,0,0,20,12,0,0,0,0,150,20,0,0,20,554,26,528
360050004002,36, New York,005, Bronx County,172,117,36,0,81,39,39,0,0,39,133,78,36,0,42,1043,80,963
360050004003,36, New York,005, Bronx County,1047,576,281,162,133,58,22,0,0,22,989,554,281,162,111,2601,204,2397
360050004004,36, New York,005, Bronx County,135,90,76,0,14,0,0,0,0,0,135,90,76,0,14,381,0,381
360050016001,36, New York,005, Bronx County,827,413,52,97,264,210,196,0,0,196,617,217,52,97,68,2011,517,1494
360050016002,36, New York,005, Bronx County,217,18,15,0,3,3,3,0,0,3,214,15,15,0,0,610,125,485
360050016003,36, New York,005, Bronx County,376,212,21,31,160,6,0,0,0,0,370,212,21,31,160,1048,81,967
360050016004,36, New York,005, Bronx County,196,69,18,0,51,6,0,0,0,0,190,69,18,0,51,694,85,609
360050019011,36, New York,005, Bronx County,546,302,48,35,219,137,98,14,0,84,409,204,34,35,135,1420,394,1026
360050019021,36, New York,005, Bronx County,291,124,61,12,51,56,48,20,0,28,235,76,41,12,23,1325,436,889
360050019031,36, New York,005, Bronx County,0,0,0,0,0,0,0,0,0,0,0,0,0,0,0,0,0,0
360050019032,36, New York,005, Bronx County,0,0,0,0,0,0,0,0,0,0,0,0,0,0,0,0,0,0
360050019040,36, New York,005, Bronx County,0,0,0,0,0,0,0,0,0,0,0,0,0,0,0,0,0,0
360050019041,36, New York,005, Bronx County,0,0,0,0,0,0,0,0,0,0,0,0,0,0,0,0,0,0
360050019042,36, New York,005, Bronx County,0,0,0,0,0,0,0,0,0,0,0,0,0,0,0,0,0,0
360050020011,36, New York,005, Bronx County,568,324,112,0,212,147,147,63,0,84,421,177,49,0,128,1498,465,1033
360050020012,36, New York,005, Bronx County,224,133,12,0,121,89,67,0,0,67,135,66,12,0,54,670,359,311
360050020013,36, New York,005, Bronx County,215,105,24,0,81,68,68,0,0,68,147,37,24,0,13,660,68,592
360050020021,36, New York,005, Bronx County,111,86,0,0,86,45,23,0,0,23,66,63,0,0,63,259,117,142
360050020022,36, New York,005, Bronx County,637,261,109,0,152,200,0,0,0,0,437,261,109,0,152,1652,668,984
360050020023,36, New York,005, Bronx County,206,63,53,0,10,0,0,0,0,0,206,63,53,0,10,996,311,685
360050023001,36, New York,005, Bronx County,468,227,35,48,144,145,140,19,30,91,323,87,16,18,53,1172,488,684
360050023002,36, New York,005, Bronx County,175,128,0,16,112,63,63,0,0,63,112,65,0,16,49,474,156,318
360050023003,36, New York,005, Bronx County,454,296,75,41,180,179,105,0,17,88,275,191,75,24,92,950,577,373
360050024000,36, New York,005, Bronx County,0,0,0,0,0,0,0,0,0,0,0,0,0,0,0,0,0,0
360050024001,36, New York,005, Bronx County,0,0,0,0,0,0,0,0,0,0,0,0,0,0,0,0,0,0
360050025001,36, New York,005, Bronx County,238,80,62,0,18,80,80,62,0,18,158,0,0,0,0,566,241,325
360050025002,36, New York,005, Bronx County,277,134,30,0,104,125,88,0,0,88,152,46,30,0,16,676,323,353
360050025003,36, New York,005, Bronx County,231,126,73,0,53,143,94,41,0,53,88,32,32,0,0,416,225,191
360050025004,36, New York,005, Bronx County,421,229,96,40,93,52,36,0,0,36,369,193,96,40,57,1014,84,930
360050025005,36, New York,005, Bronx County,139,42,0,0,42,78,28,0,0,28,61,14,0,0,14,455,328,127
360050027011,36, New York,005, Bronx County,314,155,46,0,109,146,78,18,0,60,168,77,28,0,49,697,346,351
360050027012,36, New York,005, Bronx County,479,324,48,35,241,265,246,48,0,198,214,78,0,35,43,714,355,359
360050027021,36, New York,005, Bronx County,286,176,61,0,115,75,75,0,0,75,211,101,61,0,40,939,315,624
360050027022,36, New York,005, Bronx County,172,134,114,0,20,58,20,0,0,20,114,114,114,0,0,468,265,203
360050027023,36, New York,005, Bronx County,268,158,70,0,88,67,67,29,0,38,201,91,41,0,50,878,301,577
360050027024,36, New York,005, Bronx County,308,233,98,0,135,269,209,74,0,135,39,24,24,0,0,644,500,144
360050028001,36, New York,005, Bronx County,284,127,44,0,83,0,0,0,0,0,284,127,44,0,83,967,24,943
360050028002,36, New York,005, Bronx County,190,51,0,0,51,29,29,0,0,29,161,22,0,0,22,956,29,927
360050028003,36, New York,005, Bronx County,492,174,0,33,141,0,0,0,0,0,492,174,0,33,141,1471,19,1452
360050028004,36, New York,005, Bronx County,259,160,89,0,71,0,0,0,0,0,259,160,89,0,71,1075,22,1053
360050031001,36, New York,005, Bronx County,778,567,159,15,393,127,111,42,15,54,651,456,117,0,339,1651,289,1362
360050033001,36, New York,005, Bronx County,131,101,0,0,101,0,0,0,0,0,131,101,0,0,101,349,108,241
360050033002,36, New York,005, Bronx County,415,279,0,51,228,206,206,0,51,155,209,73,0,0,73,958,405,553
360050033003,36, New York,005, Bronx County,234,188,14,0,174,121,95,0,0,95,113,93,14,0,79,863,516,347
360050035001,36, New York,005, Bronx County,235,177,44,0,133,105,105,9,0,96,130,72,35,0,37,546,99,447
360050035002,36, New York,005, Bronx County,309,129,21,0,108,106,48,0,0,48,203,81,21,0,60,727,241,486
360050035003,36, New York,005, Bronx County,584,367,25,0,342,81,81,0,0,81,503,286,25,0,261,1104,124,980
360050037001,36, New York,005, Bronx County,80,23,0,0,23,0,0,0,0,0,80,23,0,0,23,268,115,153
360050038001,36, New York,005, Bronx County,304,153,49,0,104,33,33,0,0,33,271,120,49,0,71,732,39,693
360050039001,36, New York,005, Bronx County,401,265,214,0,51,141,51,0,0,51,260,214,214,0,0,603,460,143
360050039002,36, New York,005, Bronx County,93,93,28,0,65,15,15,0,0,15,78,78,28,0,50,146,128,18
360050039003,36, New York,005, Bronx County,122,0,0,0,0,0,0,0,0,0,122,0,0,0,0,1019,318,701
360050039004,36, New York,005, Bronx County,83,28,28,0,0,0,0,0,0,0,83,28,28,0,0,188,0,188
360050039005,36, New York,005, Bronx County,432,363,185,31,147,234,234,83,31,120,198,129,102,0,27,1336,641,695
360050040011,36, New York,005, Bronx County,359,191,133,12,46,36,36,24,12,0,323,155,109,0,46,977,63,914
360050041001,36, New York,005, Bronx County,333,18,18,0,0,86,0,0,0,0,247,18,18,0,0,1426,437,989
360050041002,36, New York,005, Bronx County,278,151,103,0,48,59,59,59,0,0,219,92,44,0,48,945,348,597
360050041003,36, New York,005, Bronx County,28,0,0,0,0,0,0,0,0,0,28,0,0,0,0,85,0,85
360050041004,36, New York,005, Bronx County,924,486,120,217,149,395,240,120,93,27,529,246,0,124,122,1897,630,1267
360050042001,36, New York,005, Bronx County,217,34,0,0,34,0,0,0,0,0,217,34,0,0,34,614,13,601
360050042002,36, New York,005, Bronx County,339,263,0,0,263,240,240,0,0,240,99,23,0,0,23,773,510,263
360050042003,36, New York,005, Bronx County,708,525,179,24,322,32,0,0,0,0,676,525,179,24,322,1436,296,1140
360050042004,36, New York,005, Bronx County,380,297,145,0,152,0,0,0,0,0,380,297,145,0,152,1022,2,1020
360050042005,36, New York,005, Bronx County,484,323,23,34,266,0,0,0,0,0,484,323,23,34,266,754,48,706
360050042006,36, New York,005, Bronx County,0,0,0,0,0,0,0,0,0,0,0,0,0,0,0,0,0,0
360050042007,36, New York,005, Bronx County,106,65,65,0,0,0,0,0,0,0,106,65,65,0,0,522,91,431
360050043001,36, New York,005, Bronx County,252,208,106,29,73,68,40,14,0,26,184,168,92,29,47,914,417,497
360050043002,36, New York,005, Bronx County,472,259,0,0,259,96,96,0,0,96,376,163,0,0,163,1105,182,923
360050043003,36, New York,005, Bronx County,348,248,123,0,125,88,51,0,0,51,260,197,123,0,74,978,221,757
360050043004,36, New York,005, Bronx County,195,71,10,0,61,9,0,0,0,0,186,71,10,0,61,542,151,391
360050044001,36, New York,005, Bronx County,268,181,0,0,181,144,86,0,0,86,124,95,0,0,95,552,360,192
360050044002,36, New York,005, Bronx County,150,78,17,0,61,55,41,0,0,41,95,37,17,0,20,375,150,225
360050044003,36, New York,005, Bronx County,417,230,116,50,64,184,102,44,50,8,233,128,72,0,56,1224,462,762
360050044004,36, New York,005, Bronx County,259,147,51,0,96,97,72,31,0,41,162,75,20,0,55,627,333,294
360050046001,36, New York,005, Bronx County,362,272,94,27,151,170,170,39,0,131,192,102,55,27,20,1097,594,503
360050048001,36, New York,005, Bronx County,483,335,188,31,116,137,99,0,0,99,346,236,188,31,17,792,164,628
360050048002,36, New York,005, Bronx County,655,481,78,88,315,222,209,17,43,149,433,272,61,45,166,1384,321,1063
360050050011,36, New York,005, Bronx County,172,127,76,0,51,75,65,44,0,21,97,62,32,0,30,277,104,173
360050050012,36, New York,005, Bronx County,350,196,44,25,127,151,99,32,0,67,199,97,12,25,60,655,374,281
360050050013,36, New York,005, Bronx County,147,98,46,0,52,93,60,31,0,29,54,38,15,0,23,351,224,127
360050050014,36, New York,005, Bronx County,322,107,84,0,23,115,46,46,0,0,207,61,38,0,23,783,345,438
360050050021,36, New York,005, Bronx County,452,324,94,64,166,204,164,66,0,98,248,160,28,64,68,748,275,473
360050050022,36, New York,005, Bronx County,235,148,50,71,27,37,37,37,0,0,198,111,13,71,27,302,28,274
360050050023,36, New York,005, Bronx County,409,294,180,0,114,172,100,19,0,81,237,194,161,0,33,613,132,481
360050050024,36, New York,005, Bronx County,226,140,23,87,30,50,50,17,33,0,176,90,6,54,30,418,70,348
360050051001,36, New York,005, Bronx County,131,0,0,0,0,0,0,0,0,0,131,0,0,0,0,194,0,194
360050051002,36, New York,005, Bronx County,767,612,143,29,440,347,309,57,0,252,420,303,86,29,188,2309,1175,1134
360050051003,36, New York,005, Bronx County,674,370,0,0,370,325,204,0,0,204,349,166,0,0,166,1523,694,829
360050052001,36, New York,005, Bronx County,301,226,12,28,186,122,115,0,0,115,179,111,12,28,71,500,133,367
360050052002,36, New York,005, Bronx County,280,107,25,0,82,82,34,7,0,27,198,73,18,0,55,662,190,472
360050053001,36, New York,005, Bronx County,457,305,0,70,235,229,183,0,53,130,228,122,0,17,105,1315,691,624
360050053002,36, New York,005, Bronx County,633,564,120,39,405,197,197,0,0,197,436,367,120,39,208,894,345,549
360050054001,36, New York,005, Bronx County,198,147,75,0,72,21,21,0,0,21,177,126,75,0,51,606,44,562
360050054002,36, New York,005, Bronx County,575,370,93,58,219,165,151,0,47,104,410,219,93,11,115,1258,308,950
360050054003,36, New York,005, Bronx County,282,200,107,30,63,53,45,0,18,27,229,155,107,12,36,357,53,304
360050054004,36, New York,005, Bronx County,216,140,93,0,47,85,72,25,0,47,131,68,68,0,0,519,211,308
360050056001,36, New York,005, Bronx County,152,57,32,0,25,35,24,16,0,8,117,33,16,0,17,534,173,361
360050056002,36, New York,005, Bronx County,160,82,44,20,18,24,24,0,13,11,136,58,44,7,7,347,54,293
360050056003,36, New York,005, Bronx County,197,160,54,7,99,59,56,21,0,35,138,104,33,7,64,324,123,201
360050059021,36, New York,005, Bronx County,285,183,107,51,25,72,40,15,0,25,213,143,92,51,0,643,101,542
360050059022,36, New York,005, Bronx County,313,115,37,42,36,123,36,0,0,36,190,79,37,42,0,1072,435,637
360050060001,36, New York,005, Bronx County,286,122,9,38,75,62,53,0,23,30,224,69,9,15,45,792,83,709
360050060002,36, New York,005, Bronx County,0,0,0,0,0,0,0,0,0,0,0,0,0,0,0,0,0,0
360050061001,36, New York,005, Bronx County,0,0,0,0,0,0,0,0,0,0,0,0,0,0,0,0,0,0
360050061002,36, New York,005, Bronx County,745,192,89,10,93,44,35,25,10,0,701,157,64,0,93,2554,338,2216
360050061003,36, New York,005, Bronx County,164,97,44,0,53,32,32,0,0,32,132,65,44,0,21,748,43,705
360050061004,36, New York,005, Bronx County,0,0,0,0,0,0,0,0,0,0,0,0,0,0,0,1,0,1
360050062001,36, New York,005, Bronx County,180,110,0,0,110,0,0,0,0,0,180,110,0,0,110,645,46,599
360050062002,36, New York,005, Bronx County,637,270,26,77,167,230,173,26,77,70,407,97,0,0,97,1499,662,837
360050062003,36, New York,005, Bronx County,586,246,51,84,111,205,111,0,0,111,381,135,51,84,0,1510,459,1051
360050062004,36, New York,005, Bronx County,358,182,54,67,61,155,115,54,0,61,203,67,0,67,0,191,91,100
360050062005,36, New York,005, Bronx County,69,29,0,0,29,0,0,0,0,0,69,29,0,0,29,256,0,256
360050063011,36, New York,005, Bronx County,139,79,42,0,37,36,0,0,0,0,103,79,42,0,37,366,142,224
360050063012,36, New York,005, Bronx County,127,85,65,0,20,62,20,0,0,20,65,65,65,0,0,680,227,453
360050063013,36, New York,005, Bronx County,257,120,25,80,15,52,15,0,0,15,205,105,25,80,0,442,167,275
360050063014,36, New York,005, Bronx County,562,303,195,85,23,104,42,42,0,0,458,261,153,85,23,1870,567,1303
360050063015,36, New York,005, Bronx County,75,45,0,0,45,0,0,0,0,0,75,45,0,0,45,97,0,97
360050063016,36, New York,005, Bronx County,11,5,0,0,5,0,0,0,0,0,11,5,0,0,5,146,64,82
360050063021,36, New York,005, Bronx County,0,0,0,0,0,0,0,0,0,0,0,0,0,0,0,0,0,0
360050064001,36, New York,005, Bronx County,437,179,23,31,125,214,111,0,31,80,223,68,23,0,45,915,337,578
360050064002,36, New York,005, Bronx County,136,56,46,0,10,0,0,0,0,0,136,56,46,0,10,269,46,223
360050064003,36, New York,005, Bronx County,209,51,0,0,51,72,0,0,0,0,137,51,0,0,51,540,103,437
360050064004,36, New York,005, Bronx County,199,133,0,123,10,163,108,0,98,10,36,25,0,25,0,192,115,77
360050065001,36, New York,005, Bronx County,198,128,0,76,52,52,52,0,0,52,146,76,0,76,0,418,58,360
360050065002,36, New York,005, Bronx County,975,569,85,0,484,602,449,0,0,449,373,120,85,0,35,2224,1124,1100
360050065003,36, New York,005, Bronx County,116,101,101,0,0,30,15,15,0,0,86,86,86,0,0,196,139,57
360050065004,36, New York,005, Bronx County,15,0,0,0,0,0,0,0,0,0,15,0,0,0,0,239,188,51
360050067001,36, New York,005, Bronx County,110,110,110,0,0,0,0,0,0,0,110,110,110,0,0,306,100,206
360050067002,36, New York,005, Bronx County,532,425,172,0,253,217,217,0,0,217,315,208,172,0,36,1063,305,758
360050067003,36, New York,005, Bronx County,278,215,29,0,186,186,186,0,0,186,92,29,29,0,0,626,368,258
360050067004,36, New York,005, Bronx County,343,229,0,0,229,189,158,0,0,158,154,71,0,0,71,730,330,400
360050067005,36, New York,005, Bronx County,43,29,0,0,29,29,29,0,0,29,14,0,0,0,0,300,254,46
360050067006,36, New York,005, Bronx County,308,308,0,0,308,308,308,0,0,308,0,0,0,0,0,460,303,157
360050068001,36, New York,005, Bronx County,311,188,85,53,50,72,72,0,53,19,239,116,85,0,31,610,122,488
360050068002,36, New York,005, Bronx County,213,89,14,0,75,90,55,14,0,41,123,34,0,0,34,440,207,233
360050068003,36, New York,005, Bronx County,131,78,0,8,70,30,30,0,8,22,101,48,0,0,48,355,106,249
360050069001,36, New York,005, Bronx County,702,444,266,40,138,185,144,3,40,101,517,300,263,0,37,2246,726,1520
360050069002,36, New York,005, Bronx County,423,402,54,0,348,322,322,36,0,286,101,80,18,0,62,876,391,485
360050069003,36, New York,005, Bronx County,218,63,0,0,63,80,15,0,0,15,138,48,0,0,48,1130,444,686
360050069004,36, New York,005, Bronx County,197,174,133,0,41,21,21,0,0,21,176,153,133,0,20,683,103,580
360050070001,36, New York,005, Bronx County,486,237,74,22,141,168,132,0,22,110,318,105,74,0,31,1242,227,1015
360050070002,36, New York,005, Bronx County,164,0,0,0,0,43,0,0,0,0,121,0,0,0,0,440,250,190
360050070003,36, New York,005, Bronx County,222,73,51,0,22,0,0,0,0,0,222,73,51,0,22,659,73,586
360050071001,36, New York,005, Bronx County,192,95,10,47,38,0,0,0,0,0,192,95,10,47,38,503,35,468
360050071002,36, New York,005, Bronx County,564,385,143,40,202,96,82,0,0,82,468,303,143,40,120,1500,340,1160
360050072001,36, New York,005, Bronx County,543,206,130,57,19,135,61,51,10,0,408,145,79,47,19,1276,101,1175
360050072002,36, New York,005, Bronx County,328,158,158,0,0,13,0,0,0,0,315,158,158,0,0,1102,89,1013
360050072003,36, New York,005, Bronx County,160,113,42,31,40,0,0,0,0,0,160,113,42,31,40,475,72,403
360050072004,36, New York,005, Bronx County,143,45,19,0,26,0,0,0,0,0,143,45,19,0,26,544,15,529
360050073001,36, New York,005, Bronx County,458,403,53,63,287,223,223,0,42,181,235,180,53,21,106,1071,694,377
360050073002,36, New York,005, Bronx County,133,78,0,0,78,25,25,0,0,25,108,53,0,0,53,425,79,346
360050073003,36, New York,005, Bronx County,553,182,0,39,143,114,44,0,0,44,439,138,0,39,99,1234,209,1025
360050074001,36, New York,005, Bronx County,328,195,33,14,148,60,14,0,14,0,268,181,33,0,148,905,184,721
360050074002,36, New York,005, Bronx County,277,112,0,0,112,65,53,0,0,53,212,59,0,0,59,791,200,591
360050074003,36, New York,005, Bronx County,196,0,0,0,0,0,0,0,0,0,196,0,0,0,0,839,47,792
360050075001,36, New York,005, Bronx County,369,225,81,102,42,112,71,26,45,0,257,154,55,57,42,731,239,492
360050075002,36, New York,005, Bronx County,915,508,289,87,132,296,139,19,87,33,619,369,270,0,99,2669,939,1730
360050075003,36, New York,005, Bronx County,266,85,43,0,42,39,39,27,0,12,227,46,16,0,30,607,146,461
360050075004,36, New York,005, Bronx County,109,53,1,0,52,47,41,0,0,41,62,12,1,0,11,410,187,223
360050076001,36, New York,005, Bronx County,290,117,54,0,63,55,15,0,0,15,235,102,54,0,48,715,212,503
360050076002,36, New York,005, Bronx County,161,68,0,56,12,25,25,0,13,12,136,43,0,43,0,484,112,372
360050076003,36, New York,005, Bronx County,293,198,116,21,61,32,0,0,0,0,261,198,116,21,61,533,84,449
360050076004,36, New York,005, Bronx County,361,155,68,18,69,27,17,17,0,0,334,138,51,18,69,775,136,639
360050076005,36, New York,005, Bronx County,167,74,44,15,15,15,15,0,15,0,152,59,44,0,15,405,52,353
360050077001,36, New York,005, Bronx County,486,234,67,22,145,99,78,0,0,78,387,156,67,22,67,1345,324,1021
360050078001,36, New York,005, Bronx County,310,185,185,0,0,0,0,0,0,0,310,185,185,0,0,941,61,880
360050078002,36, New York,005, Bronx County,669,462,150,0,312,185,185,19,0,166,484,277,131,0,146,1618,246,1372
360050078003,36, New York,005, Bronx County,105,74,25,0,49,74,74,25,0,49,31,0,0,0,0,153,12,141
360050078004,36, New York,005, Bronx County,322,156,84,0,72,23,0,0,0,0,299,156,84,0,72,942,99,843
360050079001,36, New York,005, Bronx County,439,333,109,0,224,131,80,0,0,80,308,253,109,0,144,780,159,621
360050079002,36, New York,005, Bronx County,122,53,0,0,53,89,53,0,0,53,33,0,0,0,0,497,323,174
360050079003,36, New York,005, Bronx County,174,140,0,0,140,66,51,0,0,51,108,89,0,0,89,506,302,204
360050079004,36, New York,005, Bronx County,377,211,90,67,54,19,14,0,0,14,358,197,90,67,40,607,36,571
360050079005,36, New York,005, Bronx County,276,159,67,53,39,78,39,0,0,39,198,120,67,53,0,613,174,439
360050079006,36, New York,005, Bronx County,390,162,22,0,140,205,20,0,0,20,185,142,22,0,120,701,365,336
360050083001,36, New York,005, Bronx County,191,165,131,0,34,0,0,0,0,0,191,165,131,0,34,711,142,569
360050083002,36, New York,005, Bronx County,127,41,20,0,21,34,21,0,0,21,93,20,20,0,0,246,66,180
360050083003,36, New York,005, Bronx County,312,123,54,29,40,48,48,0,29,19,264,75,54,0,21,987,48,939
360050083004,36, New York,005, Bronx County,481,329,179,0,150,0,0,0,0,0,481,329,179,0,150,1141,45,1096
360050083005,36, New York,005, Bronx County,160,107,67,0,40,40,40,0,0,40,120,67,67,0,0,423,171,252
360050083006,36, New York,005, Bronx County,119,91,0,0,91,2,2,0,0,2,117,89,0,0,89,210,2,208
360050084001,36, New York,005, Bronx County,185,89,55,20,14,0,0,0,0,0,185,89,55,20,14,664,0,664
360050084002,36, New York,005, Bronx County,325,135,82,21,32,9,9,0,0,9,316,126,82,21,23,1521,128,1393
360050085001,36, New York,005, Bronx County,118,37,0,37,0,81,0,0,0,0,37,37,0,37,0,542,266,276
360050085002,36, New York,005, Bronx County,425,232,65,27,140,131,94,32,0,62,294,138,33,27,78,1389,514,875
360050085003,36, New York,005, Bronx County,321,232,87,15,130,47,33,33,0,0,274,199,54,15,130,745,155,590
360050085004,36, New York,005, Bronx County,171,71,0,0,71,68,19,0,0,19,103,52,0,0,52,329,196,133
360050085005,36, New York,005, Bronx County,150,40,0,0,40,6,6,0,0,6,144,34,0,0,34,698,286,412
360050086001,36, New York,005, Bronx County,222,52,0,0,52,0,0,0,0,0,222,52,0,0,52,486,16,470
360050086002,36, New York,005, Bronx County,296,230,0,0,230,75,56,0,0,56,221,174,0,0,174,810,304,506
360050086003,36, New York,005, Bronx County,487,166,0,19,147,273,73,0,19,54,214,93,0,0,93,1507,989,518
360050087001,36, New York,005, Bronx County,414,327,124,0,203,144,137,30,0,107,270,190,94,0,96,1400,296,1104
360050087002,36, New York,005, Bronx County,409,280,190,0,90,180,178,132,0,46,229,102,58,0,44,822,339,483
360050087003,36, New York,005, Bronx County,152,61,20,0,41,28,20,20,0,0,124,41,0,0,41,365,142,223
360050087004,36, New York,005, Bronx County,211,78,16,0,62,71,32,0,0,32,140,46,16,0,30,531,141,390
360050087005,36, New York,005, Bronx County,350,330,92,0,238,207,207,58,0,149,143,123,34,0,89,785,450,335
360050089001,36, New York,005, Bronx County,254,98,52,0,46,0,0,0,0,0,254,98,52,0,46,1196,292,904
360050089002,36, New York,005, Bronx County,423,146,26,95,25,39,26,26,0,0,384,120,0,95,25,1090,217,873
360050090000,36, New York,005, Bronx County,0,0,0,0,0,0,0,0,0,0,0,0,0,0,0,0,0,0
360050090001,36, New York,005, Bronx County,5,5,5,0,0,0,0,0,0,0,5,5,5,0,0,16,0,16
360050090002,36, New York,005, Bronx County,98,86,86,0,0,0,0,0,0,0,98,86,86,0,0,247,88,159
360050090003,36, New York,005, Bronx County,270,194,15,56,123,81,56,0,56,0,189,138,15,0,123,523,174,349
360050090004,36, New York,005, Bronx County,244,167,39,98,30,16,16,0,16,0,228,151,39,82,30,620,121,499
360050090005,36, New York,005, Bronx County,319,134,0,0,134,226,124,0,0,124,93,10,0,0,10,805,543,262
360050092001,36, New York,005, Bronx County,358,251,195,0,56,38,0,0,0,0,320,251,195,0,56,863,65,798
360050092002,36, New York,005, Bronx County,179,95,27,45,23,23,23,0,0,23,156,72,27,45,0,484,42,442
360050092003,36, New York,005, Bronx County,395,224,76,127,21,59,25,0,19,6,336,199,76,108,15,801,159,642
360050092004,36, New York,005, Bronx County,284,190,52,46,92,135,117,24,46,47,149,73,28,0,45,928,330,598
360050092005,36, New York,005, Bronx County,160,38,38,0,0,4,0,0,0,0,156,38,38,0,0,341,36,305
360050093011,36, New York,005, Bronx County,216,130,50,46,34,32,32,32,0,0,184,98,18,46,34,535,28,507
360050093012,36, New York,005, Bronx County,315,143,35,42,66,132,89,0,42,47,183,54,35,0,19,656,205,451
360050093013,36, New York,005, Bronx County,394,304,183,16,105,43,0,0,0,0,351,304,183,16,105,652,218,434
360050093014,36, New York,005, Bronx County,261,187,92,0,95,41,41,0,0,41,220,146,92,0,54,616,246,370
360050093015,36, New York,005, Bronx County,0,0,0,0,0,0,0,0,0,0,0,0,0,0,0,0,0,0
360050093016,36, New York,005, Bronx County,57,57,38,0,19,19,19,0,0,19,38,38,38,0,0,38,38,0
360050093020,36, New York,005, Bronx County,0,0,0,0,0,0,0,0,0,0,0,0,0,0,0,0,0,0
360050093021,36, New York,005, Bronx County,0,0,0,0,0,0,0,0,0,0,0,0,0,0,0,0,0,0
360050093022,36, New York,005, Bronx County,0,0,0,0,0,0,0,0,0,0,0,0,0,0,0,0,0,0
360050096001,36, New York,005, Bronx County,389,198,129,10,59,28,12,0,0,12,361,186,129,10,47,1142,152,990
360050096002,36, New York,005, Bronx County,187,102,40,5,57,63,50,9,0,41,124,52,31,5,16,494,123,371
360050098001,36, New York,005, Bronx County,158,97,40,0,57,0,0,0,0,0,158,97,40,0,57,465,0,465
360050098002,36, New York,005, Bronx County,312,31,7,0,24,83,0,0,0,0,229,31,7,0,24,1202,287,915
360050098003,36, New York,005, Bronx County,258,111,55,0,56,91,41,0,0,41,167,70,55,0,15,592,176,416
360050098004,36, New York,005, Bronx County,152,72,40,32,0,0,0,0,0,0,152,72,40,32,0,382,0,382
360050098005,36, New York,005, Bronx County,254,160,78,9,73,71,71,31,0,40,183,89,47,9,33,775,179,596
360050110000,36, New York,005, Bronx County,0,0,0,0,0,0,0,0,0,0,0,0,0,0,0,0,0,0
360050110001,36, New York,005, Bronx County,0,0,0,0,0,0,0,0,0,0,0,0,0,0,0,0,0,0
360050115021,36, New York,005, Bronx County,283,156,6,14,136,152,136,0,0,136,131,20,6,14,0,750,363,387
360050115022,36, New York,005, Bronx County,338,203,50,31,122,115,47,0,0,47,223,156,50,31,75,1054,496,558
360050115023,36, New York,005, Bronx County,386,279,20,152,107,112,99,0,43,56,274,180,20,109,51,768,287,481
360050117011,36, New York,005, Bronx County,347,236,21,0,215,108,99,21,0,78,239,137,0,0,137,918,233,685
360050117012,36, New York,005, Bronx County,0,0,0,0,0,0,0,0,0,0,0,0,0,0,0,0,0,0
360050117020,36, New York,005, Bronx County,0,0,0,0,0,0,0,0,0,0,0,0,0,0,0,0,0,0
360050117021,36, New York,005, Bronx County,0,0,0,0,0,0,0,0,0,0,0,0,0,0,0,0,0,0
360050118000,36, New York,005, Bronx County,0,0,0,0,0,0,0,0,0,0,0,0,0,0,0,0,0,0
360050118001,36, New York,005, Bronx County,439,197,113,62,22,49,22,0,0,22,390,175,113,62,0,1261,89,1172
360050118002,36, New York,005, Bronx County,363,129,129,0,0,0,0,0,0,0,363,129,129,0,0,923,22,901
360050118003,36, New York,005, Bronx County,388,248,71,65,112,58,58,0,0,58,330,190,71,65,54,1058,157,901
360050119001,36, New York,005, Bronx County,523,303,147,24,132,64,56,0,0,56,459,247,147,24,76,1525,159,1366
360050119002,36, New York,005, Bronx County,343,200,26,0,174,110,38,0,0,38,233,162,26,0,136,690,290,400
360050119003,36, New York,005, Bronx County,138,127,65,0,62,21,21,21,0,0,117,106,44,0,62,377,20,357
360050119004,36, New York,005, Bronx County,223,175,51,36,88,83,83,0,0,83,140,92,51,36,5,548,248,300
360050119005,36, New York,005, Bronx County,180,140,0,0,140,94,71,0,0,71,86,69,0,0,69,255,150,105
360050121011,36, New York,005, Bronx County,221,92,18,16,58,60,34,10,16,8,161,58,8,0,50,662,259,403
360050121012,36, New York,005, Bronx County,555,319,114,40,165,121,112,16,0,96,434,207,98,40,69,1346,238,1108
360050121021,36, New York,005, Bronx County,307,140,46,0,94,19,12,0,0,12,288,128,46,0,82,942,254,688
360050123001,36, New York,005, Bronx County,425,283,33,0,250,87,81,0,0,81,338,202,33,0,169,1137,213,924
360050123002,36, New York,005, Bronx County,488,337,320,0,17,0,0,0,0,0,488,337,320,0,17,1166,73,1093
360050123003,36, New York,005, Bronx County,310,86,12,74,0,17,0,0,0,0,293,86,12,74,0,965,136,829
360050123004,36, New York,005, Bronx County,0,0,0,0,0,0,0,0,0,0,0,0,0,0,0,0,0,0
360050123005,36, New York,005, Bronx County,0,0,0,0,0,0,0,0,0,0,0,0,0,0,0,0,0,0
360050123006,36, New York,005, Bronx County,0,0,0,0,0,0,0,0,0,0,0,0,0,0,0,0,0,0
360050125001,36, New York,005, Bronx County,667,387,127,56,204,198,118,0,0,118,469,269,127,56,86,1491,292,1199
360050125002,36, New York,005, Bronx County,312,139,85,0,54,58,42,42,0,0,254,97,43,0,54,823,209,614
360050127011,36, New York,005, Bronx County,373,264,39,39,186,124,124,27,0,97,249,140,12,39,89,870,294,576
360050127012,36, New York,005, Bronx County,195,92,24,58,10,28,0,0,0,0,167,92,24,58,10,708,88,620
360050129011,36, New York,005, Bronx County,492,401,181,44,176,117,117,0,44,73,375,284,181,0,103,1100,280,820
360050129012,36, New York,005, Bronx County,630,455,113,157,185,248,195,71,0,124,382,260,42,157,61,1859,807,1052
360050130001,36, New York,005, Bronx County,290,71,48,23,0,33,0,0,0,0,257,71,48,23,0,1074,335,739
360050131001,36, New York,005, Bronx County,197,81,9,0,72,90,72,0,0,72,107,9,9,0,0,1105,471,634
360050131002,36, New York,005, Bronx County,214,100,0,21,79,82,54,0,0,54,132,46,0,21,25,601,156,445
360050131003,36, New York,005, Bronx County,409,262,82,0,180,159,159,25,0,134,250,103,57,0,46,1031,335,696
360050131004,36, New York,005, Bronx County,83,47,16,14,17,17,17,0,0,17,66,30,16,14,0,624,223,401
360050132000,36, New York,005, Bronx County,0,0,0,0,0,0,0,0,0,0,0,0,0,0,0,0,0,0
360050132001,36, New York,005, Bronx County,277,221,183,0,38,0,0,0,0,0,277,221,183,0,38,590,38,552
360050132002,36, New York,005, Bronx County,489,158,51,21,86,0,0,0,0,0,489,158,51,21,86,1592,35,1557
360050132003,36, New York,005, Bronx County,311,122,67,0,55,37,11,0,0,11,274,111,67,0,44,883,122,761
360050132004,36, New York,005, Bronx County,324,153,114,0,39,82,82,43,0,39,242,71,71,0,0,726,69,657
360050132005,36, New York,005, Bronx County,577,182,106,0,76,45,0,0,0,0,532,182,106,0,76,1601,92,1509
360050133001,36, New York,005, Bronx County,526,299,0,97,202,78,40,0,0,40,448,259,0,97,162,1368,385,983
360050133002,36, New York,005, Bronx County,278,278,138,0,140,49,49,0,0,49,229,229,138,0,91,962,291,671
360050133003,36, New York,005, Bronx County,131,0,0,0,0,21,0,0,0,0,110,0,0,0,0,363,56,307
360050133004,36, New York,005, Bronx County,591,305,205,0,100,72,21,0,0,21,519,284,205,0,79,1518,273,1245
360050135001,36, New York,005, Bronx County,97,52,0,0,52,52,52,0,0,52,45,0,0,0,0,241,120,121
360050135002,36, New York,005, Bronx County,642,551,0,0,551,320,320,0,0,320,322,231,0,0,231,1115,591,524
360050135003,36, New York,005, Bronx County,287,160,16,15,129,16,16,16,0,0,271,144,0,15,129,469,155,314
360050138000,36, New York,005, Bronx County,0,0,0,0,0,0,0,0,0,0,0,0,0,0,0,0,0,0
360050138001,36, New York,005, Bronx County,394,142,91,17,34,7,7,0,0,7,387,135,91,17,27,1321,42,1279
360050138002,36, New York,005, Bronx County,266,141,65,9,67,44,35,9,0,26,222,106,56,9,41,869,191,678
360050141001,36, New York,005, Bronx County,432,339,113,42,184,118,105,0,42,63,314,234,113,0,121,1085,246,839
360050141002,36, New York,005, Bronx County,493,309,62,0,247,82,58,0,0,58,411,251,62,0,189,1775,362,1413
360050141003,36, New York,005, Bronx County,595,386,130,45,211,175,140,20,0,120,420,246,110,45,91,1861,648,1213
360050143001,36, New York,005, Bronx County,285,222,125,19,78,91,91,37,6,48,194,131,88,13,30,1064,443,621
360050144001,36, New York,005, Bronx County,22,11,0,11,0,11,11,0,11,0,11,0,0,0,0,388,299,89
360050144002,36, New York,005, Bronx County,181,103,0,0,103,104,34,0,0,34,77,69,0,0,69,391,269,122
360050144003,36, New York,005, Bronx County,153,134,0,0,134,53,53,0,0,53,100,81,0,0,81,357,227,130
360050144004,36, New York,005, Bronx County,385,326,21,0,305,59,0,0,0,0,326,326,21,0,305,1364,386,978
360050144005,36, New York,005, Bronx County,326,216,60,0,156,33,33,6,0,27,293,183,54,0,129,771,176,595
360050144006,36, New York,005, Bronx County,249,227,128,71,28,0,0,0,0,0,249,227,128,71,28,882,190,692
360050145001,36, New York,005, Bronx County,188,99,0,0,99,67,34,0,0,34,121,65,0,0,65,929,234,695
360050145002,36, New York,005, Bronx County,473,385,28,43,314,290,290,28,43,219,183,95,0,0,95,1010,626,384
360050145003,36, New York,005, Bronx County,121,59,59,0,0,60,0,0,0,0,61,59,59,0,0,449,172,277
360050145004,36, New York,005, Bronx County,610,462,38,0,424,337,304,0,0,304,273,158,38,0,120,1521,704,817
360050147011,36, New York,005, Bronx County,648,261,16,33,212,261,261,16,33,212,387,0,0,0,0,1648,451,1197
360050147012,36, New York,005, Bronx County,296,75,27,0,48,26,26,0,0,26,270,49,27,0,22,1227,366,861
360050147013,36, New York,005, Bronx County,354,162,66,0,96,264,162,66,0,96,90,0,0,0,0,1060,475,585
360050147021,36, New York,005, Bronx County,231,101,0,0,101,150,101,0,0,101,81,0,0,0,0,510,297,213
360050147022,36, New York,005, Bronx County,633,290,154,0,136,201,123,0,0,123,432,167,154,0,13,1397,371,1026
360050147023,36, New York,005, Bronx County,141,109,0,0,109,61,29,0,0,29,80,80,0,0,80,386,183,203
360050147024,36, New York,005, Bronx County,285,109,30,0,79,61,61,13,0,48,224,48,17,0,31,943,371,572
360050149001,36, New York,005, Bronx County,295,194,14,50,130,118,107,0,0,107,177,87,14,50,23,794,362,432
360050149002,36, New York,005, Bronx County,259,179,26,20,133,0,0,0,0,0,259,179,26,20,133,1076,118,958
360050149003,36, New York,005, Bronx County,277,207,155,0,52,51,51,51,0,0,226,156,104,0,52,566,269,297
360050151001,36, New York,005, Bronx County,138,86,8,0,78,78,78,0,0,78,60,8,8,0,0,275,168,107
360050151002,36, New York,005, Bronx County,308,47,38,0,9,38,38,29,0,9,270,9,9,0,0,572,150,422
360050151003,36, New York,005, Bronx County,193,113,0,0,113,92,66,0,0,66,101,47,0,0,47,1044,464,580
360050151004,36, New York,005, Bronx County,395,246,0,65,181,51,47,0,0,47,344,199,0,65,134,953,178,775
360050152001,36, New York,005, Bronx County,305,165,107,10,48,7,7,7,0,0,298,158,100,10,48,844,74,770
360050152002,36, New York,005, Bronx County,312,191,83,9,99,51,42,14,9,19,261,149,69,0,80,947,164,783
360050153001,36, New York,005, Bronx County,505,314,25,54,235,124,97,0,0,97,381,217,25,54,138,1555,551,1004
360050153002,36, New York,005, Bronx County,104,79,34,0,45,14,14,0,0,14,90,65,34,0,31,533,96,437
360050153003,36, New York,005, Bronx County,237,165,52,0,113,0,0,0,0,0,237,165,52,0,113,472,90,382
360050155001,36, New York,005, Bronx County,673,381,112,102,167,123,97,0,0,97,550,284,112,102,70,1242,308,934
360050155002,36, New York,005, Bronx County,123,36,36,0,0,26,0,0,0,0,97,36,36,0,0,513,209,304
360050157001,36, New York,005, Bronx County,0,0,0,0,0,0,0,0,0,0,0,0,0,0,0,0,0,0
360050157002,36, New York,005, Bronx County,447,343,94,0,249,248,248,32,0,216,199,95,62,0,33,1389,398,991
360050157003,36, New York,005, Bronx County,349,219,57,0,162,0,0,0,0,0,349,219,57,0,162,869,97,772
360050157004,36, New York,005, Bronx County,420,260,64,0,196,177,96,0,0,96,243,164,64,0,100,863,400,463
360050158001,36, New York,005, Bronx County,302,154,81,0,73,53,34,11,0,23,249,120,70,0,50,1045,242,803
360050159001,36, New York,005, Bronx County,211,105,10,64,31,71,58,0,42,16,140,47,10,22,15,950,283,667
360050159002,36, New York,005, Bronx County,199,30,13,0,17,72,17,0,0,17,127,13,13,0,0,660,227,433
360050160000,36, New York,005, Bronx County,0,0,0,0,0,0,0,0,0,0,0,0,0,0,0,0,0,0
360050160001,36, New York,005, Bronx County,510,112,21,0,91,35,25,0,0,25,475,87,21,0,66,1333,104,1229
360050160002,36, New York,005, Bronx County,235,99,52,47,0,25,0,0,0,0,210,99,52,47,0,700,83,617
360050160003,36, New York,005, Bronx County,257,88,70,11,7,4,0,0,0,0,253,88,70,11,7,640,17,623
360050160004,36, New York,005, Bronx County,142,53,53,0,0,0,0,0,0,0,142,53,53,0,0,482,8,474
360050161001,36, New York,005, Bronx County,274,214,37,0,177,140,99,0,0,99,134,115,37,0,78,603,247,356
360050161002,36, New York,005, Bronx County,479,158,35,47,76,97,47,0,47,0,382,111,35,0,76,932,185,747
360050161003,36, New York,005, Bronx County,229,75,0,0,75,52,0,0,0,0,177,75,0,0,75,708,244,464
360050161004,36, New York,005, Bronx County,362,226,26,0,200,177,177,15,0,162,185,49,11,0,38,508,223,285
360050162001,36, New York,005, Bronx County,138,56,48,0,8,13,8,0,0,8,125,48,48,0,0,362,33,329
360050162002,36, New York,005, Bronx County,244,116,68,0,48,8,0,0,0,0,236,116,68,0,48,867,49,818
360050163001,36, New York,005, Bronx County,0,0,0,0,0,0,0,0,0,0,0,0,0,0,0,0,0,0
360050164001,36, New York,005, Bronx County,250,108,86,0,22,42,9,0,0,9,208,99,86,0,13,756,133,623
360050165001,36, New York,005, Bronx County,258,191,61,6,124,50,50,8,6,36,208,141,53,0,88,545,115,430
360050166001,36, New York,005, Bronx County,425,248,108,108,32,41,14,0,0,14,384,234,108,108,18,1227,169,1058
360050166002,36, New York,005, Bronx County,200,115,62,9,44,23,23,19,0,4,177,92,43,9,40,462,68,394
360050167001,36, New York,005, Bronx County,201,102,39,44,19,26,11,0,0,11,175,91,39,44,8,537,119,418
360050167002,36, New York,005, Bronx County,542,380,111,42,227,232,225,66,16,143,310,155,45,26,84,1464,499,965
360050169001,36, New York,005, Bronx County,332,206,83,14,109,73,59,36,0,23,259,147,47,14,86,1293,549,744
360050171001,36, New York,005, Bronx County,0,0,0,0,0,0,0,0,0,0,0,0,0,0,0,0,0,0
360050173001,36, New York,005, Bronx County,176,152,124,0,28,28,28,0,0,28,148,124,124,0,0,204,0,204
360050173002,36, New York,005, Bronx County,265,0,0,0,0,165,0,0,0,0,100,0,0,0,0,872,630,242
360050173003,36, New York,005, Bronx County,212,172,81,0,91,91,91,0,0,91,121,81,81,0,0,686,303,383
360050173004,36, New York,005, Bronx County,764,340,176,24,140,339,220,176,24,20,425,120,0,0,120,2105,536,1569
360050175001,36, New York,005, Bronx County,388,229,104,68,57,57,57,0,0,57,331,172,104,68,0,804,112,692
360050175002,36, New York,005, Bronx County,285,141,0,141,0,152,141,0,141,0,133,0,0,0,0,444,201,243
360050175003,36, New York,005, Bronx County,205,101,0,0,101,50,0,0,0,0,155,101,0,0,101,818,374,444
360050175004,36, New York,005, Bronx County,409,347,0,60,287,144,144,0,0,144,265,203,0,60,143,865,257,608
360050175005,36, New York,005, Bronx County,164,164,0,119,45,0,0,0,0,0,164,164,0,119,45,208,29,179
360050175006,36, New York,005, Bronx County,167,125,0,0,125,0,0,0,0,0,167,125,0,0,125,377,108,269
360050177011,36, New York,005, Bronx County,411,283,23,0,260,239,188,0,0,188,172,95,23,0,72,832,264,568
360050177012,36, New York,005, Bronx County,152,55,0,0,55,55,55,0,0,55,97,0,0,0,0,372,148,224
360050177013,36, New York,005, Bronx County,463,316,207,0,109,188,161,161,0,0,275,155,46,0,109,964,536,428
360050177021,36, New York,005, Bronx County,138,78,11,0,67,36,36,0,0,36,102,42,11,0,31,554,104,450
360050177022,36, New York,005, Bronx County,332,199,121,0,78,80,49,0,0,49,252,150,121,0,29,636,252,384
360050177023,36, New York,005, Bronx County,460,279,20,0,259,76,54,0,0,54,384,225,20,0,205,1211,483,728
360050177024,36, New York,005, Bronx County,304,223,61,93,69,107,107,0,93,14,197,116,61,0,55,930,466,464
360050179011,36, New York,005, Bronx County,741,178,92,0,86,138,73,4,0,69,603,105,88,0,17,1720,456,1264
360050179012,36, New York,005, Bronx County,159,123,82,0,41,20,20,0,0,20,139,103,82,0,21,401,20,381
360050179013,36, New York,005, Bronx County,301,164,45,0,119,39,25,0,0,25,262,139,45,0,94,785,275,510
360050179021,36, New York,005, Bronx County,296,226,97,58,71,85,85,51,0,34,211,141,46,58,37,628,196,432
360050179022,36, New York,005, Bronx County,242,157,26,0,131,22,8,0,0,8,220,149,26,0,123,485,146,339
360050179023,36, New York,005, Bronx County,421,290,204,0,86,70,0,0,0,0,351,290,204,0,86,502,65,437
360050181011,36, New York,005, Bronx County,446,385,113,43,229,186,186,15,0,171,260,199,98,43,58,782,276,506
360050181012,36, New York,005, Bronx County,296,183,60,15,108,96,88,0,15,73,200,95,60,0,35,629,244,385
360050181013,36, New York,005, Bronx County,69,56,34,0,22,21,8,8,0,0,48,48,26,0,22,181,120,61
360050181021,36, New York,005, Bronx County,144,80,36,28,16,16,16,0,0,16,128,64,36,28,0,728,369,359
360050181022,36, New York,005, Bronx County,427,390,207,66,117,152,152,58,25,69,275,238,149,41,48,591,79,512
360050181023,36, New York,005, Bronx County,118,80,0,0,80,52,52,0,0,52,66,28,0,0,28,302,69,233
360050181024,36, New York,005, Bronx County,223,91,65,26,0,17,17,17,0,0,206,74,48,26,0,842,82,760
360050183011,36, New York,005, Bronx County,372,192,146,46,0,28,0,0,0,0,344,192,146,46,0,1300,273,1027
360050183012,36, New York,005, Bronx County,282,104,62,28,14,42,42,0,28,14,240,62,62,0,0,557,83,474
360050183013,36, New York,005, Bronx County,357,146,59,11,76,22,0,0,0,0,335,146,59,11,76,1162,85,1077
360050183021,36, New York,005, Bronx County,334,165,162,0,3,43,33,33,0,0,291,132,129,0,3,1003,49,954
360050183022,36, New York,005, Bronx County,248,189,64,16,109,41,41,0,0,41,207,148,64,16,68,447,41,406
360050183023,36, New York,005, Bronx County,152,60,17,28,15,0,0,0,0,0,152,60,17,28,15,417,0,417
360050184001,36, New York,005, Bronx County,278,134,79,45,10,0,0,0,0,0,278,134,79,45,10,645,0,645
360050184002,36, New York,005, Bronx County,253,66,37,0,29,31,7,0,0,7,222,59,37,0,22,758,112,646
360050184003,36, New York,005, Bronx County,129,58,58,0,0,0,0,0,0,0,129,58,58,0,0,454,23,431
360050184004,36, New York,005, Bronx County,254,135,103,0,32,30,23,0,0,23,224,112,103,0,9,763,104,659
360050185011,36, New York,005, Bronx County,655,357,105,0,252,116,116,0,0,116,539,241,105,0,136,1642,555,1087
360050185021,36, New York,005, Bronx County,139,139,37,0,102,35,35,0,0,35,104,104,37,0,67,983,308,675
360050185022,36, New York,005, Bronx County,684,345,50,0,295,308,186,0,0,186,376,159,50,0,109,2358,1212,1146
360050185023,36, New York,005, Bronx County,240,158,0,0,158,71,71,0,0,71,169,87,0,0,87,520,71,449
360050185024,36, New York,005, Bronx County,222,69,0,0,69,172,69,0,0,69,50,0,0,0,0,626,348,278
360050189001,36, New York,005, Bronx County,485,412,128,62,222,192,192,39,62,91,293,220,89,0,131,1121,499,622
360050189002,36, New York,005, Bronx County,486,299,114,54,131,126,126,0,0,126,360,173,114,54,5,1166,260,906
360050189003,36, New York,005, Bronx County,482,273,70,35,168,43,0,0,0,0,439,273,70,35,168,1214,337,877
360050189004,36, New York,005, Bronx County,370,214,88,11,115,132,76,65,11,0,238,138,23,0,115,1035,511,524
360050193001,36, New York,005, Bronx County,607,270,46,58,166,82,82,0,0,82,525,188,46,58,84,1661,355,1306
360050193002,36, New York,005, Bronx County,375,265,27,0,238,81,27,27,0,0,294,238,0,0,238,1023,292,731
360050193003,36, New York,005, Bronx County,206,101,22,24,55,0,0,0,0,0,206,101,22,24,55,466,34,432
360050193004,36, New York,005, Bronx County,382,162,0,0,162,146,73,0,0,73,236,89,0,0,89,819,253,566
360050194001,36, New York,005, Bronx County,518,245,103,13,129,89,70,6,0,64,429,175,97,13,65,1380,197,1183
360050195001,36, New York,005, Bronx County,532,297,26,150,121,157,83,0,0,83,375,214,26,150,38,1668,863,805
360050195002,36, New York,005, Bronx County,501,284,36,74,174,218,218,0,74,144,283,66,36,0,30,1415,421,994
360050195003,36, New York,005, Bronx County,485,256,80,92,84,273,163,0,79,84,212,93,80,13,0,1105,471,634
360050195004,36, New York,005, Bronx County,40,40,16,10,14,0,0,0,0,0,40,40,16,10,14,267,137,130
360050197001,36, New York,005, Bronx County,406,280,125,134,21,224,224,69,134,21,182,56,56,0,0,1140,763,377
360050197002,36, New York,005, Bronx County,91,34,16,0,18,57,0,0,0,0,34,34,16,0,18,415,307,108
360050197003,36, New York,005, Bronx County,611,316,130,0,186,241,96,0,0,96,370,220,130,0,90,1056,443,613
360050197004,36, New York,005, Bronx County,345,169,138,0,31,151,139,127,0,12,194,30,11,0,19,892,461,431
360050197005,36, New York,005, Bronx County,200,116,116,0,0,0,0,0,0,0,200,116,116,0,0,477,167,310
360050199001,36, New York,005, Bronx County,92,92,53,0,39,0,0,0,0,0,92,92,53,0,39,346,82,264
360050199002,36, New York,005, Bronx County,393,146,0,0,146,116,65,0,0,65,277,81,0,0,81,859,241,618
360050199003,36, New York,005, Bronx County,209,137,0,0,137,113,113,0,0,113,96,24,0,0,24,378,161,217
360050199004,36, New York,005, Bronx County,423,322,30,0,292,127,127,0,0,127,296,195,30,0,165,1143,389,754
360050199005,36, New York,005, Bronx County,588,468,311,95,62,325,325,236,27,62,263,143,75,68,0,777,236,541
360050199006,36, New York,005, Bronx County,220,107,107,0,0,0,0,0,0,0,220,107,107,0,0,936,0,936
360050200001,36, New York,005, Bronx County,242,164,104,0,60,29,29,8,0,21,213,135,96,0,39,707,91,616
360050200002,36, New York,005, Bronx County,447,336,185,36,115,150,140,25,0,115,297,196,160,36,0,1033,389,644
360050200003,36, New York,005, Bronx County,0,0,0,0,0,0,0,0,0,0,0,0,0,0,0,29,0,29
360050200004,36, New York,005, Bronx County,382,227,163,0,64,44,34,0,0,34,338,193,163,0,30,830,71,759
360050201001,36, New York,005, Bronx County,360,125,30,11,84,77,48,0,0,48,283,77,30,11,36,1199,467,732
360050201002,36, New York,005, Bronx County,307,112,0,80,32,25,17,0,0,17,282,95,0,80,15,692,190,502
360050201003,36, New York,005, Bronx County,308,206,0,56,150,136,136,0,56,80,172,70,0,0,70,528,271,257
360050202001,36, New York,005, Bronx County,280,87,49,0,38,47,47,27,0,20,233,40,22,0,18,824,85,739
360050202002,36, New York,005, Bronx County,310,134,92,17,25,87,0,0,0,0,223,134,92,17,25,680,261,419
360050204001,36, New York,005, Bronx County,271,180,58,51,71,69,38,0,0,38,202,142,58,51,33,583,99,484
360050204002,36, New York,005, Bronx County,118,72,23,0,49,4,4,0,0,4,114,68,23,0,45,429,29,400
360050204003,36, New York,005, Bronx County,332,224,90,0,134,39,35,0,0,35,293,189,90,0,99,698,148,550
360050205011,36, New York,005, Bronx County,0,0,0,0,0,0,0,0,0,0,0,0,0,0,0,0,0,0
360050205012,36, New York,005, Bronx County,317,223,88,0,135,185,155,34,0,121,132,68,54,0,14,706,232,474
360050205013,36, New York,005, Bronx County,619,294,128,0,166,330,166,0,0,166,289,128,128,0,0,1175,672,503
360050205014,36, New York,005, Bronx County,163,120,0,0,120,87,87,0,0,87,76,33,0,0,33,409,222,187
360050205015,36, New York,005, Bronx County,603,345,0,0,345,410,287,0,0,287,193,58,0,0,58,1451,921,530
360050205021,36, New York,005, Bronx County,189,89,54,0,35,69,34,9,0,25,120,55,45,0,10,582,272,310
360050205022,36, New York,005, Bronx County,121,76,27,0,49,59,59,10,0,49,62,17,17,0,0,217,105,112
360050205023,36, New York,005, Bronx County,368,131,63,28,40,45,20,0,0,20,323,111,63,28,20,842,82,760
360050206011,36, New York,005, Bronx County,204,84,63,0,21,40,40,40,0,0,164,44,23,0,21,897,232,665
360050206012,36, New York,005, Bronx County,307,236,176,0,60,111,104,53,0,51,196,132,123,0,9,804,212,592
360050209001,36, New York,005, Bronx County,103,49,49,0,0,0,0,0,0,0,103,49,49,0,0,591,233,358
360050209002,36, New York,005, Bronx County,273,182,48,0,134,89,75,9,0,66,184,107,39,0,68,682,241,441
360050209003,36, New York,005, Bronx County,396,220,54,28,138,110,62,0,0,62,286,158,54,28,76,748,164,584
360050209004,36, New York,005, Bronx County,444,323,251,1,71,0,0,0,0,0,444,323,251,1,71,971,91,880
360050210011,36, New York,005, Bronx County,241,87,0,0,87,117,87,0,0,87,124,0,0,0,0,456,153,303
360050210012,36, New York,005, Bronx County,257,142,55,0,87,93,48,0,0,48,164,94,55,0,39,732,134,598
360050210013,36, New York,005, Bronx County,319,134,134,0,0,0,0,0,0,0,319,134,134,0,0,974,155,819
360050210014,36, New York,005, Bronx County,155,121,0,33,88,0,0,0,0,0,155,121,0,33,88,433,168,265
360050210015,36, New York,005, Bronx County,104,43,0,0,43,43,43,0,0,43,61,0,0,0,0,359,98,261
360050210016,36, New York,005, Bronx County,317,170,54,0,116,181,116,0,0,116,136,54,54,0,0,806,269,537
360050210017,36, New York,005, Bronx County,494,161,57,32,72,79,63,0,32,31,415,98,57,0,41,1751,390,1361
360050210021,36, New York,005, Bronx County,564,445,191,0,254,175,175,90,0,85,389,270,101,0,169,1467,209,1258
360050210022,36, New York,005, Bronx County,123,103,66,0,37,37,37,0,0,37,86,66,66,0,0,372,103,269
360050210023,36, New York,005, Bronx County,116,0,0,0,0,0,0,0,0,0,116,0,0,0,0,333,0,333
360050210024,36, New York,005, Bronx County,438,370,100,195,75,75,75,0,0,75,363,295,100,195,0,699,84,615
360050210025,36, New York,005, Bronx County,148,14,12,0,2,0,0,0,0,0,148,14,12,0,2,309,11,298
360050210026,36, New York,005, Bronx County,163,90,5,0,85,6,0,0,0,0,157,90,5,0,85,569,98,471
360050210027,36, New York,005, Bronx County,185,91,23,17,51,51,51,0,0,51,134,40,23,17,0,460,159,301
360050210028,36, New York,005, Bronx County,298,39,21,0,18,12,0,0,0,0,286,39,21,0,18,768,23,745
360050211001,36, New York,005, Bronx County,217,66,54,12,0,27,27,27,0,0,190,39,27,12,0,682,124,558
360050211002,36, New York,005, Bronx County,501,202,31,0,171,149,141,0,0,141,352,61,31,0,30,1825,412,1413
360050211003,36, New York,005, Bronx County,220,144,18,26,100,75,75,0,26,49,145,69,18,0,51,741,315,426
360050211004,36, New York,005, Bronx County,254,191,104,0,87,11,0,0,0,0,243,191,104,0,87,381,75,306
360050212001,36, New York,005, Bronx County,267,117,81,0,36,82,36,0,0,36,185,81,81,0,0,514,78,436
360050212002,36, New York,005, Bronx County,425,167,167,0,0,0,0,0,0,0,425,167,167,0,0,846,0,846
360050212003,36, New York,005, Bronx County,139,30,30,0,0,29,3,3,0,0,110,27,27,0,0,727,168,559
360050212004,36, New York,005, Bronx County,317,141,18,65,58,79,79,18,61,0,238,62,0,4,58,731,48,683
360050212005,36, New York,005, Bronx County,72,30,0,12,18,0,0,0,0,0,72,30,0,12,18,294,0,294
360050213011,36, New York,005, Bronx County,119,49,16,0,33,23,0,0,0,0,96,49,16,0,33,256,53,203
360050213012,36, New York,005, Bronx County,207,130,58,0,72,52,46,22,0,24,155,84,36,0,48,595,113,482
360050213021,36, New York,005, Bronx County,419,163,129,0,34,283,108,108,0,0,136,55,21,0,34,2105,919,1186
360050213022,36, New York,005, Bronx County,328,185,79,0,106,57,44,0,0,44,271,141,79,0,62,1066,574,492
360050213023,36, New York,005, Bronx County,140,115,53,0,62,62,62,0,0,62,78,53,53,0,0,200,142,58
360050213024,36, New York,005, Bronx County,407,259,139,0,120,186,186,93,0,93,221,73,46,0,27,648,206,442
360050215011,36, New York,005, Bronx County,308,181,10,0,171,116,95,0,0,95,192,86,10,0,76,825,282,543
360050215012,36, New York,005, Bronx County,193,77,39,0,38,64,35,12,0,23,129,42,27,0,15,436,136,300
360050215013,36, New York,005, Bronx County,433,228,81,34,113,131,101,6,10,85,302,127,75,24,28,1205,271,934
360050215021,36, New York,005, Bronx County,472,382,34,0,348,263,263,34,0,229,209,119,0,0,119,764,219,545
360050215022,36, New York,005, Bronx County,334,146,57,18,71,51,0,0,0,0,283,146,57,18,71,634,151,483
360050215023,36, New York,005, Bronx County,336,281,76,0,205,157,157,60,0,97,179,124,16,0,108,782,317,465
360050215024,36, New York,005, Bronx County,158,98,61,37,0,39,0,0,0,0,119,98,61,37,0,448,153,295
360050215025,36, New York,005, Bronx County,271,271,0,33,238,115,115,0,0,115,156,156,0,33,123,869,420,449
360050216011,36, New York,005, Bronx County,417,288,94,55,139,116,91,5,0,86,301,197,89,55,53,800,261,539
360050216012,36, New York,005, Bronx County,371,193,64,116,13,18,18,18,0,0,353,175,46,116,13,997,119,878
360050216013,36, New York,005, Bronx County,154,93,46,36,11,40,40,29,0,11,114,53,17,36,0,276,55,221
360050216014,36, New York,005, Bronx County,180,146,117,11,18,18,18,0,0,18,162,128,117,11,0,225,32,193
360050216021,36, New York,005, Bronx County,0,0,0,0,0,0,0,0,0,0,0,0,0,0,0,39,0,39
360050216022,36, New York,005, Bronx County,239,126,58,0,68,15,1,1,0,0,224,125,57,0,68,564,102,462
360050216023,36, New York,005, Bronx County,232,162,147,15,0,118,61,46,15,0,114,101,101,0,0,415,163,252
360050216024,36, New York,005, Bronx County,685,344,289,0,55,70,41,41,0,0,615,303,248,0,55,1501,82,1419
360050216025,36, New York,005, Bronx County,331,114,102,12,0,37,37,25,12,0,294,77,77,0,0,1123,136,987
360050216026,36, New York,005, Bronx County,168,69,4,51,14,24,0,0,0,0,144,69,4,51,14,293,30,263
360050217001,36, New York,005, Bronx County,552,230,128,30,72,115,35,35,0,0,437,195,93,30,72,1495,578,917
360050217002,36, New York,005, Bronx County,348,175,63,4,108,87,61,18,0,43,261,114,45,4,65,880,300,580
360050217003,36, New York,005, Bronx County,45,0,0,0,0,0,0,0,0,0,45,0,0,0,0,449,187,262
360050217004,36, New York,005, Bronx County,161,161,63,0,98,68,68,40,0,28,93,93,23,0,70,568,238,330
360050218001,36, New York,005, Bronx County,229,79,0,0,79,84,40,0,0,40,145,39,0,0,39,660,269,391
360050218002,36, New York,005, Bronx County,483,249,22,27,200,214,152,0,27,125,269,97,22,0,75,1087,436,651
360050218003,36, New York,005, Bronx County,461,173,71,0,102,45,45,0,0,45,416,128,71,0,57,1361,97,1264
360050218004,36, New York,005, Bronx County,154,54,12,0,42,42,42,0,0,42,112,12,12,0,0,299,87,212
360050218005,36, New York,005, Bronx County,129,0,0,0,0,19,0,0,0,0,110,0,0,0,0,497,81,416
360050219001,36, New York,005, Bronx County,208,104,46,0,58,41,26,0,0,26,167,78,46,0,32,606,147,459
360050220001,36, New York,005, Bronx County,418,333,197,16,120,188,157,101,0,56,230,176,96,16,64,930,405,525
360050221011,36, New York,005, Bronx County,216,175,117,58,0,40,40,40,0,0,176,135,77,58,0,515,72,443
360050221012,36, New York,005, Bronx County,259,154,72,0,82,109,100,47,0,53,150,54,25,0,29,587,202,385
360050221013,36, New York,005, Bronx County,543,366,130,0,236,164,150,0,0,150,379,216,130,0,86,979,248,731
360050221021,36, New York,005, Bronx County,485,262,124,61,77,104,13,0,13,0,381,249,124,48,77,901,290,611
360050221022,36, New York,005, Bronx County,354,273,175,0,98,53,53,53,0,0,301,220,122,0,98,543,138,405
360050221023,36, New York,005, Bronx County,528,296,16,51,229,231,148,0,0,148,297,148,16,51,81,1215,264,951
360050222001,36, New York,005, Bronx County,208,171,83,32,56,86,86,46,18,22,122,85,37,14,34,492,111,381
360050222002,36, New York,005, Bronx County,180,135,103,7,25,61,61,61,0,0,119,74,42,7,25,365,93,272
360050222003,36, New York,005, Bronx County,158,35,5,7,23,5,5,5,0,0,153,30,0,7,23,531,60,471
360050222004,36, New York,005, Bronx County,133,85,60,25,0,18,7,7,0,0,115,78,53,25,0,201,66,135
360050223001,36, New York,005, Bronx County,310,138,69,0,69,12,12,0,0,12,298,126,69,0,57,535,39,496
360050223002,36, New York,005, Bronx County,258,128,25,0,103,119,22,0,0,22,139,106,25,0,81,634,202,432
360050223003,36, New York,005, Bronx County,169,53,14,24,15,15,15,0,0,15,154,38,14,24,0,744,76,668
360050223004,36, New York,005, Bronx County,797,621,0,53,568,402,333,0,0,333,395,288,0,53,235,1150,424,726
360050224011,36, New York,005, Bronx County,308,123,79,0,44,0,0,0,0,0,308,123,79,0,44,876,1,875
360050224012,36, New York,005, Bronx County,336,147,49,11,87,45,43,0,0,43,291,104,49,11,44,975,115,860
360050224031,36, New York,005, Bronx County,171,65,18,0,47,23,23,0,0,23,148,42,18,0,24,444,23,421
360050224032,36, New York,005, Bronx County,522,321,233,19,69,42,42,11,19,12,480,279,222,0,57,1402,192,1210
360050224041,36, New York,005, Bronx County,203,146,71,22,53,0,0,0,0,0,203,146,71,22,53,523,62,461
360050224042,36, New York,005, Bronx County,334,196,128,43,25,0,0,0,0,0,334,196,128,43,25,839,90,749
360050224043,36, New York,005, Bronx County,775,301,102,37,162,94,61,0,0,61,681,240,102,37,101,1542,136,1406
360050225001,36, New York,005, Bronx County,474,263,163,0,100,0,0,0,0,0,474,263,163,0,100,885,51,834
360050225002,36, New York,005, Bronx County,268,197,90,0,107,91,91,38,0,53,177,106,52,0,54,873,329,544
360050225003,36, New York,005, Bronx County,145,145,48,0,97,52,52,0,0,52,93,93,48,0,45,433,290,143
360050225004,36, New York,005, Bronx County,120,120,30,67,23,23,23,0,0,23,97,97,30,67,0,352,163,189
360050225005,36, New York,005, Bronx County,247,79,35,0,44,19,0,0,0,0,228,79,35,0,44,492,137,355
360050225006,36, New York,005, Bronx County,599,404,90,132,182,135,121,0,0,121,464,283,90,132,61,1295,115,1180
360050227011,36, New York,005, Bronx County,419,275,108,0,167,98,84,43,0,41,321,191,65,0,126,769,185,584
360050227012,36, New York,005, Bronx County,351,272,108,14,150,163,119,23,0,96,188,153,85,14,54,784,254,530
360050227013,36, New York,005, Bronx County,538,263,55,18,190,160,73,0,0,73,378,190,55,18,117,1034,243,791
360050227021,36, New York,005, Bronx County,390,129,0,29,100,162,74,0,29,45,228,55,0,0,55,830,382,448
360050227031,36, New York,005, Bronx County,418,323,81,62,180,135,127,16,0,111,283,196,65,62,69,945,175,770
360050228001,36, New York,005, Bronx County,271,75,0,40,35,22,0,0,0,0,249,75,0,40,35,1018,125,893
360050228002,36, New York,005, Bronx County,529,212,120,37,55,42,0,0,0,0,487,212,120,37,55,1266,216,1050
360050228003,36, New York,005, Bronx County,363,207,58,31,118,35,35,35,0,0,328,172,23,31,118,870,65,805
360050228004,36, New York,005, Bronx County,262,85,38,0,47,10,0,0,0,0,252,85,38,0,47,767,71,696
360050229011,36, New York,005, Bronx County,273,68,39,16,13,0,0,0,0,0,273,68,39,16,13,520,29,491
360050229012,36, New York,005, Bronx County,140,90,0,27,63,53,53,0,9,44,87,37,0,18,19,473,121,352
360050229013,36, New York,005, Bronx County,252,153,45,43,65,38,23,0,0,23,214,130,45,43,42,745,187,558
360050229014,36, New York,005, Bronx County,167,25,18,0,7,50,25,18,0,7,117,0,0,0,0,478,136,342
360050229015,36, New York,005, Bronx County,439,212,26,0,186,158,158,26,0,132,281,54,0,0,54,724,256,468
360050229021,36, New York,005, Bronx County,201,104,41,0,63,86,31,0,0,31,115,73,41,0,32,649,224,425
360050229022,36, New York,005, Bronx County,197,117,70,0,47,47,47,0,0,47,150,70,70,0,0,744,48,696
360050229023,36, New York,005, Bronx County,353,299,120,19,160,120,120,46,0,74,233,179,74,19,86,455,151,304
360050230001,36, New York,005, Bronx County,409,196,110,40,46,108,74,25,40,9,301,122,85,0,37,802,115,687
360050230002,36, New York,005, Bronx County,303,176,55,19,102,85,69,9,0,60,218,107,46,19,42,776,172,604
360050231001,36, New York,005, Bronx County,331,164,47,32,85,46,46,18,5,23,285,118,29,27,62,832,222,610
360050232001,36, New York,005, Bronx County,208,106,38,0,68,60,22,3,0,19,148,84,35,0,49,634,140,494
360050232002,36, New York,005, Bronx County,289,180,90,8,82,85,79,28,0,51,204,101,62,8,31,642,142,500
360050233011,36, New York,005, Bronx County,230,50,36,0,14,14,14,0,0,14,216,36,36,0,0,449,87,362
360050233012,36, New York,005, Bronx County,393,248,170,36,42,64,64,64,0,0,329,184,106,36,42,1001,119,882
360050233013,36, New York,005, Bronx County,191,145,0,0,145,134,134,0,0,134,57,11,0,0,11,239,166,73
360050233014,36, New York,005, Bronx County,136,41,0,0,41,59,22,0,0,22,77,19,0,0,19,618,257,361
360050233021,36, New York,005, Bronx County,339,199,122,7,70,68,0,0,0,0,271,199,122,7,70,1017,313,704
360050233022,36, New York,005, Bronx County,412,258,28,53,177,141,141,0,0,141,271,117,28,53,36,628,139,489
360050235011,36, New York,005, Bronx County,398,179,0,0,179,63,63,0,0,63,335,116,0,0,116,657,65,592
360050235012,36, New York,005, Bronx County,289,129,49,0,80,130,72,0,0,72,159,57,49,0,8,929,475,454
360050235013,36, New York,005, Bronx County,134,25,0,0,25,20,0,0,0,0,114,25,0,0,25,178,39,139
360050235021,36, New York,005, Bronx County,393,283,51,5,227,112,112,0,0,112,281,171,51,5,115,905,182,723
360050235022,36, New York,005, Bronx County,234,195,171,24,0,0,0,0,0,0,234,195,171,24,0,678,64,614
360050235023,36, New York,005, Bronx County,109,37,8,8,21,43,29,0,8,21,66,8,8,0,0,338,149,189
360050235024,36, New York,005, Bronx County,307,107,26,0,81,79,79,0,0,79,228,28,26,0,2,426,39,387
360050236001,36, New York,005, Bronx County,215,134,48,59,27,27,12,0,12,0,188,122,48,47,27,451,67,384
360050236002,36, New York,005, Bronx County,154,89,32,0,57,10,10,0,0,10,144,79,32,0,47,306,51,255
360050237021,36, New York,005, Bronx County,269,124,66,0,58,94,76,30,0,46,175,48,36,0,12,593,156,437
360050237031,36, New York,005, Bronx County,942,524,113,25,386,587,304,28,17,259,355,220,85,8,127,1360,892,468
360050237032,36, New York,005, Bronx County,305,169,131,7,31,65,7,0,7,0,240,162,131,0,31,743,395,348
360050237033,36, New York,005, Bronx County,104,89,24,0,65,43,43,0,0,43,61,46,24,0,22,247,77,170
360050237041,36, New York,005, Bronx County,319,242,0,35,207,240,225,0,35,190,79,17,0,0,17,443,163,280
360050237042,36, New York,005, Bronx County,371,213,67,36,110,141,98,0,0,98,230,115,67,36,12,802,344,458
360050237043,36, New York,005, Bronx County,341,167,14,14,139,85,85,0,0,85,256,82,14,14,54,656,68,588
360050238001,36, New York,005, Bronx County,24,19,7,0,12,0,0,0,0,0,24,19,7,0,12,37,0,37
360050238002,36, New York,005, Bronx County,216,107,33,0,74,44,33,5,0,28,172,74,28,0,46,680,109,571
360050238003,36, New York,005, Bronx County,288,133,57,38,38,27,27,0,6,21,261,106,57,32,17,778,51,727
360050239001,36, New York,005, Bronx County,319,283,58,86,139,145,145,0,86,59,174,138,58,0,80,605,159,446
360050239002,36, New York,005, Bronx County,245,75,0,0,75,58,30,0,0,30,187,45,0,0,45,405,99,306
360050239003,36, New York,005, Bronx County,354,319,67,68,184,88,88,0,0,88,266,231,67,68,96,381,89,292
360050239004,36, New York,005, Bronx County,310,281,72,0,209,0,0,0,0,0,310,281,72,0,209,751,118,633
360050239005,36, New York,005, Bronx County,377,311,180,0,131,107,107,64,0,43,270,204,116,0,88,443,45,398
360050239006,36, New York,005, Bronx County,170,137,61,0,76,109,76,0,0,76,61,61,61,0,0,297,260,37
360050239007,36, New York,005, Bronx County,317,213,62,0,151,31,31,0,0,31,286,182,62,0,120,442,66,376
360050240001,36, New York,005, Bronx County,539,328,154,23,151,32,32,32,0,0,507,296,122,23,151,1215,224,991
360050240002,36, New York,005, Bronx County,236,64,53,0,11,0,0,0,0,0,236,64,53,0,11,864,18,846
360050240003,36, New York,005, Bronx County,229,113,82,31,0,67,0,0,0,0,162,113,82,31,0,791,261,530
360050241001,36, New York,005, Bronx County,218,86,0,0,86,54,54,0,0,54,164,32,0,0,32,718,236,482
360050241002,36, New York,005, Bronx County,132,33,0,33,0,17,0,0,0,0,115,33,0,33,0,1028,301,727
360050241003,36, New York,005, Bronx County,280,147,37,46,64,30,0,0,0,0,250,147,37,46,64,477,163,314
360050241004,36, New York,005, Bronx County,330,221,146,75,0,0,0,0,0,0,330,221,146,75,0,316,0,316
360050241005,36, New York,005, Bronx County,410,315,34,31,250,46,45,0,0,45,364,270,34,31,205,1000,397,603
360050243001,36, New York,005, Bronx County,261,118,94,0,24,37,0,0,0,0,224,118,94,0,24,642,199,443
360050243002,36, New York,005, Bronx County,256,186,27,0,159,104,64,0,0,64,152,122,27,0,95,721,332,389
360050243003,36, New York,005, Bronx County,237,114,0,18,96,29,0,0,0,0,208,114,0,18,96,820,313,507
360050243004,36, New York,005, Bronx County,320,308,112,123,73,85,85,71,0,14,235,223,41,123,59,693,277,416
360050244001,36, New York,005, Bronx County,210,73,35,11,27,24,18,0,0,18,186,55,35,11,9,577,116,461
360050244002,36, New York,005, Bronx County,391,214,48,0,166,25,25,0,0,25,366,189,48,0,141,968,79,889
360050245011,36, New York,005, Bronx County,369,147,26,0,121,118,48,0,0,48,251,99,26,0,73,879,300,579
360050245012,36, New York,005, Bronx County,306,258,91,94,73,83,83,14,20,49,223,175,77,74,24,612,258,354
360050245013,36, New York,005, Bronx County,328,246,168,0,78,21,21,0,0,21,307,225,168,0,57,865,21,844
360050245014,36, New York,005, Bronx County,98,63,38,0,25,25,25,0,0,25,73,38,38,0,0,244,74,170
360050245021,36, New York,005, Bronx County,373,213,37,0,176,42,42,0,0,42,331,171,37,0,134,1209,295,914
360050245022,36, New York,005, Bronx County,45,27,0,0,27,18,0,0,0,0,27,27,0,0,27,132,80,52
360050245023,36, New York,005, Bronx County,423,212,0,0,212,99,99,0,0,99,324,113,0,0,113,1009,234,775
360050246001,36, New York,005, Bronx County,239,72,50,0,22,24,24,7,0,17,215,48,43,0,5,623,85,538
360050246002,36, New York,005, Bronx County,360,99,20,16,63,29,13,0,13,0,331,86,20,3,63,755,33,722
360050247001,36, New York,005, Bronx County,179,121,53,34,34,26,16,10,0,6,153,105,43,34,28,461,60,401
360050247002,36, New York,005, Bronx County,252,90,49,0,41,20,13,0,0,13,232,77,49,0,28,716,205,511
360050248001,36, New York,005, Bronx County,234,98,78,0,20,33,20,0,0,20,201,78,78,0,0,685,67,618
360050248002,36, New York,005, Bronx County,263,155,45,82,28,0,0,0,0,0,263,155,45,82,28,663,37,626
360050248003,36, New York,005, Bronx County,171,53,26,0,27,27,27,0,0,27,144,26,26,0,0,665,141,524
360050249001,36, New York,005, Bronx County,0,0,0,0,0,0,0,0,0,0,0,0,0,0,0,0,0,0
360050250001,36, New York,005, Bronx County,402,118,81,7,30,20,12,0,7,5,382,106,81,0,25,967,66,901
360050250002,36, New York,005, Bronx County,276,188,147,41,0,0,0,0,0,0,276,188,147,41,0,629,22,607
360050251001,36, New York,005, Bronx County,248,174,88,62,24,88,88,88,0,0,160,86,0,62,24,262,0,262
360050251002,36, New York,005, Bronx County,342,67,67,0,0,66,66,66,0,0,276,1,1,0,0,651,206,445
360050251003,36, New York,005, Bronx County,167,89,89,0,0,28,28,28,0,0,139,61,61,0,0,192,28,164
360050251004,36, New York,005, Bronx County,251,230,156,0,74,74,74,0,0,74,177,156,156,0,0,303,82,221
360050251005,36, New York,005, Bronx County,464,168,25,63,80,161,88,25,63,0,303,80,0,0,80,911,333,578
360050251006,36, New York,005, Bronx County,0,0,0,0,0,0,0,0,0,0,0,0,0,0,0,0,0,0
360050251007,36, New York,005, Bronx County,366,98,39,39,20,48,20,0,0,20,318,78,39,39,0,832,100,732
360050252001,36, New York,005, Bronx County,297,141,89,0,52,19,19,0,0,19,278,122,89,0,33,767,121,646
360050252002,36, New York,005, Bronx County,329,149,79,45,25,14,7,0,0,7,315,142,79,45,18,851,85,766
360050253001,36, New York,005, Bronx County,351,126,45,20,61,60,27,12,0,15,291,99,33,20,46,841,252,589
360050253002,36, New York,005, Bronx County,360,235,27,9,199,88,88,0,0,88,272,147,27,9,111,602,211,391
360050253003,36, New York,005, Bronx County,358,256,172,0,84,56,17,0,0,17,302,239,172,0,67,700,39,661
360050253004,36, New York,005, Bronx County,208,84,27,28,29,29,29,0,0,29,179,55,27,28,0,575,113,462
360050254001,36, New York,005, Bronx County,224,96,54,0,42,18,10,0,0,10,206,86,54,0,32,707,86,621
360050254002,36, New York,005, Bronx County,245,114,86,0,28,33,33,10,0,23,212,81,76,0,5,766,104,662
360050255001,36, New York,005, Bronx County,562,361,94,34,233,164,49,0,34,15,398,312,94,0,218,1290,448,842
360050255002,36, New York,005, Bronx County,987,359,165,0,194,214,100,47,0,53,773,259,118,0,141,1747,483,1264
360050255003,36, New York,005, Bronx County,156,78,14,31,33,58,31,0,31,0,98,47,14,0,33,448,192,256
360050256001,36, New York,005, Bronx County,172,69,21,0,48,9,9,0,0,9,163,60,21,0,39,393,19,374
360050256002,36, New York,005, Bronx County,158,54,47,0,7,2,2,0,0,2,156,52,47,0,5,602,10,592
360050257001,36, New York,005, Bronx County,399,192,106,16,70,53,27,27,0,0,346,165,79,16,70,1166,166,1000
360050261001,36, New York,005, Bronx County,457,155,44,0,111,0,0,0,0,0,457,155,44,0,111,1542,263,1279
360050263001,36, New York,005, Bronx County,360,265,99,74,92,64,64,0,0,64,296,201,99,74,28,719,94,625
360050263002,36, New York,005, Bronx County,318,289,238,26,25,54,25,0,0,25,264,264,238,26,0,415,83,332
360050263003,36, New York,005, Bronx County,527,350,127,0,223,168,130,0,0,130,359,220,127,0,93,1257,284,973
360050263004,36, New York,005, Bronx County,263,131,19,33,79,79,79,0,0,79,184,52,19,33,0,450,98,352
360050263005,36, New York,005, Bronx County,144,0,0,0,0,72,0,0,0,0,72,0,0,0,0,438,239,199
360050264001,36, New York,005, Bronx County,410,316,145,0,171,55,55,16,0,39,355,261,129,0,132,893,202,691
360050264002,36, New York,005, Bronx County,237,205,48,40,117,0,0,0,0,0,237,205,48,40,117,686,51,635
360050264003,36, New York,005, Bronx County,430,110,110,0,0,0,0,0,0,0,430,110,110,0,0,1280,0,1280
360050264004,36, New York,005, Bronx County,531,327,159,0,168,110,0,0,0,0,421,327,159,0,168,1311,382,929
360050265001,36, New York,005, Bronx County,352,57,22,0,35,86,3,0,0,3,266,54,22,0,32,910,240,670
360050265002,36, New York,005, Bronx County,359,265,94,91,80,72,72,21,0,51,287,193,73,91,29,944,284,660
360050265003,36, New York,005, Bronx County,486,312,277,0,35,38,0,0,0,0,448,312,277,0,35,1127,181,946
360050265004,36, New York,005, Bronx County,205,205,96,0,109,78,78,9,0,69,127,127,87,0,40,631,180,451
360050266011,36, New York,005, Bronx County,454,248,117,15,116,61,61,47,0,14,393,187,70,15,102,1243,178,1065
360050266012,36, New York,005, Bronx County,183,38,22,0,16,91,27,22,0,5,92,11,0,0,11,452,240,212
360050266013,36, New York,005, Bronx County,152,29,7,0,22,0,0,0,0,0,152,29,7,0,22,423,0,423
360050266021,36, New York,005, Bronx County,442,284,268,16,0,16,16,0,16,0,426,268,268,0,0,1233,134,1099
360050266022,36, New York,005, Bronx County,336,208,48,105,55,118,118,0,105,13,218,90,48,0,42,891,163,728
360050266023,36, New York,005, Bronx County,238,39,11,0,28,62,11,11,0,0,176,28,0,0,28,566,101,465
360050266024,36, New York,005, Bronx County,147,45,34,0,11,46,0,0,0,0,101,45,34,0,11,462,180,282
360050266025,36, New York,005, Bronx County,233,151,134,0,17,43,17,0,0,17,190,134,134,0,0,663,97,566
360050267011,36, New York,005, Bronx County,318,216,160,0,56,34,34,8,0,26,284,182,152,0,30,688,195,493
360050267012,36, New York,005, Bronx County,259,185,10,15,160,89,88,0,0,88,170,97,10,15,72,471,168,303
360050267013,36, New York,005, Bronx County,238,190,75,22,93,38,38,0,0,38,200,152,75,22,55,397,48,349
360050267021,36, New York,005, Bronx County,532,277,231,0,46,60,21,0,0,21,472,256,231,0,25,2020,210,1810
360050267022,36, New York,005, Bronx County,220,128,98,0,30,119,56,36,0,20,101,72,62,0,10,377,190,187
360050267023,36, New York,005, Bronx County,262,162,0,31,131,15,15,0,0,15,247,147,0,31,116,502,117,385
360050267024,36, New York,005, Bronx County,65,13,13,0,0,0,0,0,0,0,65,13,13,0,0,414,46,368
360050267025,36, New York,005, Bronx County,143,90,23,0,67,19,19,0,0,19,124,71,23,0,48,298,48,250
360050267026,36, New York,005, Bronx County,396,382,152,99,131,118,118,72,0,46,278,264,80,99,85,785,191,594
360050269001,36, New York,005, Bronx County,173,79,0,0,79,44,44,0,0,44,129,35,0,0,35,879,470,409
360050269002,36, New York,005, Bronx County,483,200,37,65,98,136,28,0,28,0,347,172,37,37,98,1353,318,1035
360050269003,36, New York,005, Bronx County,209,175,85,27,63,43,43,0,0,43,166,132,85,27,20,487,152,335
360050273001,36, New York,005, Bronx County,207,158,98,0,60,77,77,77,0,0,130,81,21,0,60,564,57,507
360050273002,36, New York,005, Bronx County,340,161,20,110,31,0,0,0,0,0,340,161,20,110,31,1127,201,926
360050273003,36, New York,005, Bronx County,566,416,124,37,255,108,108,0,0,108,458,308,124,37,147,1211,538,673
360050273004,36, New York,005, Bronx County,295,91,0,40,51,29,0,0,0,0,266,91,0,40,51,1250,254,996
360050274011,36, New York,005, Bronx County,217,116,49,0,67,35,35,35,0,0,182,81,14,0,67,363,74,289
360050274012,36, New York,005, Bronx County,150,51,51,0,0,0,0,0,0,0,150,51,51,0,0,443,0,443
360050274013,36, New York,005, Bronx County,597,263,218,0,45,0,0,0,0,0,597,263,218,0,45,1542,0,1542
360050274014,36, New York,005, Bronx County,340,173,99,11,63,4,4,4,0,0,336,169,95,11,63,1116,33,1083
360050274020,36, New York,005, Bronx County,0,0,0,0,0,0,0,0,0,0,0,0,0,0,0,0,0,0
360050274021,36, New York,005, Bronx County,350,172,150,0,22,18,18,0,0,18,332,154,150,0,4,1179,126,1053
360050274022,36, New York,005, Bronx County,130,88,28,0,60,7,0,0,0,0,123,88,28,0,60,217,13,204
360050274023,36, New York,005, Bronx County,248,101,80,0,21,0,0,0,0,0,248,101,80,0,21,860,70,790
360050276000,36, New York,005, Bronx County,0,0,0,0,0,0,0,0,0,0,0,0,0,0,0,0,0,0
360050276001,36, New York,005, Bronx County,17,6,0,0,6,8,0,0,0,0,9,6,0,0,6,36,15,21
360050277001,36, New York,005, Bronx County,236,128,0,0,128,81,40,0,0,40,155,88,0,0,88,477,165,312
360050277002,36, New York,005, Bronx County,202,76,14,0,62,20,20,0,0,20,182,56,14,0,42,552,95,457
360050277003,36, New York,005, Bronx County,148,91,17,35,39,35,35,0,35,0,113,56,17,0,39,441,90,351
360050277004,36, New York,005, Bronx County,623,229,20,17,192,183,125,0,17,108,440,104,20,0,84,1448,539,909
360050279001,36, New York,005, Bronx County,195,182,134,0,48,0,0,0,0,0,195,182,134,0,48,415,19,396
360050279002,36, New York,005, Bronx County,142,47,0,0,47,0,0,0,0,0,142,47,0,0,47,532,0,532
360050279003,36, New York,005, Bronx County,466,314,131,0,183,137,96,96,0,0,329,218,35,0,183,1429,406,1023
360050279004,36, New York,005, Bronx County,257,161,83,0,78,25,25,0,0,25,232,136,83,0,53,771,61,710
360050279005,36, New York,005, Bronx County,302,150,61,0,89,0,0,0,0,0,302,150,61,0,89,701,43,658
360050279006,36, New York,005, Bronx County,318,232,63,49,120,21,21,0,21,0,297,211,63,28,120,944,81,863
360050281001,36, New York,005, Bronx County,217,58,58,0,0,17,0,0,0,0,200,58,58,0,0,746,68,678
360050281002,36, New York,005, Bronx County,338,110,37,73,0,0,0,0,0,0,338,110,37,73,0,1002,85,917
360050281003,36, New York,005, Bronx County,219,87,13,14,60,0,0,0,0,0,219,87,13,14,60,892,14,878
360050283001,36, New York,005, Bronx County,374,343,17,21,305,326,326,0,21,305,48,17,17,0,0,761,601,160
360050283002,36, New York,005, Bronx County,481,218,57,33,128,80,80,0,0,80,401,138,57,33,48,1135,234,901
360050284001,36, New York,005, Bronx County,0,0,0,0,0,0,0,0,0,0,0,0,0,0,0,179,119,60
360050285001,36, New York,005, Bronx County,388,201,97,23,81,39,29,17,0,12,349,172,80,23,69,786,33,753
360050285002,36, New York,005, Bronx County,121,38,38,0,0,18,0,0,0,0,103,38,38,0,0,402,84,318
360050285003,36, New York,005, Bronx County,93,0,0,0,0,14,0,0,0,0,79,0,0,0,0,227,59,168
360050285004,36, New York,005, Bronx County,427,70,70,0,0,0,0,0,0,0,427,70,70,0,0,1233,66,1167
360050286001,36, New York,005, Bronx County,133,31,29,0,2,0,0,0,0,0,133,31,29,0,2,385,8,377
360050286002,36, New York,005, Bronx County,120,27,21,0,6,9,9,3,0,6,111,18,18,0,0,314,17,297
360050287001,36, New York,005, Bronx County,441,190,92,26,72,12,12,0,0,12,429,178,92,26,60,1070,36,1034
360050287002,36, New York,005, Bronx County,93,57,45,0,12,0,0,0,0,0,93,57,45,0,12,456,83,373
360050287003,36, New York,005, Bronx County,317,115,68,0,47,29,29,29,0,0,288,86,39,0,47,722,29,693
360050288001,36, New York,005, Bronx County,286,130,117,0,13,90,0,0,0,0,196,130,117,0,13,637,134,503
360050288002,36, New York,005, Bronx County,251,52,35,17,0,0,0,0,0,0,251,52,35,17,0,784,17,767
360050288003,36, New York,005, Bronx County,69,18,18,0,0,7,0,0,0,0,62,18,18,0,0,109,18,91
360050288004,36, New York,005, Bronx County,111,20,20,0,0,0,0,0,0,0,111,20,20,0,0,318,38,280
360050289001,36, New York,005, Bronx County,157,89,34,0,55,98,83,34,0,49,59,6,0,0,6,415,175,240
360050289002,36, New York,005, Bronx County,519,348,38,69,241,162,162,9,0,153,357,186,29,69,88,883,256,627
360050289003,36, New York,005, Bronx County,300,158,88,0,70,0,0,0,0,0,300,158,88,0,70,986,86,900
360050289004,36, New York,005, Bronx County,95,55,55,0,0,26,26,26,0,0,69,29,29,0,0,327,10,317
360050293010,36, New York,005, Bronx County,0,0,0,0,0,0,0,0,0,0,0,0,0,0,0,0,0,0
360050293011,36, New York,005, Bronx County,245,51,51,0,0,5,0,0,0,0,240,51,51,0,0,736,17,719
360050293012,36, New York,005, Bronx County,246,84,48,23,13,0,0,0,0,0,246,84,48,23,13,704,5,699
360050293021,36, New York,005, Bronx County,150,38,0,38,0,0,0,0,0,0,150,38,0,38,0,517,0,517
360050293022,36, New York,005, Bronx County,289,133,133,0,0,0,0,0,0,0,289,133,133,0,0,1103,20,1083
360050293023,36, New York,005, Bronx County,521,407,321,19,67,151,151,127,0,24,370,256,194,19,43,1193,244,949
360050293024,36, New York,005, Bronx County,249,129,107,0,22,0,0,0,0,0,249,129,107,0,22,958,19,939
360050295001,36, New York,005, Bronx County,428,156,134,0,22,0,0,0,0,0,428,156,134,0,22,1338,58,1280
360050295002,36, New York,005, Bronx County,239,95,87,8,0,0,0,0,0,0,239,95,87,8,0,811,117,694
360050295003,36, New York,005, Bronx County,259,127,127,0,0,83,62,62,0,0,176,65,65,0,0,1025,395,630
360050295004,36, New York,005, Bronx County,100,44,44,0,0,0,0,0,0,0,100,44,44,0,0,327,6,321
360050296001,36, New York,005, Bronx County,359,156,141,0,15,5,0,0,0,0,354,156,141,0,15,799,114,685
360050296002,36, New York,005, Bronx County,95,14,6,0,8,12,0,0,0,0,83,14,6,0,8,340,75,265
360050297001,36, New York,005, Bronx County,378,139,65,0,74,0,0,0,0,0,378,139,65,0,74,1024,26,998
360050297002,36, New York,005, Bronx County,304,138,94,12,32,0,0,0,0,0,304,138,94,12,32,1206,54,1152
360050297003,36, New York,005, Bronx County,234,98,85,0,13,0,0,0,0,0,234,98,85,0,13,583,37,546
360050300001,36, New York,005, Bronx County,345,188,98,20,70,0,0,0,0,0,345,188,98,20,70,823,0,823
360050300002,36, New York,005, Bronx County,495,174,33,0,141,128,70,0,0,70,367,104,33,0,71,1235,291,944
360050300003,36, New York,005, Bronx County,236,93,93,0,0,29,0,0,0,0,207,93,93,0,0,628,60,568
360050300004,36, New York,005, Bronx County,231,81,25,0,56,0,0,0,0,0,231,81,25,0,56,947,154,793
360050300005,36, New York,005, Bronx County,190,33,33,0,0,0,0,0,0,0,190,33,33,0,0,543,4,539
360050300006,36, New York,005, Bronx County,122,90,90,0,0,36,36,36,0,0,86,54,54,0,0,472,164,308
360050301001,36, New York,005, Bronx County,225,93,89,0,4,4,4,0,0,4,221,89,89,0,0,714,12,702
360050301002,36, New York,005, Bronx County,51,11,11,0,0,0,0,0,0,0,51,11,11,0,0,224,54,170
360050302011,36, New York,005, Bronx County,580,301,111,178,12,0,0,0,0,0,580,301,111,178,12,1335,149,1186
360050302012,36, New York,005, Bronx County,73,2,0,0,2,0,0,0,0,0,73,2,0,0,2,376,47,329
360050302013,36, New York,005, Bronx County,360,160,114,0,46,54,54,8,0,46,306,106,106,0,0,918,113,805
360050302021,36, New York,005, Bronx County,484,68,0,20,48,0,0,0,0,0,484,68,0,20,48,1547,117,1430
360050302022,36, New York,005, Bronx County,0,0,0,0,0,0,0,0,0,0,0,0,0,0,0,0,0,0
360050302023,36, New York,005, Bronx County,777,403,325,0,78,75,16,16,0,0,702,387,309,0,78,2138,255,1883
360050302024,36, New York,005, Bronx County,166,39,0,0,39,0,0,0,0,0,166,39,0,0,39,436,66,370
360050307011,36, New York,005, Bronx County,159,62,40,0,22,0,0,0,0,0,159,62,40,0,22,405,18,387
360050307012,36, New York,005, Bronx County,571,169,169,0,0,0,0,0,0,0,571,169,169,0,0,1883,7,1876
360050307013,36, New York,005, Bronx County,275,117,64,0,53,6,6,0,0,6,269,111,64,0,47,608,73,535
360050307014,36, New York,005, Bronx County,359,172,141,0,31,0,0,0,0,0,359,172,141,0,31,837,0,837
360050309000,36, New York,005, Bronx County,0,0,0,0,0,0,0,0,0,0,0,0,0,0,0,0,0,0
360050309001,36, New York,005, Bronx County,0,0,0,0,0,0,0,0,0,0,0,0,0,0,0,160,3,157
360050309002,36, New York,005, Bronx County,169,39,27,12,0,0,0,0,0,0,169,39,27,12,0,407,14,393
360050309003,36, New York,005, Bronx County,281,67,55,12,0,0,0,0,0,0,281,67,55,12,0,875,10,865
360050309004,36, New York,005, Bronx County,216,104,91,0,13,18,18,18,0,0,198,86,73,0,13,649,33,616
360050310001,36, New York,005, Bronx County,256,53,53,0,0,6,0,0,0,0,250,53,53,0,0,1032,37,995
360050310002,36, New York,005, Bronx County,242,11,11,0,0,0,0,0,0,0,242,11,11,0,0,515,25,490
360050310003,36, New York,005, Bronx County,407,230,173,0,57,22,16,0,0,16,385,214,173,0,41,1417,93,1324
360050312001,36, New York,005, Bronx County,215,115,86,0,29,10,10,0,0,10,205,105,86,0,19,626,25,601
360050312002,36, New York,005, Bronx County,170,84,51,0,33,0,0,0,0,0,170,84,51,0,33,507,10,497
360050314001,36, New York,005, Bronx County,232,92,86,0,6,8,8,8,0,0,224,84,78,0,6,738,23,715
360050314002,36, New York,005, Bronx County,196,88,72,0,16,4,0,0,0,0,192,88,72,0,16,732,21,711
360050316001,36, New York,005, Bronx County,303,141,41,35,65,45,45,0,0,45,258,96,41,35,20,734,90,644
360050316002,36, New York,005, Bronx County,274,58,46,0,12,24,0,0,0,0,250,58,46,0,12,597,11,586
360050318001,36, New York,005, Bronx County,150,50,35,0,15,0,0,0,0,0,150,50,35,0,15,567,7,560
360050318002,36, New York,005, Bronx County,324,61,54,7,0,21,21,21,0,0,303,40,33,7,0,881,58,823
360050319000,36, New York,005, Bronx County,0,0,0,0,0,0,0,0,0,0,0,0,0,0,0,0,0,0
360050319001,36, New York,005, Bronx County,0,0,0,0,0,0,0,0,0,0,0,0,0,0,0,84,84,0
360050323001,36, New York,005, Bronx County,174,34,34,0,0,0,0,0,0,0,174,34,34,0,0,847,39,808
360050323002,36, New York,005, Bronx County,318,101,101,0,0,0,0,0,0,0,318,101,101,0,0,1134,77,1057
360050323003,36, New York,005, Bronx County,89,0,0,0,0,0,0,0,0,0,89,0,0,0,0,446,57,389
360050323004,36, New York,005, Bronx County,414,116,70,0,46,0,0,0,0,0,414,116,70,0,46,1377,87,1290
360050323005,36, New York,005, Bronx County,5,5,5,0,0,0,0,0,0,0,5,5,5,0,0,14,0,14
360050324001,36, New York,005, Bronx County,500,336,0,44,292,119,117,0,44,73,381,219,0,0,219,1141,115,1026
360050324002,36, New York,005, Bronx County,405,243,161,82,0,158,158,138,20,0,247,85,23,62,0,954,360,594
360050326001,36, New York,005, Bronx County,217,47,47,0,0,26,0,0,0,0,191,47,47,0,0,702,102,600
360050326002,36, New York,005, Bronx County,428,121,94,0,27,27,27,27,0,0,401,94,67,0,27,1121,115,1006
360050326003,36, New York,005, Bronx County,145,77,68,0,9,13,0,0,0,0,132,77,68,0,9,457,38,419
360050328001,36, New York,005, Bronx County,299,161,16,20,125,0,0,0,0,0,299,161,16,20,125,746,110,636
360050328002,36, New York,005, Bronx County,260,101,20,0,81,62,62,14,0,48,198,39,6,0,33,594,159,435
360050328003,36, New York,005, Bronx County,142,117,68,0,49,52,52,26,0,26,90,65,42,0,23,343,91,252
360050328004,36, New York,005, Bronx County,261,110,68,0,42,42,42,0,0,42,219,68,68,0,0,639,35,604
360050330001,36, New York,005, Bronx County,316,238,103,0,135,162,131,39,0,92,154,107,64,0,43,911,288,623
360050330002,36, New York,005, Bronx County,236,72,56,0,16,0,0,0,0,0,236,72,56,0,16,601,15,586
360050330003,36, New York,005, Bronx County,384,169,151,0,18,76,53,35,0,18,308,116,116,0,0,875,182,693
360050330004,36, New York,005, Bronx County,227,142,71,0,71,0,0,0,0,0,227,142,71,0,71,681,51,630
360050332011,36, New York,005, Bronx County,322,146,89,27,30,19,14,14,0,0,303,132,75,27,30,1009,355,654
360050332012,36, New York,005, Bronx County,466,363,255,0,108,89,89,0,0,89,377,274,255,0,19,1226,210,1016
360050332013,36, New York,005, Bronx County,213,92,51,0,41,9,9,0,0,9,204,83,51,0,32,911,132,779
360050332021,36, New York,005, Bronx County,269,83,71,0,12,4,0,0,0,0,265,83,71,0,12,941,161,780
360050332022,36, New York,005, Bronx County,250,113,24,38,51,47,29,0,10,19,203,84,24,28,32,663,128,535
360050332023,36, New York,005, Bronx County,127,127,16,0,111,0,0,0,0,0,127,127,16,0,111,316,26,290
360050332024,36, New York,005, Bronx County,103,67,36,0,31,0,0,0,0,0,103,67,36,0,31,343,90,253
360050334001,36, New York,005, Bronx County,6,6,0,0,6,0,0,0,0,0,6,6,0,0,6,31,2,29
360050335001,36, New York,005, Bronx County,46,27,27,0,0,5,5,5,0,0,41,22,22,0,0,100,10,90
360050335002,36, New York,005, Bronx County,87,32,32,0,0,17,2,2,0,0,70,30,30,0,0,255,49,206
360050335003,36, New York,005, Bronx County,309,175,52,23,100,39,15,0,15,0,270,160,52,8,100,818,129,689
360050336011,36, New York,005, Bronx County,354,118,0,84,34,34,34,0,0,34,320,84,0,84,0,876,301,575
360050336012,36, New York,005, Bronx County,274,152,37,0,115,128,99,0,0,99,146,53,37,0,16,749,397,352
360050336013,36, New York,005, Bronx County,81,71,37,0,34,10,0,0,0,0,71,71,37,0,34,468,203,265
360050336014,36, New York,005, Bronx County,454,308,115,39,154,170,154,0,0,154,284,154,115,39,0,1178,511,667
360050336021,36, New York,005, Bronx County,316,74,22,14,38,19,19,0,14,5,297,55,22,0,33,1013,102,911
360050337001,36, New York,005, Bronx County,168,27,21,0,6,17,0,0,0,0,151,27,21,0,6,526,48,478
360050337002,36, New York,005, Bronx County,281,123,114,9,0,6,0,0,0,0,275,123,114,9,0,779,48,731
360050337003,36, New York,005, Bronx County,238,105,82,17,6,0,0,0,0,0,238,105,82,17,6,626,0,626
360050338011,36, New York,005, Bronx County,389,81,31,0,50,13,13,13,0,0,376,68,18,0,50,772,153,619
360050338012,36, New York,005, Bronx County,301,211,70,60,81,63,42,0,0,42,238,169,70,60,39,608,106,502
360050338021,36, New York,005, Bronx County,432,267,113,0,154,80,69,0,0,69,352,198,113,0,85,1048,181,867
360050340001,36, New York,005, Bronx County,450,221,59,143,19,52,52,0,33,19,398,169,59,110,0,781,113,668
360050340002,36, New York,005, Bronx County,521,259,109,38,112,34,14,0,0,14,487,245,109,38,98,1025,123,902
360050340003,36, New York,005, Bronx County,221,86,61,0,25,56,38,27,0,11,165,48,34,0,14,637,170,467
360050340004,36, New York,005, Bronx County,176,131,61,0,70,26,26,0,0,26,150,105,61,0,44,381,10,371
360050342001,36, New York,005, Bronx County,312,204,138,35,31,57,35,0,18,17,255,169,138,17,14,544,110,434
360050342002,36, New York,005, Bronx County,155,82,64,0,18,8,0,0,0,0,147,82,64,0,18,527,29,498
360050343001,36, New York,005, Bronx County,260,109,95,14,0,0,0,0,0,0,260,109,95,14,0,508,0,508
360050343002,36, New York,005, Bronx County,203,109,83,11,15,14,0,0,0,0,189,109,83,11,15,561,19,542
360050344001,36, New York,005, Bronx County,225,114,34,18,62,42,29,0,18,11,183,85,34,0,51,496,58,438
360050344002,36, New York,005, Bronx County,327,146,110,14,22,102,102,84,0,18,225,44,26,14,4,664,51,613
360050345001,36, New York,005, Bronx County,181,61,29,5,27,21,10,0,0,10,160,51,29,5,17,614,43,571
360050345002,36, New York,005, Bronx County,478,269,140,86,43,13,0,0,0,0,465,269,140,86,43,1277,314,963
360050345003,36, New York,005, Bronx County,263,135,135,0,0,15,0,0,0,0,248,135,135,0,0,700,26,674
360050348001,36, New York,005, Bronx County,217,117,0,0,117,0,0,0,0,0,217,117,0,0,117,551,0,551
360050348002,36, New York,005, Bronx County,816,509,27,83,399,253,181,0,0,181,563,328,27,83,218,1969,734,1235
360050348003,36, New York,005, Bronx County,263,76,32,44,0,4,0,0,0,0,259,76,32,44,0,772,45,727
360050348004,36, New York,005, Bronx County,206,112,103,0,9,9,0,0,0,0,197,112,103,0,9,631,87,544
360050350001,36, New York,005, Bronx County,174,93,78,0,15,0,0,0,0,0,174,93,78,0,15,493,39,454
360050350002,36, New York,005, Bronx County,310,205,42,83,80,15,15,4,0,11,295,190,38,83,69,751,9,742
360050351001,36, New York,005, Bronx County,86,35,29,0,6,0,0,0,0,0,86,35,29,0,6,260,5,255
360050351002,36, New York,005, Bronx County,411,115,71,0,44,41,25,0,0,25,370,90,71,0,19,1079,96,983
360050351003,36, New York,005, Bronx County,285,191,97,61,33,22,22,0,22,0,263,169,97,39,33,871,72,799
360050356001,36, New York,005, Bronx County,199,68,47,0,21,8,8,8,0,0,191,60,39,0,21,712,74,638
360050356002,36, New York,005, Bronx County,267,161,77,10,74,0,0,0,0,0,267,161,77,10,74,737,37,700
360050358001,36, New York,005, Bronx County,263,207,148,0,59,37,37,21,0,16,226,170,127,0,43,1124,159,965
360050358002,36, New York,005, Bronx County,230,97,0,26,71,30,0,0,0,0,200,97,0,26,71,662,123,539
360050358003,36, New York,005, Bronx County,219,65,13,29,23,29,29,0,29,0,190,36,13,0,23,527,33,494
360050358004,36, New York,005, Bronx County,189,74,74,0,0,0,0,0,0,0,189,74,74,0,0,555,57,498
360050358005,36, New York,005, Bronx County,253,73,53,0,20,0,0,0,0,0,253,73,53,0,20,574,32,542
360050358006,36, New York,005, Bronx County,663,280,219,0,61,0,0,0,0,0,663,280,219,0,61,1524,0,1524
360050358007,36, New York,005, Bronx County,201,67,0,36,31,118,67,0,36,31,83,0,0,0,0,342,249,93
360050359001,36, New York,005, Bronx County,709,505,36,12,457,362,310,17,12,281,347,195,19,0,176,1455,598,857
360050360001,36, New York,005, Bronx County,215,103,88,0,15,29,15,0,0,15,186,88,88,0,0,523,50,473
360050360002,36, New York,005, Bronx County,306,75,29,0,46,14,9,0,0,9,292,66,29,0,37,1062,50,1012
360050360003,36, New York,005, Bronx County,193,49,28,0,21,0,0,0,0,0,193,49,28,0,21,463,5,458
360050361001,36, New York,005, Bronx County,249,161,27,0,134,122,122,0,0,122,127,39,27,0,12,664,323,341
360050361002,36, New York,005, Bronx County,278,168,0,0,168,119,119,0,0,119,159,49,0,0,49,864,405,459
360050361003,36, New York,005, Bronx County,386,274,13,47,214,261,261,0,47,214,125,13,13,0,0,905,350,555
360050361004,36, New York,005, Bronx County,180,180,37,0,143,104,104,0,0,104,76,76,37,0,39,372,205,167
360050361005,36, New York,005, Bronx County,298,177,29,0,148,147,147,16,0,131,151,30,13,0,17,824,249,575
360050363001,36, New York,005, Bronx County,232,0,0,0,0,59,0,0,0,0,173,0,0,0,0,634,162,472
360050363002,36, New York,005, Bronx County,254,103,0,55,48,103,103,0,55,48,151,0,0,0,0,556,128,428
360050363003,36, New York,005, Bronx County,226,159,83,0,76,85,85,54,0,31,141,74,29,0,45,683,323,360
360050363004,36, New York,005, Bronx County,162,162,19,0,143,136,136,19,0,117,26,26,0,0,26,563,331,232
360050363005,36, New York,005, Bronx County,297,161,24,0,137,100,34,0,0,34,197,127,24,0,103,677,253,424
360050363006,36, New York,005, Bronx County,235,194,127,17,50,67,67,0,17,50,168,127,127,0,0,781,258,523
360050364001,36, New York,005, Bronx County,247,139,51,0,88,5,0,0,0,0,242,139,51,0,88,682,15,667
360050364002,36, New York,005, Bronx County,167,76,24,17,35,16,0,0,0,0,151,76,24,17,35,581,63,518
360050364003,36, New York,005, Bronx County,214,90,59,0,31,23,13,0,0,13,191,77,59,0,18,571,39,532
360050365011,36, New York,005, Bronx County,332,149,52,95,2,85,46,13,31,2,247,103,39,64,0,885,300,585
360050365012,36, New York,005, Bronx County,399,227,87,17,123,99,86,21,0,65,300,141,66,17,58,1171,383,788
360050365013,36, New York,005, Bronx County,270,158,33,34,91,47,47,0,0,47,223,111,33,34,44,527,123,404
360050365021,36, New York,005, Bronx County,320,247,32,0,215,118,95,5,0,90,202,152,27,0,125,681,238,443
360050365022,36, New York,005, Bronx County,219,138,47,6,85,79,51,0,0,51,140,87,47,6,34,704,396,308
360050367001,36, New York,005, Bronx County,205,113,71,9,33,28,28,0,0,28,177,85,71,9,5,567,87,480
360050367002,36, New York,005, Bronx County,271,147,33,25,89,99,90,11,9,70,172,57,22,16,19,846,378,468
360050368001,36, New York,005, Bronx County,324,98,66,6,26,123,14,2,0,12,201,84,64,6,14,942,254,688
360050368002,36, New York,005, Bronx County,213,131,75,12,44,38,38,0,0,38,175,93,75,12,6,375,126,249
360050369011,36, New York,005, Bronx County,220,186,65,10,111,174,149,34,10,105,46,37,31,0,6,561,315,246
360050369012,36, New York,005, Bronx County,217,101,36,0,65,14,14,0,0,14,203,87,36,0,51,717,129,588
360050369021,36, New York,005, Bronx County,217,138,11,0,127,165,127,0,0,127,52,11,11,0,0,419,280,139
360050369022,36, New York,005, Bronx County,379,239,71,12,156,144,140,0,0,140,235,99,71,12,16,959,388,571
360050370001,36, New York,005, Bronx County,196,140,86,29,25,4,0,0,0,0,192,140,86,29,25,634,52,582
360050370002,36, New York,005, Bronx County,150,85,39,14,32,15,15,0,6,9,135,70,39,8,23,433,36,397
360050370003,36, New York,005, Bronx County,159,82,44,14,24,41,41,41,0,0,118,41,3,14,24,366,142,224
360050371001,36, New York,005, Bronx County,114,64,20,0,44,17,17,0,0,17,97,47,20,0,27,428,156,272
360050371002,36, New York,005, Bronx County,301,123,0,61,62,25,0,0,0,0,276,123,0,61,62,877,312,565
360050371003,36, New York,005, Bronx County,189,132,18,0,114,59,59,0,0,59,130,73,18,0,55,719,361,358
360050371004,36, New York,005, Bronx County,207,176,176,0,0,0,0,0,0,0,207,176,176,0,0,535,115,420
360050372001,36, New York,005, Bronx County,223,137,46,35,56,20,20,0,0,20,203,117,46,35,36,531,95,436
360050372002,36, New York,005, Bronx County,334,155,108,13,34,38,3,3,0,0,296,152,105,13,34,886,126,760
360050373001,36, New York,005, Bronx County,429,229,14,116,99,31,31,0,0,31,398,198,14,116,68,960,88,872
360050373002,36, New York,005, Bronx County,172,138,70,27,41,41,41,0,0,41,131,97,70,27,0,520,132,388
360050373003,36, New York,005, Bronx County,215,105,51,0,54,123,51,51,0,0,92,54,0,0,54,628,359,269
360050373004,36, New York,005, Bronx County,730,585,148,0,437,256,185,0,0,185,474,400,148,0,252,1233,557,676
360050374001,36, New York,005, Bronx County,169,99,33,0,66,0,0,0,0,0,169,99,33,0,66,505,34,471
360050374002,36, New York,005, Bronx County,314,74,0,14,60,87,55,0,14,41,227,19,0,0,19,1047,347,700
360050374003,36, New York,005, Bronx County,127,78,18,0,60,60,60,0,0,60,67,18,18,0,0,202,66,136
360050374004,36, New York,005, Bronx County,323,205,25,0,180,93,93,0,0,93,230,112,25,0,87,580,122,458
360050375041,36, New York,005, Bronx County,357,291,21,0,270,157,157,0,0,157,200,134,21,0,113,556,182,374
360050375042,36, New York,005, Bronx County,268,119,16,0,103,140,106,3,0,103,128,13,13,0,0,625,311,314
360050375043,36, New York,005, Bronx County,396,207,126,15,66,29,16,0,0,16,367,191,126,15,50,1011,151,860
360050376001,36, New York,005, Bronx County,163,95,66,0,29,32,27,10,0,17,131,68,56,0,12,540,136,404
360050376002,36, New York,005, Bronx County,282,90,64,0,26,22,13,0,0,13,260,77,64,0,13,746,85,661
360050378001,36, New York,005, Bronx County,466,339,49,102,188,83,69,20,0,49,383,270,29,102,139,1014,188,826
360050378002,36, New York,005, Bronx County,187,19,10,0,9,0,0,0,0,0,187,19,10,0,9,628,0,628
360050378003,36, New York,005, Bronx County,114,67,67,0,0,19,19,19,0,0,95,48,48,0,0,228,40,188
360050379001,36, New York,005, Bronx County,444,295,136,0,159,78,78,0,0,78,366,217,136,0,81,755,132,623
360050379002,36, New York,005, Bronx County,147,76,0,0,76,17,17,0,0,17,130,59,0,0,59,946,486,460
360050379003,36, New York,005, Bronx County,310,154,103,10,41,141,53,30,0,23,169,101,73,10,18,514,211,303
360050379004,36, New York,005, Bronx County,174,101,90,0,11,47,47,47,0,0,127,54,43,0,11,388,136,252
360050379005,36, New York,005, Bronx County,308,182,0,0,182,168,168,0,0,168,140,14,0,0,14,606,228,378
360050380001,36, New York,005, Bronx County,267,77,30,0,47,0,0,0,0,0,267,77,30,0,47,865,48,817
360050380002,36, New York,005, Bronx County,181,116,40,0,76,109,109,33,0,76,72,7,7,0,0,556,241,315
360050380003,36, New York,005, Bronx County,247,202,21,128,53,203,168,0,128,40,44,34,21,0,13,700,370,330
360050380004,36, New York,005, Bronx County,306,143,16,14,113,82,82,0,0,82,224,61,16,14,31,862,233,629
360050381001,36, New York,005, Bronx County,167,89,31,44,14,31,31,31,0,0,136,58,0,44,14,401,106,295
360050381002,36, New York,005, Bronx County,487,236,0,0,236,225,158,0,0,158,262,78,0,0,78,459,324,135
360050381003,36, New York,005, Bronx County,191,191,100,0,91,63,63,0,0,63,128,128,100,0,28,249,57,192
360050381004,36, New York,005, Bronx County,253,119,119,0,0,35,35,35,0,0,218,84,84,0,0,641,83,558
360050381005,36, New York,005, Bronx County,104,66,0,0,66,12,12,0,0,12,92,54,0,0,54,538,108,430
360050381006,36, New York,005, Bronx County,545,324,39,130,155,71,71,0,71,0,474,253,39,59,155,846,215,631
360050382001,36, New York,005, Bronx County,264,144,86,14,44,12,6,0,0,6,252,138,86,14,38,992,65,927
360050382002,36, New York,005, Bronx County,275,129,77,9,43,55,42,0,9,33,220,87,77,0,10,918,219,699
360050383011,36, New York,005, Bronx County,269,152,84,0,68,18,1,1,0,0,251,151,83,0,68,596,160,436
360050383012,36, New York,005, Bronx County,478,225,57,20,148,78,39,0,0,39,400,186,57,20,109,957,295,662
360050383013,36, New York,005, Bronx County,524,273,40,36,197,162,162,29,11,122,362,111,11,25,75,1064,172,892
360050383031,36, New York,005, Bronx County,378,218,53,0,165,118,39,0,0,39,260,179,53,0,126,1070,325,745
360050383032,36, New York,005, Bronx County,299,214,0,7,207,96,78,0,0,78,203,136,0,7,129,1057,520,537
360050383041,36, New York,005, Bronx County,425,295,67,8,220,169,153,0,8,145,256,142,67,0,75,1240,612,628
360050385001,36, New York,005, Bronx County,175,137,10,34,93,102,95,0,34,61,73,42,10,0,32,439,290,149
360050385002,36, New York,005, Bronx County,55,23,23,0,0,23,23,23,0,0,32,0,0,0,0,308,60,248
360050385003,36, New York,005, Bronx County,476,369,42,107,220,250,220,42,46,132,226,149,0,61,88,710,381,329
360050385004,36, New York,005, Bronx County,355,309,60,0,249,221,183,48,0,135,134,126,12,0,114,1055,542,513
360050386001,36, New York,005, Bronx County,486,339,0,0,339,205,193,0,0,193,281,146,0,0,146,1213,449,764
360050386002,36, New York,005, Bronx County,132,82,0,0,82,0,0,0,0,0,132,82,0,0,82,345,0,345
360050386003,36, New York,005, Bronx County,304,173,0,23,150,109,109,0,23,86,195,64,0,0,64,634,163,471
360050386004,36, New York,005, Bronx County,330,0,0,0,0,42,0,0,0,0,288,0,0,0,0,776,142,634
360050386005,36, New York,005, Bronx County,211,128,110,0,18,18,18,0,0,18,193,110,110,0,0,608,54,554
360050386006,36, New York,005, Bronx County,97,97,87,0,10,10,10,0,0,10,87,87,87,0,0,238,10,228
360050386007,36, New York,005, Bronx County,308,166,67,0,99,14,14,14,0,0,294,152,53,0,99,633,68,565
360050386008,36, New York,005, Bronx County,147,104,0,104,0,0,0,0,0,0,147,104,0,104,0,462,368,94
360050387001,36, New York,005, Bronx County,246,118,62,0,56,40,40,14,0,26,206,78,48,0,30,483,72,411
360050387002,36, New York,005, Bronx County,353,206,55,38,113,107,107,0,21,86,246,99,55,17,27,458,168,290
360050387003,36, New York,005, Bronx County,289,182,132,0,50,59,52,17,0,35,230,130,115,0,15,549,212,337
360050388001,36, New York,005, Bronx County,333,239,89,23,127,66,66,0,0,66,267,173,89,23,61,752,55,697
360050388002,36, New York,005, Bronx County,432,241,113,0,128,76,61,49,0,12,356,180,64,0,116,934,138,796
360050389001,36, New York,005, Bronx County,258,170,66,41,63,69,69,0,6,63,189,101,66,35,0,423,156,267
360050389002,36, New York,005, Bronx County,211,57,28,0,29,44,42,13,0,29,167,15,15,0,0,711,294,417
360050389003,36, New York,005, Bronx County,127,63,8,0,55,55,55,0,0,55,72,8,8,0,0,495,352,143
360050389004,36, New York,005, Bronx County,262,97,61,0,36,38,10,10,0,0,224,87,51,0,36,597,120,477
360050389005,36, New York,005, Bronx County,176,126,54,30,42,64,37,0,0,37,112,89,54,30,5,715,272,443
360050390001,36, New York,005, Bronx County,388,206,20,0,186,71,0,0,0,0,317,206,20,0,186,1047,208,839
360050390002,36, New York,005, Bronx County,360,145,32,0,113,37,37,0,0,37,323,108,32,0,76,936,64,872
360050391001,36, New York,005, Bronx County,398,67,42,0,25,140,25,0,0,25,258,42,42,0,0,1168,380,788
360050391002,36, New York,005, Bronx County,274,144,72,0,72,18,0,0,0,0,256,144,72,0,72,1010,369,641
360050391003,36, New York,005, Bronx County,341,252,0,126,126,192,174,0,126,48,149,78,0,0,78,582,230,352
360050391004,36, New York,005, Bronx County,305,93,0,0,93,131,78,0,0,78,174,15,0,0,15,488,254,234
360050391005,36, New York,005, Bronx County,263,124,0,0,124,52,52,0,0,52,211,72,0,0,72,113,0,113
360050391006,36, New York,005, Bronx County,287,157,0,127,30,29,0,0,0,0,258,157,0,127,30,213,34,179
360050392001,36, New York,005, Bronx County,196,124,51,36,37,38,23,0,14,9,158,101,51,22,28,590,84,506
360050392002,36, New York,005, Bronx County,191,51,17,12,22,29,17,0,0,17,162,34,17,12,5,506,67,439
360050393001,36, New York,005, Bronx County,556,438,63,0,375,27,27,0,0,27,529,411,63,0,348,697,171,526
360050393002,36, New York,005, Bronx County,271,271,38,33,200,111,111,0,33,78,160,160,38,0,122,671,238,433
360050393003,36, New York,005, Bronx County,217,217,98,0,119,107,107,31,0,76,110,110,67,0,43,557,297,260
360050393004,36, New York,005, Bronx County,339,314,171,0,143,101,101,0,0,101,238,213,171,0,42,839,133,706
360050393005,36, New York,005, Bronx County,79,40,0,0,40,34,13,0,0,13,45,27,0,0,27,239,123,116
360050393006,36, New York,005, Bronx County,285,62,62,0,0,41,0,0,0,0,244,62,62,0,0,1131,323,808
360050394001,36, New York,005, Bronx County,129,73,42,0,31,36,23,0,0,23,93,50,42,0,8,298,95,203
360050394002,36, New York,005, Bronx County,535,385,117,83,185,195,195,0,49,146,340,190,117,34,39,709,126,583
360050394003,36, New York,005, Bronx County,261,153,105,0,48,23,0,0,0,0,238,153,105,0,48,774,113,661
360050394004,36, New York,005, Bronx County,131,52,26,0,26,3,0,0,0,0,128,52,26,0,26,561,121,440
360050395001,36, New York,005, Bronx County,429,373,66,37,270,232,232,0,0,232,197,141,66,37,38,683,327,356
360050395002,36, New York,005, Bronx County,212,112,41,20,51,43,43,15,0,28,169,69,26,20,23,436,90,346
360050395003,36, New York,005, Bronx County,202,152,0,0,152,101,88,0,0,88,101,64,0,0,64,513,289,224
360050395004,36, New York,005, Bronx County,175,61,9,0,52,52,37,0,0,37,123,24,9,0,15,773,253,520
360050396001,36, New York,005, Bronx County,160,66,9,15,42,37,37,0,15,22,123,29,9,0,20,506,148,358
360050396002,36, New York,005, Bronx County,321,197,24,0,173,89,36,0,0,36,232,161,24,0,137,585,163,422
360050396003,36, New York,005, Bronx County,257,111,0,11,100,8,8,0,0,8,249,103,0,11,92,1077,155,922
360050396004,36, New York,005, Bronx County,151,77,77,0,0,26,0,0,0,0,125,77,77,0,0,583,142,441
360050397001,36, New York,005, Bronx County,30,10,10,0,0,0,0,0,0,0,30,10,10,0,0,275,150,125
360050397002,36, New York,005, Bronx County,100,40,19,0,21,9,9,0,0,9,91,31,19,0,12,300,108,192
360050398001,36, New York,005, Bronx County,380,248,48,33,167,125,125,0,0,125,255,123,48,33,42,1227,329,898
360050398002,36, New York,005, Bronx County,217,76,76,0,0,41,0,0,0,0,176,76,76,0,0,612,204,408
360050398003,36, New York,005, Bronx County,238,137,137,0,0,37,37,37,0,0,201,100,100,0,0,554,52,502
360050399011,36, New York,005, Bronx County,241,134,55,24,55,42,12,12,0,0,199,122,43,24,55,387,66,321
360050399012,36, New York,005, Bronx County,70,47,29,18,0,0,0,0,0,0,70,47,29,18,0,277,50,227
360050399013,36, New York,005, Bronx County,363,314,84,40,190,48,34,0,0,34,315,280,84,40,156,492,179,313
360050399014,36, New York,005, Bronx County,357,167,33,25,109,87,87,0,25,62,270,80,33,0,47,916,235,681
360050399015,36, New York,005, Bronx County,120,66,0,0,66,64,18,0,0,18,56,48,0,0,48,335,161,174
360050399021,36, New York,005, Bronx County,352,225,126,12,87,17,7,0,0,7,335,218,126,12,80,399,97,302
360050399022,36, New York,005, Bronx County,206,172,65,0,107,79,53,18,0,35,127,119,47,0,72,247,150,97
360050399023,36, New York,005, Bronx County,349,203,42,0,161,56,56,0,0,56,293,147,42,0,105,583,182,401
360050399024,36, New York,005, Bronx County,206,102,67,26,9,25,0,0,0,0,181,102,67,26,9,386,37,349
360050399025,36, New York,005, Bronx County,195,172,84,9,79,43,36,0,0,36,152,136,84,9,43,441,42,399
360050401001,36, New York,005, Bronx County,229,154,66,27,61,63,27,0,27,0,166,127,66,0,61,596,235,361
360050401002,36, New York,005, Bronx County,233,34,0,34,0,48,34,0,34,0,185,0,0,0,0,179,27,152
360050401003,36, New York,005, Bronx County,79,55,46,0,9,23,9,0,0,9,56,46,46,0,0,318,52,266
360050401004,36, New York,005, Bronx County,332,243,122,31,90,146,146,56,0,90,186,97,66,31,0,688,162,526
360050401005,36, New York,005, Bronx County,157,98,24,11,63,93,46,0,0,46,64,52,24,11,17,649,529,120
360050403021,36, New York,005, Bronx County,612,322,50,11,261,134,77,17,0,60,478,245,33,11,201,1214,254,960
360050403022,36, New York,005, Bronx County,226,99,10,23,66,31,31,0,23,8,195,68,10,0,58,388,42,346
360050403023,36, New York,005, Bronx County,385,307,244,42,21,280,279,229,29,21,105,28,15,13,0,670,433,237
360050403031,36, New York,005, Bronx County,314,196,126,8,62,52,52,23,0,29,262,144,103,8,33,714,198,516
360050403032,36, New York,005, Bronx County,379,168,65,12,91,69,43,0,12,31,310,125,65,0,60,764,75,689
360050403033,36, New York,005, Bronx County,311,118,79,0,39,43,36,29,0,7,268,82,50,0,32,806,276,530
360050403041,36, New York,005, Bronx County,174,126,73,0,53,60,60,44,0,16,114,66,29,0,37,413,142,271
360050403042,36, New York,005, Bronx County,408,250,120,11,119,49,24,10,0,14,359,226,110,11,105,686,99,587
360050403043,36, New York,005, Bronx County,255,160,54,11,95,127,106,31,0,75,128,54,23,11,20,699,343,356
360050404001,36, New York,005, Bronx County,572,356,137,56,163,0,0,0,0,0,572,356,137,56,163,1189,0,1189
360050404002,36, New York,005, Bronx County,106,42,7,0,35,0,0,0,0,0,106,42,7,0,35,370,0,370
360050404003,36, New York,005, Bronx County,99,80,38,0,42,0,0,0,0,0,99,80,38,0,42,376,53,323
360050405011,36, New York,005, Bronx County,409,286,51,0,235,195,194,18,0,176,214,92,33,0,59,903,333,570
360050405012,36, New York,005, Bronx County,220,93,52,22,19,22,22,0,22,0,198,71,52,0,19,351,45,306
360050405013,36, New York,005, Bronx County,291,138,48,30,60,100,57,12,0,45,191,81,36,30,15,561,104,457
360050405021,36, New York,005, Bronx County,233,122,19,43,60,40,37,0,0,37,193,85,19,43,23,780,245,535
360050405022,36, New York,005, Bronx County,457,306,44,10,252,41,41,0,0,41,416,265,44,10,211,707,122,585
360050405023,36, New York,005, Bronx County,183,69,21,0,48,33,10,0,0,10,150,59,21,0,38,465,118,347
360050405024,36, New York,005, Bronx County,282,122,64,26,32,131,82,38,26,18,151,40,26,0,14,539,261,278
360050405025,36, New York,005, Bronx County,180,105,19,0,86,60,60,0,0,60,120,45,19,0,26,283,93,190
360050405026,36, New York,005, Bronx County,324,269,89,34,146,79,79,59,0,20,245,190,30,34,126,613,159,454
360050406001,36, New York,005, Bronx County,496,196,67,31,98,63,0,0,0,0,433,196,67,31,98,1276,251,1025
360050406002,36, New York,005, Bronx County,193,128,48,0,80,0,0,0,0,0,193,128,48,0,80,536,111,425
360050406003,36, New York,005, Bronx County,251,157,0,0,157,79,79,0,0,79,172,78,0,0,78,546,158,388
360050407011,36, New York,005, Bronx County,242,184,60,68,56,128,101,35,23,43,114,83,25,45,13,375,68,307
360050407012,36, New York,005, Bronx County,106,80,21,0,59,38,38,0,0,38,68,42,21,0,21,289,80,209
360050407013,36, New York,005, Bronx County,492,185,77,51,57,77,58,13,34,11,415,127,64,17,46,635,173,462
360050407021,36, New York,005, Bronx County,139,93,50,0,43,84,38,21,0,17,55,55,29,0,26,401,222,179
360050407022,36, New York,005, Bronx County,270,103,19,0,84,82,0,0,0,0,188,103,19,0,84,1380,417,963
360050407023,36, New York,005, Bronx County,591,451,230,0,221,0,0,0,0,0,591,451,230,0,221,1007,43,964
360050407024,36, New York,005, Bronx County,281,221,35,0,186,30,30,0,0,30,251,191,35,0,156,654,51,603
360050407025,36, New York,005, Bronx County,171,64,10,45,9,85,0,0,0,0,86,64,10,45,9,685,254,431
360050408001,36, New York,005, Bronx County,115,41,0,0,41,0,0,0,0,0,115,41,0,0,41,277,0,277
360050408002,36, New York,005, Bronx County,189,125,61,0,64,125,76,33,0,43,64,49,28,0,21,358,212,146
360050408003,36, New York,005, Bronx County,287,142,66,0,76,76,64,26,0,38,211,78,40,0,38,880,177,703
360050408004,36, New York,005, Bronx County,650,280,113,0,167,81,47,0,0,47,569,233,113,0,120,1285,205,1080
360050409001,36, New York,005, Bronx County,781,414,92,91,231,29,0,0,0,0,752,414,92,91,231,2115,153,1962
360050409002,36, New York,005, Bronx County,60,40,18,22,0,0,0,0,0,0,60,40,18,22,0,207,0,207
360050411001,36, New York,005, Bronx County,389,185,126,13,46,9,0,0,0,0,380,185,126,13,46,712,57,655
360050411002,36, New York,005, Bronx County,284,112,58,0,54,47,47,7,0,40,237,65,51,0,14,423,145,278
360050411003,36, New York,005, Bronx County,306,83,0,0,83,67,43,0,0,43,239,40,0,0,40,854,196,658
360050413001,36, New York,005, Bronx County,330,170,34,0,136,64,64,0,0,64,266,106,34,0,72,916,117,799
360050413002,36, New York,005, Bronx County,72,72,27,22,23,0,0,0,0,0,72,72,27,22,23,153,20,133
360050413003,36, New York,005, Bronx County,121,88,52,0,36,51,51,15,0,36,70,37,37,0,0,178,67,111
360050413004,36, New York,005, Bronx County,154,44,44,0,0,0,0,0,0,0,154,44,44,0,0,533,144,389
360050413005,36, New York,005, Bronx County,365,177,78,0,99,116,88,54,0,34,249,89,24,0,65,648,256,392
360050413006,36, New York,005, Bronx County,249,205,96,36,73,53,53,15,0,38,196,152,81,36,35,716,168,548
360050413007,36, New York,005, Bronx County,587,264,94,37,133,25,0,0,0,0,562,264,94,37,133,1190,110,1080
360050414001,36, New York,005, Bronx County,563,221,173,0,48,0,0,0,0,0,563,221,173,0,48,1361,54,1307
360050414002,36, New York,005, Bronx County,170,17,17,0,0,0,0,0,0,0,170,17,17,0,0,736,16,720
360050414003,36, New York,005, Bronx County,174,74,33,13,28,11,11,0,0,11,163,63,33,13,17,432,91,341
360050414004,36, New York,005, Bronx County,258,139,89,0,50,12,12,12,0,0,246,127,77,0,50,1015,124,891
360050415001,36, New York,005, Bronx County,402,222,143,0,79,103,79,0,0,79,299,143,143,0,0,834,158,676
360050415002,36, New York,005, Bronx County,137,76,49,0,27,14,0,0,0,0,123,76,49,0,27,268,86,182
360050415003,36, New York,005, Bronx County,107,66,0,0,66,0,0,0,0,0,107,66,0,0,66,203,26,177
360050415004,36, New York,005, Bronx County,279,38,38,0,0,38,38,38,0,0,241,0,0,0,0,374,108,266
360050415005,36, New York,005, Bronx County,280,156,0,0,156,162,117,0,0,117,118,39,0,0,39,533,313,220
360050415006,36, New York,005, Bronx County,300,134,49,60,25,35,7,0,0,7,265,127,49,60,18,610,109,501
360050418001,36, New York,005, Bronx County,100,36,12,0,24,0,0,0,0,0,100,36,12,0,24,482,166,316
360050418002,36, New York,005, Bronx County,410,373,210,15,148,12,12,0,0,12,398,361,210,15,136,843,54,789
360050418003,36, New York,005, Bronx County,365,245,99,0,146,73,73,40,0,33,292,172,59,0,113,722,126,596
360050418004,36, New York,005, Bronx County,129,37,27,0,10,0,0,0,0,0,129,37,27,0,10,287,30,257
360050419001,36, New York,005, Bronx County,219,67,29,0,38,0,0,0,0,0,219,67,29,0,38,586,108,478
360050419002,36, New York,005, Bronx County,107,107,33,21,53,0,0,0,0,0,107,107,33,21,53,373,31,342
360050419003,36, New York,005, Bronx County,185,117,0,0,117,101,101,0,0,101,84,16,0,0,16,679,482,197
360050419004,36, New York,005, Bronx County,134,123,57,4,62,102,91,29,0,62,32,32,28,4,0,538,181,357
360050419005,36, New York,005, Bronx County,191,128,56,0,72,128,113,41,0,72,63,15,15,0,0,406,160,246
360050419006,36, New York,005, Bronx County,207,130,130,0,0,16,16,16,0,0,191,114,114,0,0,446,110,336
360050419007,36, New York,005, Bronx County,309,51,51,0,0,0,0,0,0,0,309,51,51,0,0,767,48,719
360050420001,36, New York,005, Bronx County,159,101,0,28,73,73,73,0,0,73,86,28,0,28,0,395,164,231
360050420002,36, New York,005, Bronx County,425,318,102,26,190,221,143,37,0,106,204,175,65,26,84,1238,748,490
360050420003,36, New York,005, Bronx County,333,163,103,17,43,43,32,0,0,32,290,131,103,17,11,1039,205,834
360050421001,36, New York,005, Bronx County,254,151,151,0,0,0,0,0,0,0,254,151,151,0,0,871,53,818
360050421002,36, New York,005, Bronx County,199,61,24,23,14,0,0,0,0,0,199,61,24,23,14,459,16,443
360050421003,36, New York,005, Bronx County,111,91,24,0,67,75,67,0,0,67,36,24,24,0,0,208,137,71
360050421004,36, New York,005, Bronx County,310,175,53,0,122,55,35,0,0,35,255,140,53,0,87,1012,196,816
360050421005,36, New York,005, Bronx County,276,194,51,36,107,174,143,0,36,107,102,51,51,0,0,557,243,314
360050422001,36, New York,005, Bronx County,499,210,42,129,39,31,0,0,0,0,468,210,42,129,39,1073,87,986
360050422002,36, New York,005, Bronx County,266,64,56,0,8,21,0,0,0,0,245,64,56,0,8,695,51,644
360050423001,36, New York,005, Bronx County,340,197,108,28,61,99,99,20,28,51,241,98,88,0,10,662,120,542
360050423002,36, New York,005, Bronx County,357,222,94,0,128,0,0,0,0,0,357,222,94,0,128,671,29,642
360050423003,36, New York,005, Bronx County,389,216,99,71,46,100,75,35,40,0,289,141,64,31,46,631,120,511
360050424001,36, New York,005, Bronx County,265,205,58,23,124,0,0,0,0,0,265,205,58,23,124,651,5,646
360050424002,36, New York,005, Bronx County,308,192,87,0,105,18,18,0,0,18,290,174,87,0,87,777,84,693
360050425001,36, New York,005, Bronx County,151,108,0,17,91,29,29,0,0,29,122,79,0,17,62,423,96,327
360050425002,36, New York,005, Bronx County,433,138,0,54,84,47,11,0,0,11,386,127,0,54,73,811,183,628
360050425003,36, New York,005, Bronx County,162,34,0,0,34,38,0,0,0,0,124,34,0,0,34,455,19,436
360050425004,36, New York,005, Bronx County,175,59,59,0,0,10,10,10,0,0,165,49,49,0,0,564,71,493
360050425005,36, New York,005, Bronx County,182,137,120,0,17,96,68,51,0,17,86,69,69,0,0,296,76,220
360050425006,36, New York,005, Bronx County,47,32,0,0,32,0,0,0,0,0,47,32,0,0,32,126,35,91
360050425007,36, New York,005, Bronx County,182,138,95,0,43,17,17,17,0,0,165,121,78,0,43,459,78,381
360050426001,36, New York,005, Bronx County,389,247,134,0,113,0,0,0,0,0,389,247,134,0,113,1119,22,1097
360050426002,36, New York,005, Bronx County,145,90,43,0,47,0,0,0,0,0,145,90,43,0,47,652,79,573
360050426003,36, New York,005, Bronx County,251,143,143,0,0,0,0,0,0,0,251,143,143,0,0,611,6,605
360050426004,36, New York,005, Bronx County,164,0,0,0,0,0,0,0,0,0,164,0,0,0,0,843,206,637
360050426005,36, New York,005, Bronx County,223,100,14,0,86,0,0,0,0,0,223,100,14,0,86,477,16,461
360050426006,36, New York,005, Bronx County,154,19,0,0,19,19,19,0,0,19,135,0,0,0,0,676,95,581
360050428001,36, New York,005, Bronx County,299,184,163,0,21,19,9,0,0,9,280,175,163,0,12,699,9,690
360050428002,36, New York,005, Bronx County,277,138,53,0,85,49,30,0,0,30,228,108,53,0,55,755,137,618
360050429011,36, New York,005, Bronx County,269,225,69,0,156,58,57,6,0,51,211,168,63,0,105,743,210,533
360050429012,36, New York,005, Bronx County,130,99,60,0,39,25,25,10,0,15,105,74,50,0,24,269,45,224
360050429013,36, New York,005, Bronx County,272,184,136,16,32,61,48,32,16,0,211,136,104,0,32,523,85,438
360050429021,36, New York,005, Bronx County,535,335,201,44,90,80,68,31,0,37,455,267,170,44,53,1400,322,1078
360050429022,36, New York,005, Bronx County,146,99,18,0,81,14,14,0,0,14,132,85,18,0,67,451,47,404
360050429023,36, New York,005, Bronx County,197,83,71,0,12,25,17,12,0,5,172,66,59,0,7,427,58,369
360050430001,36, New York,005, Bronx County,359,178,91,56,31,32,32,23,0,9,327,146,68,56,22,1106,114,992
360050430002,36, New York,005, Bronx County,121,88,59,16,13,16,16,0,16,0,105,72,59,0,13,395,152,243
360050430003,36, New York,005, Bronx County,342,244,35,0,209,34,34,0,0,34,308,210,35,0,175,815,73,742
360050431011,36, New York,005, Bronx County,442,152,97,17,38,224,33,0,17,16,218,119,97,0,22,807,489,318
360050431012,36, New York,005, Bronx County,34,34,33,1,0,1,1,0,1,0,33,33,33,0,0,80,23,57
360050431013,36, New York,005, Bronx County,350,168,168,0,0,35,18,18,0,0,315,150,150,0,0,724,77,647
360050431014,36, New York,005, Bronx County,477,311,132,102,77,186,156,44,66,46,291,155,88,36,31,997,312,685
360050431021,36, New York,005, Bronx County,236,149,98,0,51,39,39,35,0,4,197,110,63,0,47,1001,171,830
360050431022,36, New York,005, Bronx County,234,178,122,0,56,78,78,78,0,0,156,100,44,0,56,419,52,367
360050431023,36, New York,005, Bronx County,463,245,142,25,78,182,96,18,0,78,281,149,124,25,0,880,150,730
360050434001,36, New York,005, Bronx County,241,119,70,24,25,0,0,0,0,0,241,119,70,24,25,655,0,655
360050434002,36, New York,005, Bronx County,385,187,76,32,79,92,76,76,0,0,293,111,0,32,79,522,31,491
360050434003,36, New York,005, Bronx County,128,0,0,0,0,12,0,0,0,0,116,0,0,0,0,374,83,291
360050434004,36, New York,005, Bronx County,308,102,0,53,49,104,49,0,0,49,204,53,0,53,0,840,330,510
360050435011,36, New York,005, Bronx County,271,202,20,0,182,121,97,0,0,97,150,105,20,0,85,552,206,346
360050435021,36, New York,005, Bronx County,0,0,0,0,0,0,0,0,0,0,0,0,0,0,0,0,0,0
360050435031,36, New York,005, Bronx County,0,0,0,0,0,0,0,0,0,0,0,0,0,0,0,16,3,13
360050436001,36, New York,005, Bronx County,232,119,76,0,43,24,24,24,0,0,208,95,52,0,43,486,38,448
360050436002,36, New York,005, Bronx County,257,97,26,18,53,61,48,0,18,30,196,49,26,0,23,685,131,554
360050442001,36, New York,005, Bronx County,209,150,0,0,150,68,68,0,0,68,141,82,0,0,82,782,312,470
360050442002,36, New York,005, Bronx County,116,63,23,0,40,0,0,0,0,0,116,63,23,0,40,264,22,242
360050442003,36, New York,005, Bronx County,197,47,27,0,20,47,47,27,0,20,150,0,0,0,0,420,75,345
360050442004,36, New York,005, Bronx County,329,234,234,0,0,193,193,193,0,0,136,41,41,0,0,818,510,308
360050442005,36, New York,005, Bronx County,127,45,28,0,17,17,17,0,0,17,110,28,28,0,0,490,55,435
360050444001,36, New York,005, Bronx County,292,183,72,0,111,0,0,0,0,0,292,183,72,0,111,859,0,859
360050444002,36, New York,005, Bronx County,189,116,72,0,44,0,0,0,0,0,189,116,72,0,44,430,19,411
360050444003,36, New York,005, Bronx County,276,60,60,0,0,25,25,25,0,0,251,35,35,0,0,1008,40,968
360050444004,36, New York,005, Bronx County,232,64,44,20,0,124,0,0,0,0,108,64,44,20,0,701,227,474
360050448001,36, New York,005, Bronx County,283,136,81,7,48,33,33,8,7,18,250,103,73,0,30,939,112,827
360050448002,36, New York,005, Bronx County,236,153,57,17,79,17,17,0,17,0,219,136,57,0,79,715,90,625
360050449011,36, New York,005, Bronx County,194,83,45,0,38,0,0,0,0,0,194,83,45,0,38,616,26,590
360050449012,36, New York,005, Bronx County,179,41,32,0,9,21,0,0,0,0,158,41,32,0,9,817,74,743
360050449021,36, New York,005, Bronx County,353,119,86,0,33,57,25,0,0,25,296,94,86,0,8,884,79,805
360050449022,36, New York,005, Bronx County,180,100,92,8,0,12,12,12,0,0,168,88,80,8,0,727,50,677
360050451011,36, New York,005, Bronx County,91,26,9,0,17,0,0,0,0,0,91,26,9,0,17,404,0,404
360050451012,36, New York,005, Bronx County,197,99,61,3,35,0,0,0,0,0,197,99,61,3,35,840,11,829
360050451021,36, New York,005, Bronx County,186,82,48,11,23,0,0,0,0,0,186,82,48,11,23,575,6,569
360050451022,36, New York,005, Bronx County,232,138,113,0,25,7,0,0,0,0,225,138,113,0,25,853,75,778
360050456001,36, New York,005, Bronx County,335,185,185,0,0,11,0,0,0,0,324,185,185,0,0,846,36,810
360050456002,36, New York,005, Bronx County,301,118,86,0,32,0,0,0,0,0,301,118,86,0,32,997,4,993
360050456003,36, New York,005, Bronx County,310,82,70,12,0,0,0,0,0,0,310,82,70,12,0,839,10,829
360050458001,36, New York,005, Bronx County,325,99,0,0,99,194,99,0,0,99,131,0,0,0,0,729,367,362
360050458002,36, New York,005, Bronx County,488,338,0,188,150,83,0,0,0,0,405,338,0,188,150,876,297,579
360050458003,36, New York,005, Bronx County,49,0,0,0,0,0,0,0,0,0,49,0,0,0,0,98,0,98
360050458004,36, New York,005, Bronx County,852,371,0,77,294,239,66,0,43,23,613,305,0,34,271,1696,549,1147
360050460001,36, New York,005, Bronx County,392,146,96,0,50,111,50,0,0,50,281,96,96,0,0,1230,283,947
360050460002,36, New York,005, Bronx County,221,116,64,0,52,31,31,0,0,31,190,85,64,0,21,468,31,437
360050462031,36, New York,005, Bronx County,1253,403,0,0,403,35,0,0,0,0,1218,403,0,0,403,3354,525,2829
360050462032,36, New York,005, Bronx County,89,89,89,0,0,0,0,0,0,0,89,89,89,0,0,163,0,163
360050462033,36, New York,005, Bronx County,414,103,103,0,0,16,0,0,0,0,398,103,103,0,0,1334,355,979
360050462041,36, New York,005, Bronx County,560,231,55,122,54,0,0,0,0,0,560,231,55,122,54,1659,46,1613
360050462042,36, New York,005, Bronx County,408,269,142,0,127,0,0,0,0,0,408,269,142,0,127,872,51,821
360050462043,36, New York,005, Bronx County,0,0,0,0,0,0,0,0,0,0,0,0,0,0,0,23,23,0
360050462044,36, New York,005, Bronx County,723,271,71,70,130,110,0,0,0,0,613,271,71,70,130,2146,436,1710
360050462051,36, New York,005, Bronx County,38,19,0,0,19,19,19,0,0,19,19,0,0,0,0,553,19,534
360050462052,36, New York,005, Bronx County,5,0,0,0,0,0,0,0,0,0,5,0,0,0,0,535,5,530
360050462053,36, New York,005, Bronx County,149,0,0,0,0,0,0,0,0,0,149,0,0,0,0,403,22,381
360050462054,36, New York,005, Bronx County,194,69,0,17,52,52,52,0,0,52,142,17,0,17,0,591,69,522
360050462055,36, New York,005, Bronx County,43,0,0,0,0,0,0,0,0,0,43,0,0,0,0,338,37,301
360050462061,36, New York,005, Bronx County,458,0,0,0,0,0,0,0,0,0,458,0,0,0,0,1053,125,928
360050462062,36, New York,005, Bronx County,330,91,91,0,0,49,0,0,0,0,281,91,91,0,0,1192,108,1084
360050462063,36, New York,005, Bronx County,2,0,0,0,0,0,0,0,0,0,2,0,0,0,0,156,0,156
360050462064,36, New York,005, Bronx County,386,43,43,0,0,0,0,0,0,0,386,43,43,0,0,1478,0,1478
360050462071,36, New York,005, Bronx County,261,218,132,0,86,0,0,0,0,0,261,218,132,0,86,612,0,612
360050462072,36, New York,005, Bronx County,396,272,146,126,0,126,126,0,126,0,270,146,146,0,0,1553,456,1097
360050462073,36, New York,005, Bronx County,775,277,172,29,76,29,29,0,29,0,746,248,172,0,76,3025,156,2869
360050462081,36, New York,005, Bronx County,233,204,94,83,27,0,0,0,0,0,233,204,94,83,27,497,24,473
360050462082,36, New York,005, Bronx County,224,160,131,0,29,0,0,0,0,0,224,160,131,0,29,367,0,367
360050462083,36, New York,005, Bronx County,353,228,71,0,157,36,36,0,0,36,317,192,71,0,121,1272,176,1096
360050462084,36, New York,005, Bronx County,333,77,48,0,29,55,29,0,0,29,278,48,48,0,0,891,118,773
360050462091,36, New York,005, Bronx County,216,189,0,67,122,122,122,0,0,122,94,67,0,67,0,670,444,226
360050462092,36, New York,005, Bronx County,234,150,51,41,58,0,0,0,0,0,234,150,51,41,58,730,56,674
360050462093,36, New York,005, Bronx County,735,497,56,0,441,341,302,0,0,302,394,195,56,0,139,1371,424,947
360050484011,36, New York,005, Bronx County,485,236,161,0,75,0,0,0,0,0,485,236,161,0,75,1438,2,1436
360050484012,36, New York,005, Bronx County,143,54,0,0,54,37,37,0,0,37,106,17,0,0,17,437,69,368
360050484013,36, New York,005, Bronx County,262,189,138,38,13,13,13,0,0,13,249,176,138,38,0,632,51,581
360050484021,36, New York,005, Bronx County,0,0,0,0,0,0,0,0,0,0,0,0,0,0,0,0,0,0
360050504000,36, New York,005, Bronx County,0,0,0,0,0,0,0,0,0,0,0,0,0,0,0,0,0,0
360050504001,36, New York,005, Bronx County,0,0,0,0,0,0,0,0,0,0,0,0,0,0,0,0,0,0
360050516010,36, New York,005, Bronx County,0,0,0,0,0,0,0,0,0,0,0,0,0,0,0,0,0,0
360050516011,36, New York,005, Bronx County,123,50,30,0,20,0,0,0,0,0,123,50,30,0,20,443,0,443
360050516012,36, New York,005, Bronx County,215,15,15,0,0,0,0,0,0,0,215,15,15,0,0,746,43,703
360050516013,36, New York,005, Bronx County,505,95,95,0,0,0,0,0,0,0,505,95,95,0,0,1360,116,1244
360050516014,36, New York,005, Bronx County,384,214,110,0,104,0,0,0,0,0,384,214,110,0,104,848,23,825
360050516015,36, New York,005, Bronx County,0,0,0,0,0,0,0,0,0,0,0,0,0,0,0,0,0,0
360050516020,36, New York,005, Bronx County,0,0,0,0,0,0,0,0,0,0,0,0,0,0,0,0,0,0
360050516021,36, New York,005, Bronx County,0,0,0,0,0,0,0,0,0,0,0,0,0,0,0,0,0,0
360290001101,36, New York,029, Erie County,91,36,24,0,12,0,0,0,0,0,91,36,24,0,12,586,98,488
360290001102,36, New York,029, Erie County,258,169,12,102,55,9,9,0,0,9,249,160,12,102,46,725,80,645
360290001103,36, New York,029, Erie County,252,95,11,47,37,22,22,0,0,22,230,73,11,47,15,600,57,543
360290002001,36, New York,029, Erie County,270,216,140,16,60,29,29,0,16,13,241,187,140,0,47,635,90,545
360290002002,36, New York,029, Erie County,105,22,11,11,0,0,0,0,0,0,105,22,11,11,0,598,168,430
360290002003,36, New York,029, Erie County,205,71,66,5,0,11,11,11,0,0,194,60,55,5,0,1126,96,1030
360290002004,36, New York,029, Erie County,263,106,56,0,50,17,17,17,0,0,246,89,39,0,50,846,92,754
360290005001,36, New York,029, Erie County,287,159,71,16,72,86,74,15,16,43,201,85,56,0,29,826,202,624
360290005002,36, New York,029, Erie County,133,34,7,0,27,56,7,0,0,7,77,27,7,0,20,669,323,346
360290006001,36, New York,029, Erie County,649,232,105,13,114,0,0,0,0,0,649,232,105,13,114,1797,49,1748
360290006002,36, New York,029, Erie County,164,115,100,0,15,0,0,0,0,0,164,115,100,0,15,460,75,385
360290006003,36, New York,029, Erie County,180,43,43,0,0,26,26,26,0,0,154,17,17,0,0,628,86,542
360290006004,36, New York,029, Erie County,227,10,0,0,10,0,0,0,0,0,227,10,0,0,10,638,15,623
360290007001,36, New York,029, Erie County,136,92,61,7,24,0,0,0,0,0,136,92,61,7,24,387,6,381
360290007002,36, New York,029, Erie County,236,145,113,0,32,0,0,0,0,0,236,145,113,0,32,641,0,641
360290007003,36, New York,029, Erie County,110,37,26,11,0,9,0,0,0,0,101,37,26,11,0,309,25,284
360290007004,36, New York,029, Erie County,271,63,25,38,0,0,0,0,0,0,271,63,25,38,0,970,61,909
360290007005,36, New York,029, Erie County,197,66,48,8,10,0,0,0,0,0,197,66,48,8,10,651,25,626
360290008001,36, New York,029, Erie County,309,116,86,0,30,9,9,0,0,9,300,107,86,0,21,743,22,721
360290008002,36, New York,029, Erie County,366,165,77,0,88,58,45,11,0,34,308,120,66,0,54,1027,159,868
360290008003,36, New York,029, Erie County,577,372,241,46,85,133,98,0,23,75,444,274,241,23,10,1646,299,1347
360290008004,36, New York,029, Erie County,150,77,77,0,0,0,0,0,0,0,150,77,77,0,0,451,38,413
360290009001,36, New York,029, Erie County,167,27,16,0,11,10,0,0,0,0,157,27,16,0,11,415,20,395
360290009002,36, New York,029, Erie County,141,67,45,0,22,17,10,0,0,10,124,57,45,0,12,423,46,377
360290009003,36, New York,029, Erie County,340,115,32,12,71,38,12,0,12,0,302,103,32,0,71,1141,93,1048
360290010001,36, New York,029, Erie County,244,93,38,0,55,55,55,0,0,55,189,38,38,0,0,955,159,796
360290010002,36, New York,029, Erie County,170,102,64,38,0,64,64,64,0,0,106,38,0,38,0,482,159,323
360290010003,36, New York,029, Erie County,237,108,90,0,18,18,18,0,0,18,219,90,90,0,0,789,133,656
360290010004,36, New York,029, Erie County,186,104,47,0,57,82,82,25,0,57,104,22,22,0,0,631,264,367
360290010005,36, New York,029, Erie County,601,197,162,35,0,25,25,25,0,0,576,172,137,35,0,2122,111,2011
360290011001,36, New York,029, Erie County,440,294,147,35,112,86,86,28,0,58,354,208,119,35,54,1535,257,1278
360290011002,36, New York,029, Erie County,190,44,12,32,0,0,0,0,0,0,190,44,12,32,0,576,62,514
360290011003,36, New York,029, Erie County,104,16,0,16,0,29,16,0,16,0,75,0,0,0,0,605,175,430
360290014031,36, New York,029, Erie County,73,17,0,0,17,17,17,0,0,17,56,0,0,0,0,535,153,382
360290014032,36, New York,029, Erie County,342,224,107,0,117,102,35,0,0,35,240,189,107,0,82,910,459,451
360290014041,36, New York,029, Erie County,92,72,0,0,72,72,72,0,0,72,20,0,0,0,0,247,159,88
360290014042,36, New York,029, Erie County,50,35,13,0,22,3,0,0,0,0,47,35,13,0,22,181,75,106
360290015001,36, New York,029, Erie County,155,88,25,45,18,22,22,22,0,0,133,66,3,45,18,578,114,464
360290015002,36, New York,029, Erie County,142,131,81,0,50,63,63,22,0,41,79,68,59,0,9,389,168,221
360290015003,36, New York,029, Erie County,102,33,0,23,10,0,0,0,0,0,102,33,0,23,10,352,27,325
360290016011,36, New York,029, Erie County,372,152,71,0,81,152,123,48,0,75,220,29,23,0,6,1009,380,629
360290016021,36, New York,029, Erie County,223,110,76,0,34,61,61,44,0,17,162,49,32,0,17,887,220,667
360290017001,36, New York,029, Erie County,229,97,42,43,12,77,39,34,0,5,152,58,8,43,7,998,356,642
360290017002,36, New York,029, Erie County,144,58,35,0,23,30,30,30,0,0,114,28,5,0,23,631,177,454
360290019001,36, New York,029, Erie County,186,53,53,0,0,26,17,17,0,0,160,36,36,0,0,867,101,766
360290019002,36, New York,029, Erie County,390,182,135,0,47,0,0,0,0,0,390,182,135,0,47,1296,74,1222
360290019003,36, New York,029, Erie County,91,33,23,0,10,49,33,23,0,10,42,0,0,0,0,484,176,308
360290023001,36, New York,029, Erie County,226,130,58,21,51,48,48,8,0,40,178,82,50,21,11,725,85,640
360290023002,36, New York,029, Erie County,214,130,50,0,80,38,38,1,0,37,176,92,49,0,43,848,247,601
360290023003,36, New York,029, Erie County,163,86,37,0,49,23,23,0,0,23,140,63,37,0,26,417,84,333
360290023004,36, New York,029, Erie County,210,160,27,37,96,87,78,0,0,78,123,82,27,37,18,672,338,334
360290024001,36, New York,029, Erie County,326,101,24,28,49,8,0,0,0,0,318,101,24,28,49,880,51,829
360290024002,36, New York,029, Erie County,210,84,42,2,40,62,46,31,2,13,148,38,11,0,27,779,180,599
360290024003,36, New York,029, Erie County,140,72,20,37,15,37,37,0,37,0,103,35,20,0,15,462,103,359
360290024004,36, New York,029, Erie County,125,68,68,0,0,13,13,13,0,0,112,55,55,0,0,494,44,450
360290024005,36, New York,029, Erie County,180,78,78,0,0,93,15,15,0,0,87,63,63,0,0,583,221,362
360290025021,36, New York,029, Erie County,106,71,16,0,55,44,44,16,0,28,62,27,0,0,27,777,437,340
360290025022,36, New York,029, Erie County,113,18,0,0,18,0,0,0,0,0,113,18,0,0,18,304,5,299
360290025023,36, New York,029, Erie County,94,54,27,22,5,27,27,0,22,5,67,27,27,0,0,453,196,257
360290027031,36, New York,029, Erie County,263,209,144,6,59,199,182,136,6,40,64,27,8,0,19,704,473,231
360290027041,36, New York,029, Erie County,60,47,29,14,4,37,37,29,4,4,23,10,0,10,0,182,75,107
360290027042,36, New York,029, Erie County,173,112,112,0,0,10,3,3,0,0,163,109,109,0,0,758,153,605
360290027043,36, New York,029, Erie County,67,49,37,12,0,37,37,25,12,0,30,12,12,0,0,128,51,77
360290028011,36, New York,029, Erie County,193,158,89,15,54,111,89,47,15,27,82,69,42,0,27,536,242,294
360290028012,36, New York,029, Erie County,108,70,25,5,40,52,52,12,0,40,56,18,13,5,0,247,88,159
360290028021,36, New York,029, Erie County,183,145,34,0,111,57,40,9,0,31,126,105,25,0,80,691,257,434
360290029001,36, New York,029, Erie County,117,85,31,0,54,34,34,9,0,25,83,51,22,0,29,468,269,199
360290029002,36, New York,029, Erie County,110,97,48,0,49,103,97,48,0,49,7,0,0,0,0,257,161,96
360290029003,36, New York,029, Erie County,79,29,0,0,29,13,0,0,0,0,66,29,0,0,29,192,48,144
360290029004,36, New York,029, Erie County,179,97,53,0,44,69,68,24,0,44,110,29,29,0,0,595,122,473
360290030001,36, New York,029, Erie County,90,78,30,0,48,30,30,0,0,30,60,48,30,0,18,368,61,307
360290030002,36, New York,029, Erie County,331,208,123,0,85,174,144,86,0,58,157,64,37,0,27,1029,426,603
360290030003,36, New York,029, Erie County,84,72,48,24,0,0,0,0,0,0,84,72,48,24,0,246,12,234
360290031001,36, New York,029, Erie County,168,73,36,0,37,59,21,0,0,21,109,52,36,0,16,402,142,260
360290031002,36, New York,029, Erie County,143,67,67,0,0,0,0,0,0,0,143,67,67,0,0,480,57,423
360290031003,36, New York,029, Erie County,37,17,0,0,17,0,0,0,0,0,37,17,0,0,17,267,5,262
360290031004,36, New York,029, Erie County,96,53,0,0,53,53,53,0,0,53,43,0,0,0,0,423,210,213
360290033011,36, New York,029, Erie County,184,164,0,0,164,71,71,0,0,71,113,93,0,0,93,498,120,378
360290033012,36, New York,029, Erie County,109,84,19,34,31,19,19,19,0,0,90,65,0,34,31,641,111,530
360290033013,36, New York,029, Erie County,368,216,23,0,193,33,33,0,0,33,335,183,23,0,160,1112,186,926
360290033014,36, New York,029, Erie County,67,30,0,0,30,0,0,0,0,0,67,30,0,0,30,479,52,427
360290033021,36, New York,029, Erie County,131,87,47,0,40,33,33,33,0,0,98,54,14,0,40,440,142,298
360290033022,36, New York,029, Erie County,141,71,32,0,39,27,0,0,0,0,114,71,32,0,39,453,101,352
360290033023,36, New York,029, Erie County,170,99,37,0,62,0,0,0,0,0,170,99,37,0,62,584,57,527
360290033024,36, New York,029, Erie County,140,83,40,32,11,51,51,40,0,11,89,32,0,32,0,691,235,456
360290034001,36, New York,029, Erie County,120,3,0,0,3,99,0,0,0,0,21,3,0,0,3,326,219,107
360290034002,36, New York,029, Erie County,88,64,45,0,19,10,0,0,0,0,78,64,45,0,19,372,151,221
360290034003,36, New York,029, Erie County,162,103,1,46,56,1,1,1,0,0,161,102,0,46,56,611,73,538
360290034004,36, New York,029, Erie County,77,64,30,0,34,34,34,0,0,34,43,30,30,0,0,298,67,231
360290034005,36, New York,029, Erie County,253,96,0,0,96,101,0,0,0,0,152,96,0,0,96,549,199,350
360290035011,36, New York,029, Erie County,103,56,23,16,17,4,0,0,0,0,99,56,23,16,17,377,133,244
360290035012,36, New York,029, Erie County,287,252,82,18,152,183,183,33,18,132,104,69,49,0,20,476,180,296
360290035021,36, New York,029, Erie County,172,108,53,0,55,60,30,0,0,30,112,78,53,0,25,575,190,385
360290035022,36, New York,029, Erie County,325,73,37,9,27,11,11,0,0,11,314,62,37,9,16,812,47,765
360290036001,36, New York,029, Erie County,119,81,46,19,16,66,35,0,19,16,53,46,46,0,0,389,195,194
360290036002,36, New York,029, Erie County,58,21,0,0,21,30,21,0,0,21,28,0,0,0,0,249,114,135
360290036003,36, New York,029, Erie County,165,87,78,0,9,9,9,0,0,9,156,78,78,0,0,353,32,321
360290036004,36, New York,029, Erie County,318,132,87,0,45,23,0,0,0,0,295,132,87,0,45,983,233,750
360290037001,36, New York,029, Erie County,465,328,59,0,269,89,89,29,0,60,376,239,30,0,209,933,171,762
360290037002,36, New York,029, Erie County,234,144,0,0,144,54,54,0,0,54,180,90,0,0,90,610,170,440
360290037003,36, New York,029, Erie County,120,50,27,0,23,39,27,27,0,0,81,23,0,0,23,290,88,202
360290037004,36, New York,029, Erie County,407,183,91,0,92,116,44,11,0,33,291,139,80,0,59,1073,250,823
360290038001,36, New York,029, Erie County,550,238,9,31,198,300,213,0,31,182,250,25,9,0,16,1306,514,792
360290038002,36, New York,029, Erie County,200,115,85,0,30,36,36,36,0,0,164,79,49,0,30,643,64,579
360290038003,36, New York,029, Erie County,113,74,0,0,74,38,38,0,0,38,75,36,0,0,36,438,161,277
360290039011,36, New York,029, Erie County,242,132,53,0,79,63,63,44,0,19,179,69,9,0,60,870,357,513
360290040021,36, New York,029, Erie County,120,45,11,0,34,1,1,1,0,0,119,44,10,0,34,494,181,313
360290040022,36, New York,029, Erie County,155,128,100,0,28,18,18,0,0,18,137,110,100,0,10,394,77,317
360290040031,36, New York,029, Erie County,359,297,26,102,169,101,101,20,0,81,258,196,6,102,88,765,238,527
360290040032,36, New York,029, Erie County,192,94,58,0,36,87,36,0,0,36,105,58,58,0,0,472,197,275
360290040033,36, New York,029, Erie County,303,191,87,46,58,33,33,2,0,31,270,158,85,46,27,777,101,676
360290041001,36, New York,029, Erie County,243,189,27,0,162,50,50,0,0,50,193,139,27,0,112,949,401,548
360290041002,36, New York,029, Erie County,239,181,39,0,142,44,44,0,0,44,195,137,39,0,98,636,85,551
360290041003,36, New York,029, Erie County,126,38,0,0,38,34,34,0,0,34,92,4,0,0,4,431,72,359
360290041004,36, New York,029, Erie County,304,137,52,0,85,54,54,0,0,54,250,83,52,0,31,1069,85,984
360290042001,36, New York,029, Erie County,205,122,52,0,70,31,31,0,0,31,174,91,52,0,39,523,126,397
360290042002,36, New York,029, Erie County,101,33,0,0,33,33,33,0,0,33,68,0,0,0,0,401,67,334
360290042003,36, New York,029, Erie County,164,150,33,0,117,94,80,0,0,80,70,70,33,0,37,335,154,181
360290042004,36, New York,029, Erie County,124,89,11,0,78,83,83,11,0,72,41,6,0,0,6,334,207,127
360290042005,36, New York,029, Erie County,299,180,24,32,124,108,105,11,32,62,191,75,13,0,62,768,182,586
360290043001,36, New York,029, Erie County,159,80,36,0,44,44,44,0,0,44,115,36,36,0,0,425,133,292
360290043002,36, New York,029, Erie County,110,48,0,0,48,44,44,0,0,44,66,4,0,0,4,510,204,306
360290043003,36, New York,029, Erie County,90,57,0,0,57,0,0,0,0,0,90,57,0,0,57,212,0,212
360290043004,36, New York,029, Erie County,284,25,0,0,25,0,0,0,0,0,284,25,0,0,25,673,39,634
360290043005,36, New York,029, Erie County,748,398,101,142,155,193,107,0,107,0,555,291,101,35,155,2013,659,1354
360290043006,36, New York,029, Erie County,229,113,72,0,41,75,75,56,0,19,154,38,16,0,22,594,156,438
360290043007,36, New York,029, Erie County,190,158,93,0,65,60,60,44,0,16,130,98,49,0,49,406,172,234
360290044011,36, New York,029, Erie County,245,149,44,0,105,16,8,8,0,0,229,141,36,0,105,775,96,679
360290044012,36, New York,029, Erie County,199,148,12,0,136,32,32,0,0,32,167,116,12,0,104,552,134,418
360290044013,36, New York,029, Erie County,541,217,81,0,136,113,85,13,0,72,428,132,68,0,64,1546,270,1276
360290044014,36, New York,029, Erie County,144,76,17,0,59,0,0,0,0,0,144,76,17,0,59,587,45,542
360290044021,36, New York,029, Erie County,552,420,103,6,311,318,311,103,6,202,234,109,0,0,109,1219,777,442
360290044022,36, New York,029, Erie County,216,161,26,0,135,26,26,26,0,0,190,135,0,0,135,542,86,456
360290045001,36, New York,029, Erie County,203,76,63,0,13,0,0,0,0,0,203,76,63,0,13,856,30,826
360290045002,36, New York,029, Erie County,399,124,22,0,102,56,39,0,0,39,343,85,22,0,63,1188,99,1089
360290045003,36, New York,029, Erie County,330,91,81,0,10,0,0,0,0,0,330,91,81,0,10,1141,103,1038
360290045004,36, New York,029, Erie County,125,29,29,0,0,0,0,0,0,0,125,29,29,0,0,366,26,340
360290045005,36, New York,029, Erie County,258,153,94,0,59,21,0,0,0,0,237,153,94,0,59,737,96,641
360290045006,36, New York,029, Erie County,83,30,19,0,11,0,0,0,0,0,83,30,19,0,11,374,0,374
360290046011,36, New York,029, Erie County,112,19,11,8,0,1,1,1,0,0,111,18,10,8,0,470,140,330
360290046012,36, New York,029, Erie County,239,115,6,0,109,8,0,0,0,0,231,115,6,0,109,1098,261,837
360290046013,36, New York,029, Erie County,91,74,8,0,66,0,0,0,0,0,91,74,8,0,66,865,489,376
360290046014,36, New York,029, Erie County,225,110,102,0,8,30,30,30,0,0,195,80,72,0,8,430,19,411
360290047011,36, New York,029, Erie County,104,83,5,0,78,70,61,0,0,61,34,22,5,0,17,493,201,292
360290047012,36, New York,029, Erie County,367,218,73,52,93,98,58,0,0,58,269,160,73,52,35,1050,317,733
360290047021,36, New York,029, Erie County,167,10,0,0,10,0,0,0,0,0,167,10,0,0,10,911,317,594
360290047022,36, New York,029, Erie County,269,119,51,27,41,0,0,0,0,0,269,119,51,27,41,913,133,780
360290047023,36, New York,029, Erie County,196,89,0,0,89,9,0,0,0,0,187,89,0,0,89,1903,986,917
360290048001,36, New York,029, Erie County,280,98,88,10,0,23,0,0,0,0,257,98,88,10,0,959,95,864
360290048002,36, New York,029, Erie County,395,247,214,0,33,26,26,26,0,0,369,221,188,0,33,1128,210,918
360290048003,36, New York,029, Erie County,373,182,75,12,95,54,54,6,0,48,319,128,69,12,47,1200,182,1018
360290049011,36, New York,029, Erie County,97,11,0,11,0,0,0,0,0,0,97,11,0,11,0,715,140,575
360290049012,36, New York,029, Erie County,203,158,131,6,21,27,27,0,6,21,176,131,131,0,0,574,48,526
360290049021,36, New York,029, Erie County,332,165,79,52,34,0,0,0,0,0,332,165,79,52,34,1236,16,1220
360290049022,36, New York,029, Erie County,381,140,92,16,32,14,14,0,0,14,367,126,92,16,18,1593,263,1330
360290049023,36, New York,029, Erie County,209,0,0,0,0,0,0,0,0,0,209,0,0,0,0,978,126,852
360290050001,36, New York,029, Erie County,126,60,54,0,6,0,0,0,0,0,126,60,54,0,6,695,149,546
360290050002,36, New York,029, Erie County,108,42,13,0,29,13,13,13,0,0,95,29,0,0,29,490,148,342
360290050003,36, New York,029, Erie County,167,118,41,16,61,22,22,0,11,11,145,96,41,5,50,689,95,594
360290051001,36, New York,029, Erie County,519,68,54,0,14,17,0,0,0,0,502,68,54,0,14,1831,173,1658
360290051002,36, New York,029, Erie County,237,114,76,0,38,116,81,50,0,31,121,33,26,0,7,643,307,336
360290051003,36, New York,029, Erie County,35,0,0,0,0,0,0,0,0,0,35,0,0,0,0,601,91,510
360290051004,36, New York,029, Erie County,333,199,25,42,132,152,124,0,30,94,181,75,25,12,38,902,340,562
360290052011,36, New York,029, Erie County,304,114,82,9,23,37,23,0,0,23,267,91,82,9,0,989,105,884
360290052012,36, New York,029, Erie County,194,94,68,26,0,0,0,0,0,0,194,94,68,26,0,621,17,604
360290052013,36, New York,029, Erie County,149,67,61,0,6,0,0,0,0,0,149,67,61,0,6,413,46,367
360290052014,36, New York,029, Erie County,245,88,77,11,0,0,0,0,0,0,245,88,77,11,0,694,0,694
360290052021,36, New York,029, Erie County,146,86,21,0,65,15,15,0,0,15,131,71,21,0,50,850,227,623
360290052022,36, New York,029, Erie County,245,152,97,10,45,62,52,39,0,13,183,100,58,10,32,888,279,609
360290053001,36, New York,029, Erie County,171,85,68,11,6,12,6,0,0,6,159,79,68,11,0,612,30,582
360290053002,36, New York,029, Erie County,30,0,0,0,0,0,0,0,0,0,30,0,0,0,0,222,108,114
360290054001,36, New York,029, Erie County,253,83,83,0,0,0,0,0,0,0,253,83,83,0,0,1261,97,1164
360290054002,36, New York,029, Erie County,173,129,58,13,58,0,0,0,0,0,173,129,58,13,58,681,129,552
360290054003,36, New York,029, Erie County,285,101,101,0,0,0,0,0,0,0,285,101,101,0,0,701,10,691
360290054004,36, New York,029, Erie County,274,150,60,0,90,98,98,22,0,76,176,52,38,0,14,904,176,728
360290055001,36, New York,029, Erie County,218,165,49,52,64,45,45,0,5,40,173,120,49,47,24,657,115,542
360290055002,36, New York,029, Erie County,126,53,29,0,24,53,53,29,0,24,73,0,0,0,0,697,248,449
360290055003,36, New York,029, Erie County,178,138,79,0,59,84,76,41,0,35,94,62,38,0,24,600,302,298
360290055004,36, New York,029, Erie County,224,175,153,0,22,102,69,69,0,0,122,106,84,0,22,557,104,453
360290056001,36, New York,029, Erie County,189,140,15,17,108,29,29,0,17,12,160,111,15,0,96,504,191,313
360290056002,36, New York,029, Erie County,167,55,49,0,6,12,0,0,0,0,155,55,49,0,6,482,42,440
360290056003,36, New York,029, Erie County,459,352,1,0,351,233,233,0,0,233,226,119,1,0,118,915,370,545
360290056004,36, New York,029, Erie County,373,208,97,11,100,87,87,34,11,42,286,121,63,0,58,865,210,655
360290056005,36, New York,029, Erie County,184,127,0,0,127,47,47,0,0,47,137,80,0,0,80,428,68,360
360290057001,36, New York,029, Erie County,109,101,10,0,91,69,69,0,0,69,40,32,10,0,22,330,255,75
360290057002,36, New York,029, Erie County,326,95,9,31,55,136,40,0,0,40,190,55,9,31,15,736,302,434
360290057003,36, New York,029, Erie County,374,237,49,0,188,19,19,0,0,19,355,218,49,0,169,831,76,755
360290058011,36, New York,029, Erie County,514,308,123,23,162,113,101,21,0,80,401,207,102,23,82,1253,302,951
360290058012,36, New York,029, Erie County,207,101,24,0,77,20,20,3,0,17,187,81,21,0,60,856,137,719
360290058013,36, New York,029, Erie County,149,98,52,0,46,41,15,0,0,15,108,83,52,0,31,300,68,232
360290058021,36, New York,029, Erie County,167,70,23,0,47,58,38,0,0,38,109,32,23,0,9,675,336,339
360290058022,36, New York,029, Erie County,396,260,140,16,104,116,116,46,16,54,280,144,94,0,50,940,228,712
360290058023,36, New York,029, Erie County,141,71,47,0,24,29,16,16,0,0,112,55,31,0,24,323,69,254
360290058024,36, New York,029, Erie County,632,502,255,118,129,205,169,59,0,110,427,333,196,118,19,1382,377,1005
360290059001,36, New York,029, Erie County,127,79,0,13,66,40,40,0,13,27,87,39,0,0,39,375,92,283
360290059002,36, New York,029, Erie County,249,150,54,0,96,111,98,14,0,84,138,52,40,0,12,496,97,399
360290059003,36, New York,029, Erie County,91,74,33,41,0,0,0,0,0,0,91,74,33,41,0,306,81,225
360290059004,36, New York,029, Erie County,170,170,0,0,170,63,63,0,0,63,107,107,0,0,107,832,310,522
360290059005,36, New York,029, Erie County,272,148,0,54,94,159,129,0,54,75,113,19,0,0,19,956,437,519
360290061001,36, New York,029, Erie County,240,211,60,119,32,103,97,0,97,0,137,114,60,22,32,616,176,440
360290061002,36, New York,029, Erie County,197,125,0,0,125,125,125,0,0,125,72,0,0,0,0,881,259,622
360290061003,36, New York,029, Erie County,133,95,36,0,59,73,59,0,0,59,60,36,36,0,0,321,128,193
360290061004,36, New York,029, Erie County,165,146,35,8,103,138,138,35,0,103,27,8,0,8,0,378,174,204
360290061005,36, New York,029, Erie County,254,192,63,0,129,72,72,0,0,72,182,120,63,0,57,686,118,568
360290063011,36, New York,029, Erie County,238,88,57,0,31,0,0,0,0,0,238,88,57,0,31,766,66,700
360290063012,36, New York,029, Erie County,128,52,37,15,0,0,0,0,0,0,128,52,37,15,0,702,38,664
360290063013,36, New York,029, Erie County,127,10,10,0,0,0,0,0,0,0,127,10,10,0,0,512,19,493
360290063014,36, New York,029, Erie County,263,159,82,26,51,22,22,2,0,20,241,137,80,26,31,1521,295,1226
360290063015,36, New York,029, Erie County,60,21,0,21,0,0,0,0,0,0,60,21,0,21,0,227,36,191
360290063021,36, New York,029, Erie County,271,144,67,0,77,0,0,0,0,0,271,144,67,0,77,735,80,655
360290063022,36, New York,029, Erie County,220,67,57,10,0,0,0,0,0,0,220,67,57,10,0,926,47,879
360290063023,36, New York,029, Erie County,69,18,9,0,9,9,9,0,0,9,60,9,9,0,0,380,67,313
360290065011,36, New York,029, Erie County,72,37,20,0,17,0,0,0,0,0,72,37,20,0,17,656,154,502
360290065012,36, New York,029, Erie County,224,107,58,4,45,34,34,0,0,34,190,73,58,4,11,784,70,714
360290065013,36, New York,029, Erie County,138,43,38,0,5,12,0,0,0,0,126,43,38,0,5,456,28,428
360290065014,36, New York,029, Erie County,71,14,14,0,0,0,0,0,0,0,71,14,14,0,0,369,79,290
360290066011,36, New York,029, Erie County,97,72,19,10,43,43,43,0,0,43,54,29,19,10,0,224,76,148
360290066012,36, New York,029, Erie County,122,99,63,0,36,0,0,0,0,0,122,99,63,0,36,1357,54,1303
360290066013,36, New York,029, Erie County,103,52,52,0,0,9,9,9,0,0,94,43,43,0,0,361,24,337
360290066021,36, New York,029, Erie County,221,134,127,0,7,0,0,0,0,0,221,134,127,0,7,746,11,735
360290066022,36, New York,029, Erie County,94,26,13,13,0,0,0,0,0,0,94,26,13,13,0,527,37,490
360290066023,36, New York,029, Erie County,79,9,0,0,9,0,0,0,0,0,79,9,0,0,9,635,181,454
360290067011,36, New York,029, Erie County,96,0,0,0,0,54,0,0,0,0,42,0,0,0,0,666,190,476
360290067012,36, New York,029, Erie County,292,105,105,0,0,36,0,0,0,0,256,105,105,0,0,1572,284,1288
360290067013,36, New York,029, Erie County,71,0,0,0,0,0,0,0,0,0,71,0,0,0,0,585,44,541
360290067014,36, New York,029, Erie County,162,81,39,0,42,0,0,0,0,0,162,81,39,0,42,526,2,524
360290067021,36, New York,029, Erie County,197,114,0,41,73,114,114,0,41,73,83,0,0,0,0,923,303,620
360290067022,36, New York,029, Erie County,142,46,46,0,0,0,0,0,0,0,142,46,46,0,0,1019,127,892
360290067023,36, New York,029, Erie County,134,21,0,0,21,36,0,0,0,0,98,21,0,0,21,742,268,474
360290067024,36, New York,029, Erie County,31,0,0,0,0,0,0,0,0,0,31,0,0,0,0,443,50,393
360290068011,36, New York,029, Erie County,90,86,79,7,0,7,7,0,7,0,83,79,79,0,0,1115,70,1045
360290068021,36, New York,029, Erie County,101,62,33,0,29,29,29,0,0,29,72,33,33,0,0,567,120,447
360290068022,36, New York,029, Erie County,93,33,0,10,23,0,0,0,0,0,93,33,0,10,23,459,39,420
360290068023,36, New York,029, Erie County,202,69,44,0,25,25,25,0,0,25,177,44,44,0,0,854,147,707
360290069011,36, New York,029, Erie County,236,135,70,7,58,39,39,11,0,28,197,96,59,7,30,502,77,425
360290069012,36, New York,029, Erie County,295,239,159,40,40,48,27,0,0,27,247,212,159,40,13,579,104,475
360290069013,36, New York,029, Erie County,358,244,123,56,65,92,67,53,0,14,266,177,70,56,51,746,138,608
360290069014,36, New York,029, Erie County,75,64,41,0,23,29,29,17,0,12,46,35,24,0,11,371,147,224
360290069031,36, New York,029, Erie County,354,202,184,18,0,24,10,10,0,0,330,192,174,18,0,1367,187,1180
360290069041,36, New York,029, Erie County,101,69,27,5,37,26,26,0,0,26,75,43,27,5,11,635,184,451
360290069042,36, New York,029, Erie County,112,44,15,29,0,29,29,0,29,0,83,15,15,0,0,392,55,337
360290069043,36, New York,029, Erie County,109,47,22,0,25,34,22,22,0,0,75,25,0,0,25,517,84,433
360290070001,36, New York,029, Erie County,323,203,164,19,20,34,28,8,0,20,289,175,156,19,0,793,56,737
360290070002,36, New York,029, Erie County,203,132,16,0,116,111,111,8,0,103,92,21,8,0,13,579,253,326
360290070003,36, New York,029, Erie County,226,129,103,26,0,0,0,0,0,0,226,129,103,26,0,680,21,659
360290071021,36, New York,029, Erie County,175,160,54,0,106,166,160,54,0,106,9,0,0,0,0,504,404,100
360290071022,36, New York,029, Erie County,198,26,0,0,26,26,26,0,0,26,172,0,0,0,0,706,139,567
360290071023,36, New York,029, Erie County,169,75,26,0,49,75,75,26,0,49,94,0,0,0,0,494,173,321
360290071031,36, New York,029, Erie County,19,0,0,0,0,9,0,0,0,0,10,0,0,0,0,303,61,242
360290071032,36, New York,029, Erie County,245,211,108,0,103,211,211,108,0,103,34,0,0,0,0,520,336,184
360290071041,36, New York,029, Erie County,87,78,49,0,29,70,70,41,0,29,17,8,8,0,0,223,126,97
360290071042,36, New York,029, Erie County,198,116,31,9,76,68,68,27,9,32,130,48,4,0,44,702,186,516
360290071043,36, New York,029, Erie County,17,17,0,8,9,8,8,0,8,0,9,9,0,0,9,295,239,56
360290071044,36, New York,029, Erie County,268,236,72,28,136,175,166,30,0,136,93,70,42,28,0,1004,555,449
360290072021,36, New York,029, Erie County,377,165,41,0,124,66,66,31,0,35,311,99,10,0,89,1252,145,1107
360290073031,36, New York,029, Erie County,210,92,19,0,73,0,0,0,0,0,210,92,19,0,73,614,0,614
360290073032,36, New York,029, Erie County,586,305,253,0,52,12,12,0,0,12,574,293,253,0,40,1650,81,1569
360290073033,36, New York,029, Erie County,549,237,219,0,18,44,0,0,0,0,505,237,219,0,18,1404,92,1312
360290073034,36, New York,029, Erie County,307,60,60,0,0,0,0,0,0,0,307,60,60,0,0,842,0,842
360290073035,36, New York,029, Erie County,186,131,0,0,131,0,0,0,0,0,186,131,0,0,131,1025,153,872
360290073041,36, New York,029, Erie County,817,245,231,0,14,0,0,0,0,0,817,245,231,0,14,2370,0,2370
360290073042,36, New York,029, Erie County,175,88,80,0,8,13,0,0,0,0,162,88,80,0,8,433,28,405
360290073043,36, New York,029, Erie County,882,377,318,0,59,0,0,0,0,0,882,377,318,0,59,2248,45,2203
360290073051,36, New York,029, Erie County,671,270,212,11,47,22,7,0,0,7,649,263,212,11,40,1967,181,1786
360290073061,36, New York,029, Erie County,223,110,53,35,22,0,0,0,0,0,223,110,53,35,22,749,63,686
360290073062,36, New York,029, Erie County,212,145,120,15,10,0,0,0,0,0,212,145,120,15,10,492,0,492
360290073063,36, New York,029, Erie County,249,110,110,0,0,81,0,0,0,0,168,110,110,0,0,634,148,486
360290073064,36, New York,029, Erie County,456,165,165,0,0,0,0,0,0,0,456,165,165,0,0,1053,0,1053
360290073065,36, New York,029, Erie County,526,124,69,55,0,0,0,0,0,0,526,124,69,55,0,1448,80,1368
360290076001,36, New York,029, Erie County,213,46,31,15,0,44,0,0,0,0,169,46,31,15,0,797,172,625
360290076002,36, New York,029, Erie County,323,49,37,12,0,9,0,0,0,0,314,49,37,12,0,973,29,944
360290076003,36, New York,029, Erie County,236,125,103,0,22,0,0,0,0,0,236,125,103,0,22,730,23,707
360290077001,36, New York,029, Erie County,344,70,70,0,0,0,0,0,0,0,344,70,70,0,0,1077,35,1042
360290077002,36, New York,029, Erie County,169,34,20,14,0,0,0,0,0,0,169,34,20,14,0,814,285,529
360290077003,36, New York,029, Erie County,194,109,68,17,24,24,24,0,0,24,170,85,68,17,0,532,24,508
360290077004,36, New York,029, Erie County,177,98,98,0,0,0,0,0,0,0,177,98,98,0,0,509,46,463
360290077005,36, New York,029, Erie County,347,140,17,98,25,7,0,0,0,0,340,140,17,98,25,796,35,761
360290078001,36, New York,029, Erie County,187,9,9,0,0,0,0,0,0,0,187,9,9,0,0,711,31,680
360290078002,36, New York,029, Erie County,638,464,288,0,176,114,80,0,0,80,524,384,288,0,96,1144,194,950
360290078003,36, New York,029, Erie County,292,165,108,0,57,0,0,0,0,0,292,165,108,0,57,811,13,798
360290078004,36, New York,029, Erie County,545,113,12,75,26,26,26,0,0,26,519,87,12,75,0,1165,36,1129
360290079011,36, New York,029, Erie County,306,125,106,7,12,0,0,0,0,0,306,125,106,7,12,885,24,861
360290079012,36, New York,029, Erie County,144,86,24,0,62,3,3,0,0,3,141,83,24,0,59,839,99,740
360290079013,36, New York,029, Erie County,315,149,138,0,11,11,11,0,0,11,304,138,138,0,0,823,15,808
360290079021,36, New York,029, Erie County,165,60,60,0,0,0,0,0,0,0,165,60,60,0,0,541,22,519
360290079022,36, New York,029, Erie County,178,84,65,0,19,19,19,0,0,19,159,65,65,0,0,689,63,626
360290079023,36, New York,029, Erie County,606,146,124,0,22,31,31,20,0,11,575,115,104,0,11,2147,117,2030
360290079024,36, New York,029, Erie County,332,117,117,0,0,0,0,0,0,0,332,117,117,0,0,870,65,805
360290079025,36, New York,029, Erie County,371,82,82,0,0,15,0,0,0,0,356,82,82,0,0,908,42,866
360290079026,36, New York,029, Erie County,109,32,32,0,0,0,0,0,0,0,109,32,32,0,0,369,0,369
360290079031,36, New York,029, Erie County,292,94,62,0,32,20,10,0,0,10,272,84,62,0,22,935,58,877
360290079032,36, New York,029, Erie County,165,77,77,0,0,0,0,0,0,0,165,77,77,0,0,558,11,547
360290079033,36, New York,029, Erie County,312,135,123,12,0,46,19,19,0,0,266,116,104,12,0,861,100,761
360290079041,36, New York,029, Erie County,343,118,101,0,17,18,0,0,0,0,325,118,101,0,17,901,48,853
360290079042,36, New York,029, Erie County,108,42,42,0,0,0,0,0,0,0,108,42,42,0,0,377,29,348
360290079043,36, New York,029, Erie County,339,102,52,23,27,15,15,0,0,15,324,87,52,23,12,1037,65,972
360290079051,36, New York,029, Erie County,388,201,184,0,17,43,43,43,0,0,345,158,141,0,17,961,84,877
360290079052,36, New York,029, Erie County,362,133,116,17,0,0,0,0,0,0,362,133,116,17,0,911,0,911
360290079053,36, New York,029, Erie County,191,52,34,18,0,0,0,0,0,0,191,52,34,18,0,642,0,642
360290079054,36, New York,029, Erie County,223,32,32,0,0,17,0,0,0,0,206,32,32,0,0,1087,105,982
360290080011,36, New York,029, Erie County,266,20,20,0,0,18,0,0,0,0,248,20,20,0,0,706,37,669
360290080012,36, New York,029, Erie County,268,79,71,0,8,0,0,0,0,0,268,79,71,0,8,901,88,813
360290080013,36, New York,029, Erie County,203,131,131,0,0,78,78,78,0,0,125,53,53,0,0,497,110,387
360290080014,36, New York,029, Erie County,136,41,22,0,19,0,0,0,0,0,136,41,22,0,19,390,0,390
360290080015,36, New York,029, Erie County,224,82,60,0,22,0,0,0,0,0,224,82,60,0,22,666,102,564
360290080016,36, New York,029, Erie County,303,166,153,0,13,0,0,0,0,0,303,166,153,0,13,950,73,877
360290080021,36, New York,029, Erie County,124,45,45,0,0,0,0,0,0,0,124,45,45,0,0,426,0,426
360290080022,36, New York,029, Erie County,193,163,69,0,94,95,95,21,0,74,98,68,48,0,20,475,127,348
360290080023,36, New York,029, Erie County,378,82,54,0,28,0,0,0,0,0,378,82,54,0,28,902,11,891
360290080024,36, New York,029, Erie County,344,174,73,101,0,0,0,0,0,0,344,174,73,101,0,822,0,822
360290080025,36, New York,029, Erie County,324,166,156,0,10,0,0,0,0,0,324,166,156,0,10,916,44,872
360290080026,36, New York,029, Erie County,299,177,135,0,42,42,42,0,0,42,257,135,135,0,0,561,42,519
360290080031,36, New York,029, Erie County,204,28,28,0,0,0,0,0,0,0,204,28,28,0,0,685,22,663
360290080032,36, New York,029, Erie County,209,43,24,0,19,51,33,24,0,9,158,10,0,0,10,752,151,601
360290080033,36, New York,029, Erie County,178,51,42,9,0,20,0,0,0,0,158,51,42,9,0,748,53,695
360290080034,36, New York,029, Erie County,433,272,137,103,32,0,0,0,0,0,433,272,137,103,32,1147,33,1114
360290080035,36, New York,029, Erie County,196,40,0,40,0,0,0,0,0,0,196,40,0,40,0,698,19,679
360290081011,36, New York,029, Erie County,504,204,52,110,42,0,0,0,0,0,504,204,52,110,42,1589,49,1540
360290081012,36, New York,029, Erie County,274,113,85,28,0,0,0,0,0,0,274,113,85,28,0,909,0,909
360290081013,36, New York,029, Erie County,252,137,51,0,86,0,0,0,0,0,252,137,51,0,86,506,0,506
360290081014,36, New York,029, Erie County,251,55,30,25,0,32,25,0,25,0,219,30,30,0,0,677,39,638
360290081015,36, New York,029, Erie County,258,66,33,0,33,0,0,0,0,0,258,66,33,0,33,1617,575,1042
360290081021,36, New York,029, Erie County,270,108,88,20,0,18,10,10,0,0,252,98,78,20,0,794,99,695
360290081022,36, New York,029, Erie County,208,40,33,0,7,10,0,0,0,0,198,40,33,0,7,860,19,841
360290081023,36, New York,029, Erie County,244,83,47,36,0,0,0,0,0,0,244,83,47,36,0,622,0,622
360290081024,36, New York,029, Erie County,224,34,34,0,0,11,0,0,0,0,213,34,34,0,0,624,50,574
360290081025,36, New York,029, Erie County,217,154,115,0,39,4,4,0,0,4,213,150,115,0,35,524,20,504
360290082011,36, New York,029, Erie County,294,182,149,0,33,13,13,13,0,0,281,169,136,0,33,686,29,657
360290082012,36, New York,029, Erie County,175,64,27,0,37,10,10,0,0,10,165,54,27,0,27,608,74,534
360290082013,36, New York,029, Erie County,154,41,36,5,0,0,0,0,0,0,154,41,36,5,0,793,49,744
360290082021,36, New York,029, Erie County,191,61,54,0,7,0,0,0,0,0,191,61,54,0,7,652,52,600
360290082022,36, New York,029, Erie County,220,65,42,23,0,56,22,5,17,0,164,43,37,6,0,685,157,528
360290082023,36, New York,029, Erie County,168,33,17,0,16,16,16,0,0,16,152,17,17,0,0,498,31,467
360290082024,36, New York,029, Erie County,201,117,61,0,56,14,14,0,0,14,187,103,61,0,42,741,78,663
360290082025,36, New York,029, Erie County,49,0,0,0,0,0,0,0,0,0,49,0,0,0,0,465,171,294
360290083001,36, New York,029, Erie County,155,109,35,0,74,44,31,0,0,31,111,78,35,0,43,825,149,676
360290083002,36, New York,029, Erie County,220,141,141,0,0,17,0,0,0,0,203,141,141,0,0,603,71,532
360290083003,36, New York,029, Erie County,110,78,46,0,32,45,32,0,0,32,65,46,46,0,0,366,155,211
360290084001,36, New York,029, Erie County,138,93,0,0,93,65,50,0,0,50,73,43,0,0,43,386,84,302
360290084002,36, New York,029, Erie County,443,156,135,0,21,17,0,0,0,0,426,156,135,0,21,1484,166,1318
360290085001,36, New York,029, Erie County,237,152,104,0,48,0,0,0,0,0,237,152,104,0,48,949,53,896
360290085002,36, New York,029, Erie County,328,93,73,0,20,0,0,0,0,0,328,93,73,0,20,1116,17,1099
360290086001,36, New York,029, Erie County,309,208,155,0,53,18,18,18,0,0,291,190,137,0,53,769,32,737
360290086002,36, New York,029, Erie County,185,40,29,0,11,0,0,0,0,0,185,40,29,0,11,653,0,653
360290086003,36, New York,029, Erie County,33,0,0,0,0,0,0,0,0,0,33,0,0,0,0,505,91,414
360290086004,36, New York,029, Erie County,169,103,72,0,31,13,13,0,0,13,156,90,72,0,18,460,52,408
360290086005,36, New York,029, Erie County,498,331,119,153,59,138,138,0,138,0,360,193,119,15,59,1138,162,976
360290087001,36, New York,029, Erie County,236,136,76,0,60,29,29,0,0,29,207,107,76,0,31,711,47,664
360290087002,36, New York,029, Erie County,164,113,89,8,16,16,16,0,0,16,148,97,89,8,0,459,33,426
360290087003,36, New York,029, Erie County,212,114,101,0,13,0,0,0,0,0,212,114,101,0,13,665,46,619
360290087004,36, New York,029, Erie County,244,62,18,15,29,41,0,0,0,0,203,62,18,15,29,801,297,504
360290087005,36, New York,029, Erie County,343,71,55,0,16,0,0,0,0,0,343,71,55,0,16,934,48,886
360290088001,36, New York,029, Erie County,125,25,0,0,25,0,0,0,0,0,125,25,0,0,25,517,0,517
360290088002,36, New York,029, Erie County,253,137,58,9,70,0,0,0,0,0,253,137,58,9,70,968,12,956
360290088003,36, New York,029, Erie County,401,180,79,0,101,29,0,0,0,0,372,180,79,0,101,1402,85,1317
360290089001,36, New York,029, Erie County,210,98,69,22,7,7,7,0,0,7,203,91,69,22,0,618,14,604
360290089002,36, New York,029, Erie County,156,78,70,0,8,0,0,0,0,0,156,78,70,0,8,655,21,634
360290089003,36, New York,029, Erie County,309,103,103,0,0,11,0,0,0,0,298,103,103,0,0,685,18,667
360290089004,36, New York,029, Erie County,200,78,42,0,36,0,0,0,0,0,200,78,42,0,36,734,37,697
360290089005,36, New York,029, Erie County,290,58,52,0,6,0,0,0,0,0,290,58,52,0,6,904,24,880
360290090041,36, New York,029, Erie County,414,160,104,23,33,0,0,0,0,0,414,160,104,23,33,1248,86,1162
360290090042,36, New York,029, Erie County,846,486,481,0,5,318,288,283,0,5,528,198,198,0,0,1492,200,1292
360290090071,36, New York,029, Erie County,738,269,157,0,112,0,0,0,0,0,738,269,157,0,112,1659,0,1659
360290090072,36, New York,029, Erie County,356,150,142,0,8,0,0,0,0,0,356,150,142,0,8,792,0,792
360290090073,36, New York,029, Erie County,728,385,364,11,10,0,0,0,0,0,728,385,364,11,10,1798,68,1730
360290090074,36, New York,029, Erie County,401,213,178,10,25,0,0,0,0,0,401,213,178,10,25,1010,0,1010
360290090081,36, New York,029, Erie County,383,151,105,0,46,33,16,0,0,16,350,135,105,0,30,1201,64,1137
360290090082,36, New York,029, Erie County,179,36,24,0,12,0,0,0,0,0,179,36,24,0,12,810,20,790
360290090083,36, New York,029, Erie County,173,99,76,15,8,8,8,0,0,8,165,91,76,15,0,571,10,561
360290090084,36, New York,029, Erie County,255,87,87,0,0,15,15,15,0,0,240,72,72,0,0,1042,81,961
360290090091,36, New York,029, Erie County,492,177,177,0,0,0,0,0,0,0,492,177,177,0,0,1298,15,1283
360290090092,36, New York,029, Erie County,559,388,388,0,0,14,0,0,0,0,545,388,388,0,0,1495,77,1418
360290090093,36, New York,029, Erie County,500,194,83,14,97,53,36,0,0,36,447,158,83,14,61,1513,148,1365
360290090101,36, New York,029, Erie County,311,137,119,0,18,0,0,0,0,0,311,137,119,0,18,998,36,962
360290090102,36, New York,029, Erie County,564,362,341,21,0,0,0,0,0,0,564,362,341,21,0,1249,0,1249
360290090103,36, New York,029, Erie County,188,75,75,0,0,0,0,0,0,0,188,75,75,0,0,475,0,475
360290090104,36, New York,029, Erie County,649,329,235,12,82,120,105,23,0,82,529,224,212,12,0,1322,146,1176
360290090111,36, New York,029, Erie County,344,173,152,14,7,0,0,0,0,0,344,173,152,14,7,1013,0,1013
360290090112,36, New York,029, Erie County,409,129,113,0,16,12,0,0,0,0,397,129,113,0,16,1217,29,1188
360290090121,36, New York,029, Erie County,378,206,169,13,24,0,0,0,0,0,378,206,169,13,24,821,24,797
360290090122,36, New York,029, Erie County,268,64,41,0,23,9,9,0,0,9,259,55,41,0,14,977,22,955
360290090123,36, New York,029, Erie County,503,227,194,0,33,25,4,0,0,4,478,223,194,0,29,1107,171,936
360290091041,36, New York,029, Erie County,401,88,88,0,0,0,0,0,0,0,401,88,88,0,0,1165,19,1146
360290091042,36, New York,029, Erie County,336,104,101,0,3,7,0,0,0,0,329,104,101,0,3,936,26,910
360290091043,36, New York,029, Erie County,470,128,92,36,0,17,0,0,0,0,453,128,92,36,0,1445,118,1327
360290091061,36, New York,029, Erie County,280,67,58,9,0,0,0,0,0,0,280,67,58,9,0,774,43,731
360290091062,36, New York,029, Erie County,668,147,121,11,15,0,0,0,0,0,668,147,121,11,15,2085,126,1959
360290091071,36, New York,029, Erie County,311,181,121,0,60,11,11,0,0,11,300,170,121,0,49,1040,134,906
360290091072,36, New York,029, Erie County,231,93,41,0,52,0,0,0,0,0,231,93,41,0,52,674,149,525
360290091073,36, New York,029, Erie County,661,255,53,14,188,25,11,0,0,11,636,244,53,14,177,1873,98,1775
360290091074,36, New York,029, Erie County,437,337,337,0,0,27,27,27,0,0,410,310,310,0,0,976,68,908
360290091091,36, New York,029, Erie County,188,71,71,0,0,0,0,0,0,0,188,71,71,0,0,704,87,617
360290091092,36, New York,029, Erie County,534,212,161,35,16,101,25,18,0,7,433,187,143,35,9,1366,224,1142
360290091101,36, New York,029, Erie County,0,0,0,0,0,0,0,0,0,0,0,0,0,0,0,0,0,0
360290091121,36, New York,029, Erie County,468,218,142,39,37,66,54,4,13,37,402,164,138,26,0,1616,419,1197
360290091122,36, New York,029, Erie County,66,24,24,0,0,0,0,0,0,0,66,24,24,0,0,532,55,477
360290091131,36, New York,029, Erie County,622,246,213,33,0,0,0,0,0,0,622,246,213,33,0,1488,0,1488
360290091132,36, New York,029, Erie County,705,188,162,0,26,0,0,0,0,0,705,188,162,0,26,1726,13,1713
360290091133,36, New York,029, Erie County,830,288,288,0,0,48,34,34,0,0,782,254,254,0,0,2182,116,2066
360290091141,36, New York,029, Erie County,326,124,105,19,0,0,0,0,0,0,326,124,105,19,0,817,10,807
360290091142,36, New York,029, Erie County,440,202,145,18,39,25,25,25,0,0,415,177,120,18,39,1247,56,1191
360290091143,36, New York,029, Erie County,366,167,98,17,52,0,0,0,0,0,366,167,98,17,52,927,34,893
360290091151,36, New York,029, Erie County,101,38,38,0,0,0,0,0,0,0,101,38,38,0,0,994,318,676
360290091152,36, New York,029, Erie County,274,144,14,100,30,68,68,0,68,0,206,76,14,32,30,874,248,626
360290091153,36, New York,029, Erie County,28,0,0,0,0,0,0,0,0,0,28,0,0,0,0,569,393,176
360290091161,36, New York,029, Erie County,174,54,35,1,18,0,0,0,0,0,174,54,35,1,18,962,157,805
360290091162,36, New York,029, Erie County,324,222,189,0,33,17,17,17,0,0,307,205,172,0,33,838,49,789
360290091163,36, New York,029, Erie County,193,115,18,29,68,39,39,18,21,0,154,76,0,8,68,751,55,696
360290091164,36, New York,029, Erie County,462,108,92,0,16,0,0,0,0,0,462,108,92,0,16,1867,407,1460
360290092001,36, New York,029, Erie County,324,207,150,43,14,0,0,0,0,0,324,207,150,43,14,909,81,828
360290092002,36, New York,029, Erie County,205,105,74,0,31,0,0,0,0,0,205,105,74,0,31,654,12,642
360290092003,36, New York,029, Erie County,307,25,25,0,0,0,0,0,0,0,307,25,25,0,0,1222,68,1154
360290092004,36, New York,029, Erie County,152,28,28,0,0,0,0,0,0,0,152,28,28,0,0,558,24,534
360290093011,36, New York,029, Erie County,77,29,0,29,0,0,0,0,0,0,77,29,0,29,0,528,3,525
360290093012,36, New York,029, Erie County,106,84,84,0,0,0,0,0,0,0,106,84,84,0,0,694,0,694
360290093013,36, New York,029, Erie County,347,234,23,27,184,128,120,23,0,97,219,114,0,27,87,1083,376,707
360290093014,36, New York,029, Erie County,375,112,112,0,0,0,0,0,0,0,375,112,112,0,0,972,35,937
360290093015,36, New York,029, Erie County,147,39,21,0,18,35,18,0,0,18,112,21,21,0,0,392,102,290
360290093021,36, New York,029, Erie County,232,134,75,44,15,25,25,0,10,15,207,109,75,34,0,618,54,564
360290093022,36, New York,029, Erie County,408,286,118,0,168,26,26,9,0,17,382,260,109,0,151,964,60,904
360290093023,36, New York,029, Erie County,164,72,72,0,0,0,0,0,0,0,164,72,72,0,0,461,45,416
360290094011,36, New York,029, Erie County,402,211,113,0,98,0,0,0,0,0,402,211,113,0,98,1150,278,872
360290094012,36, New York,029, Erie County,324,90,90,0,0,12,0,0,0,0,312,90,90,0,0,804,24,780
360290094013,36, New York,029, Erie County,226,106,73,0,33,57,33,0,0,33,169,73,73,0,0,961,146,815
360290094014,36, New York,029, Erie County,160,44,23,21,0,0,0,0,0,0,160,44,23,21,0,543,17,526
360290094015,36, New York,029, Erie County,228,70,70,0,0,0,0,0,0,0,228,70,70,0,0,619,25,594
360290094021,36, New York,029, Erie County,226,113,104,0,9,9,9,0,0,9,217,104,104,0,0,613,18,595
360290094022,36, New York,029, Erie County,269,78,22,0,56,0,0,0,0,0,269,78,22,0,56,827,31,796
360290094023,36, New York,029, Erie County,398,150,150,0,0,9,0,0,0,0,389,150,150,0,0,1134,17,1117
360290094024,36, New York,029, Erie County,317,179,171,0,8,0,0,0,0,0,317,179,171,0,8,947,68,879
360290095011,36, New York,029, Erie County,302,115,75,26,14,0,0,0,0,0,302,115,75,26,14,744,0,744
360290095012,36, New York,029, Erie County,501,278,179,21,78,47,47,0,0,47,454,231,179,21,31,1362,51,1311
360290095013,36, New York,029, Erie County,366,124,111,0,13,0,0,0,0,0,366,124,111,0,13,1186,60,1126
360290095014,36, New York,029, Erie County,169,87,57,0,30,0,0,0,0,0,169,87,57,0,30,583,0,583
360290095031,36, New York,029, Erie County,256,138,108,11,19,0,0,0,0,0,256,138,108,11,19,675,18,657
360290095032,36, New York,029, Erie County,344,189,132,35,22,0,0,0,0,0,344,189,132,35,22,991,20,971
360290095041,36, New York,029, Erie County,357,159,121,13,25,12,0,0,0,0,345,159,121,13,25,856,40,816
360290095042,36, New York,029, Erie County,388,232,203,0,29,0,0,0,0,0,388,232,203,0,29,1501,308,1193
360290095043,36, New York,029, Erie County,432,188,166,0,22,0,0,0,0,0,432,188,166,0,22,1002,6,996
360290096011,36, New York,029, Erie County,352,135,85,20,30,9,0,0,0,0,343,135,85,20,30,1298,99,1199
360290096021,36, New York,029, Erie County,315,74,74,0,0,0,0,0,0,0,315,74,74,0,0,844,0,844
360290096022,36, New York,029, Erie County,606,164,123,0,41,0,0,0,0,0,606,164,123,0,41,1739,40,1699
360290096023,36, New York,029, Erie County,91,0,0,0,0,55,0,0,0,0,36,0,0,0,0,370,155,215
360290096024,36, New York,029, Erie County,278,231,156,0,75,35,17,0,0,17,243,214,156,0,58,1156,188,968
360290097011,36, New York,029, Erie County,430,207,95,0,112,54,54,0,0,54,376,153,95,0,58,1047,69,978
360290097012,36, New York,029, Erie County,493,126,65,0,61,30,22,0,0,22,463,104,65,0,39,1366,87,1279
360290097021,36, New York,029, Erie County,319,161,97,10,54,45,45,45,0,0,274,116,52,10,54,972,118,854
360290097022,36, New York,029, Erie County,269,117,52,38,27,29,29,0,29,0,240,88,52,9,27,722,29,693
360290097023,36, New York,029, Erie County,240,98,93,5,0,5,0,0,0,0,235,98,93,5,0,712,23,689
360290097024,36, New York,029, Erie County,377,161,110,0,51,17,7,0,0,7,360,154,110,0,44,973,26,947
360290098001,36, New York,029, Erie County,266,121,81,0,40,13,13,0,0,13,253,108,81,0,27,780,50,730
360290098002,36, New York,029, Erie County,188,79,15,6,58,16,16,0,0,16,172,63,15,6,42,611,91,520
360290099001,36, New York,029, Erie County,380,165,78,57,30,57,30,0,0,30,323,135,78,57,0,1125,110,1015
360290099002,36, New York,029, Erie County,221,95,13,16,66,26,26,0,0,26,195,69,13,16,40,519,26,493
360290099003,36, New York,029, Erie County,420,171,91,0,80,52,41,23,0,18,368,130,68,0,62,1447,231,1216
360290100011,36, New York,029, Erie County,501,104,90,0,14,6,6,0,0,6,495,98,90,0,8,1922,49,1873
360290100012,36, New York,029, Erie County,409,128,74,35,19,17,17,5,0,12,392,111,69,35,7,1068,57,1011
360290100021,36, New York,029, Erie County,387,135,116,0,19,19,19,0,0,19,368,116,116,0,0,1370,74,1296
360290100022,36, New York,029, Erie County,398,123,75,35,13,5,0,0,0,0,393,123,75,35,13,1059,52,1007
360290100023,36, New York,029, Erie County,198,73,73,0,0,15,15,15,0,0,183,58,58,0,0,1124,183,941
360290100031,36, New York,029, Erie County,466,216,128,0,88,20,14,0,0,14,446,202,128,0,74,1545,141,1404
360290100032,36, New York,029, Erie County,288,141,71,47,23,7,7,7,0,0,281,134,64,47,23,733,40,693
360290100033,36, New York,029, Erie County,164,66,56,0,10,20,20,10,0,10,144,46,46,0,0,539,96,443
360290101011,36, New York,029, Erie County,132,52,37,0,15,0,0,0,0,0,132,52,37,0,15,544,38,506
360290101012,36, New York,029, Erie County,366,166,148,0,18,31,14,14,0,0,335,152,134,0,18,1187,102,1085
360290101013,36, New York,029, Erie County,288,87,59,0,28,28,28,0,0,28,260,59,59,0,0,800,66,734
360290101014,36, New York,029, Erie County,383,139,109,0,30,25,25,25,0,0,358,114,84,0,30,954,44,910
360290101021,36, New York,029, Erie County,412,273,113,98,62,0,0,0,0,0,412,273,113,98,62,1032,35,997
360290101022,36, New York,029, Erie County,200,61,27,0,34,0,0,0,0,0,200,61,27,0,34,529,59,470
360290101023,36, New York,029, Erie County,391,276,107,6,163,85,85,12,0,73,306,191,95,6,90,1518,298,1220
360290101031,36, New York,029, Erie County,447,189,71,0,118,44,44,0,0,44,403,145,71,0,74,1367,90,1277
360290101032,36, New York,029, Erie County,258,99,69,23,7,7,0,0,0,0,251,99,69,23,7,1330,59,1271
360290101033,36, New York,029, Erie County,112,47,19,0,28,9,9,9,0,0,103,38,10,0,28,590,112,478
360290102011,36, New York,029, Erie County,168,38,21,0,17,0,0,0,0,0,168,38,21,0,17,547,7,540
360290102012,36, New York,029, Erie County,269,133,69,0,64,5,5,0,0,5,264,128,69,0,59,941,99,842
360290102013,36, New York,029, Erie County,164,80,61,0,19,0,0,0,0,0,164,80,61,0,19,518,14,504
360290102021,36, New York,029, Erie County,443,209,89,0,120,88,88,16,0,72,355,121,73,0,48,1513,193,1320
360290102022,36, New York,029, Erie County,26,12,12,0,0,0,0,0,0,0,26,12,12,0,0,189,88,101
360290102023,36, New York,029, Erie County,368,183,156,0,27,4,0,0,0,0,364,183,156,0,27,1135,9,1126
360290103001,36, New York,029, Erie County,185,94,35,4,55,18,0,0,0,0,167,94,35,4,55,456,56,400
360290103002,36, New York,029, Erie County,172,72,15,0,57,7,7,0,0,7,165,65,15,0,50,529,75,454
360290104001,36, New York,029, Erie County,449,314,81,9,224,74,63,6,0,57,375,251,75,9,167,1076,196,880
360290104002,36, New York,029, Erie County,186,96,49,8,39,26,0,0,0,0,160,96,49,8,39,520,92,428
360290105001,36, New York,029, Erie County,97,77,39,26,12,0,0,0,0,0,97,77,39,26,12,334,29,305
360290105002,36, New York,029, Erie County,286,192,141,12,39,12,12,0,12,0,274,180,141,0,39,909,20,889
360290105003,36, New York,029, Erie County,217,114,59,9,46,0,0,0,0,0,217,114,59,9,46,635,59,576
360290106001,36, New York,029, Erie County,277,111,95,0,16,11,0,0,0,0,266,111,95,0,16,713,105,608
360290106002,36, New York,029, Erie County,365,100,66,20,14,19,0,0,0,0,346,100,66,20,14,1130,71,1059
360290107001,36, New York,029, Erie County,290,139,102,10,27,27,27,0,0,27,263,112,102,10,0,970,68,902
360290107002,36, New York,029, Erie County,165,45,19,0,26,40,0,0,0,0,125,45,19,0,26,426,129,297
360290107003,36, New York,029, Erie County,214,40,40,0,0,0,0,0,0,0,214,40,40,0,0,604,9,595
360290108031,36, New York,029, Erie County,296,112,76,6,30,31,31,11,6,14,265,81,65,0,16,961,70,891
360290108032,36, New York,029, Erie County,121,35,20,10,5,5,5,0,0,5,116,30,20,10,0,417,27,390
360290108041,36, New York,029, Erie County,534,147,118,0,29,10,0,0,0,0,524,147,118,0,29,1648,118,1530
360290108042,36, New York,029, Erie County,220,104,97,0,7,0,0,0,0,0,220,104,97,0,7,739,13,726
360290108043,36, New York,029, Erie County,350,100,79,21,0,8,8,8,0,0,342,92,71,21,0,1385,102,1283
360290108051,36, New York,029, Erie County,513,135,135,0,0,0,0,0,0,0,513,135,135,0,0,1369,27,1342
360290108052,36, New York,029, Erie County,272,124,124,0,0,32,32,32,0,0,240,92,92,0,0,804,116,688
360290108053,36, New York,029, Erie County,527,245,180,16,49,29,14,14,0,0,498,231,166,16,49,1556,77,1479
360290108071,36, New York,029, Erie County,455,243,128,0,115,40,0,0,0,0,415,243,128,0,115,1260,140,1120
360290108072,36, New York,029, Erie County,179,71,71,0,0,0,0,0,0,0,179,71,71,0,0,703,50,653
360290108073,36, New York,029, Erie County,154,17,17,0,0,0,0,0,0,0,154,17,17,0,0,905,15,890
360290108074,36, New York,029, Erie County,374,214,149,52,13,15,15,15,0,0,359,199,134,52,13,1192,75,1117
360290108081,36, New York,029, Erie County,551,289,244,45,0,71,71,26,45,0,480,218,218,0,0,1608,224,1384
360290108082,36, New York,029, Erie County,207,105,55,0,50,0,0,0,0,0,207,105,55,0,50,540,32,508
360290108083,36, New York,029, Erie County,266,22,0,9,13,0,0,0,0,0,266,22,0,9,13,902,61,841
360290108091,36, New York,029, Erie County,407,130,102,9,19,0,0,0,0,0,407,130,102,9,19,1098,56,1042
360290108092,36, New York,029, Erie County,526,102,86,5,11,10,0,0,0,0,516,102,86,5,11,1362,19,1343
360290109011,36, New York,029, Erie County,154,55,55,0,0,0,0,0,0,0,154,55,55,0,0,600,0,600
360290109012,36, New York,029, Erie County,199,21,7,7,7,7,7,0,0,7,192,14,7,7,0,692,13,679
360290109013,36, New York,029, Erie County,144,73,33,0,40,10,10,0,0,10,134,63,33,0,30,721,68,653
360290109021,36, New York,029, Erie County,180,112,6,90,16,0,0,0,0,0,180,112,6,90,16,617,13,604
360290109022,36, New York,029, Erie County,331,7,7,0,0,1,1,1,0,0,330,6,6,0,0,1419,63,1356
360290109023,36, New York,029, Erie County,259,75,58,17,0,0,0,0,0,0,259,75,58,17,0,834,39,795
360290109024,36, New York,029, Erie County,257,36,36,0,0,0,0,0,0,0,257,36,36,0,0,757,0,757
360290110001,36, New York,029, Erie County,127,39,11,6,22,7,7,0,0,7,120,32,11,6,15,453,13,440
360290110002,36, New York,029, Erie County,351,160,86,0,74,27,27,27,0,0,324,133,59,0,74,1063,196,867
360290111001,36, New York,029, Erie County,359,156,76,69,11,34,22,9,13,0,325,134,67,56,11,1129,91,1038
360290111002,36, New York,029, Erie County,191,84,84,0,0,7,0,0,0,0,184,84,84,0,0,574,22,552
360290112011,36, New York,029, Erie County,533,209,190,0,19,0,0,0,0,0,533,209,190,0,19,1622,12,1610
360290112021,36, New York,029, Erie County,175,43,43,0,0,0,0,0,0,0,175,43,43,0,0,525,0,525
360290112022,36, New York,029, Erie County,238,128,97,14,17,17,17,0,0,17,221,111,97,14,0,699,87,612
360290112023,36, New York,029, Erie County,618,322,296,11,15,28,12,12,0,0,590,310,284,11,15,1731,91,1640
360290112024,36, New York,029, Erie County,143,36,36,0,0,0,0,0,0,0,143,36,36,0,0,886,172,714
360290113001,36, New York,029, Erie County,226,0,0,0,0,0,0,0,0,0,226,0,0,0,0,661,16,645
360290113002,36, New York,029, Erie County,555,214,65,0,149,0,0,0,0,0,555,214,65,0,149,1532,115,1417
360290113003,36, New York,029, Erie County,80,0,0,0,0,0,0,0,0,0,80,0,0,0,0,401,107,294
360290113004,36, New York,029, Erie County,220,109,68,0,41,0,0,0,0,0,220,109,68,0,41,1111,39,1072
360290114001,36, New York,029, Erie County,305,197,57,0,140,0,0,0,0,0,305,197,57,0,140,726,36,690
360290114002,36, New York,029, Erie County,297,159,58,0,101,11,5,0,0,5,286,154,58,0,96,1182,239,943
360290115001,36, New York,029, Erie County,216,51,13,6,32,5,0,0,0,0,211,51,13,6,32,614,43,571
360290115002,36, New York,029, Erie County,157,52,20,23,9,0,0,0,0,0,157,52,20,23,9,540,37,503
360290116001,36, New York,029, Erie County,265,134,79,18,37,9,9,0,0,9,256,125,79,18,28,1099,99,1000
360290116002,36, New York,029, Erie County,176,83,68,8,7,0,0,0,0,0,176,83,68,8,7,452,0,452
360290117001,36, New York,029, Erie County,113,23,15,8,0,15,0,0,0,0,98,23,15,8,0,490,80,410
360290117002,36, New York,029, Erie County,268,147,79,0,68,10,10,0,0,10,258,137,79,0,58,861,89,772
360290117003,36, New York,029, Erie County,625,273,115,132,26,12,12,0,0,12,613,261,115,132,14,1823,66,1757
360290118001,36, New York,029, Erie County,204,61,31,23,7,11,11,11,0,0,193,50,20,23,7,754,99,655
360290118002,36, New York,029, Erie County,278,117,117,0,0,36,22,22,0,0,242,95,95,0,0,758,89,669
360290118003,36, New York,029, Erie County,561,306,183,43,80,26,26,18,0,8,535,280,165,43,72,1482,153,1329
360290120011,36, New York,029, Erie County,414,159,108,22,29,8,0,0,0,0,406,159,108,22,29,1125,53,1072
360290120012,36, New York,029, Erie County,670,335,150,6,179,131,112,0,0,112,539,223,150,6,67,1857,470,1387
360290120013,36, New York,029, Erie County,245,107,107,0,0,0,0,0,0,0,245,107,107,0,0,751,53,698
360290120021,36, New York,029, Erie County,216,61,61,0,0,0,0,0,0,0,216,61,61,0,0,881,21,860
360290120022,36, New York,029, Erie County,367,138,138,0,0,0,0,0,0,0,367,138,138,0,0,998,19,979
360290120023,36, New York,029, Erie County,413,139,98,0,41,13,0,0,0,0,400,139,98,0,41,1137,43,1094
360290120031,36, New York,029, Erie County,400,147,133,14,0,20,20,20,0,0,380,127,113,14,0,1395,76,1319
360290120032,36, New York,029, Erie County,336,88,67,0,21,0,0,0,0,0,336,88,67,0,21,715,0,715
360290120033,36, New York,029, Erie County,762,361,349,0,12,0,0,0,0,0,762,361,349,0,12,2015,73,1942
360290123001,36, New York,029, Erie County,155,51,39,0,12,51,51,39,0,12,104,0,0,0,0,602,129,473
360290123002,36, New York,029, Erie County,284,115,53,19,43,43,43,12,0,31,241,72,41,19,12,934,190,744
360290123003,36, New York,029, Erie County,133,133,62,0,71,96,96,56,0,40,37,37,6,0,31,528,229,299
360290123004,36, New York,029, Erie County,177,52,28,0,24,6,6,6,0,0,171,46,22,0,24,883,239,644
360290124001,36, New York,029, Erie County,120,57,45,0,12,0,0,0,0,0,120,57,45,0,12,492,14,478
360290124002,36, New York,029, Erie County,337,194,57,63,74,118,114,0,56,58,219,80,57,7,16,1285,197,1088
360290125011,36, New York,029, Erie County,206,16,0,16,0,0,0,0,0,0,206,16,0,16,0,790,157,633
360290125012,36, New York,029, Erie County,163,45,45,0,0,0,0,0,0,0,163,45,45,0,0,488,0,488
360290125013,36, New York,029, Erie County,346,233,200,0,33,0,0,0,0,0,346,233,200,0,33,1386,162,1224
360290125014,36, New York,029, Erie County,157,82,48,34,0,26,26,26,0,0,131,56,22,34,0,496,176,320
360290125015,36, New York,029, Erie County,143,7,7,0,0,16,0,0,0,0,127,7,7,0,0,459,107,352
360290125021,36, New York,029, Erie County,368,203,129,12,62,14,9,2,0,7,354,194,127,12,55,969,97,872
360290125022,36, New York,029, Erie County,279,64,21,33,10,7,0,0,0,0,272,64,21,33,10,870,80,790
360290128001,36, New York,029, Erie County,250,113,88,9,16,4,4,0,0,4,246,109,88,9,12,778,66,712
360290128002,36, New York,029, Erie County,125,69,24,34,11,11,5,5,0,0,114,64,19,34,11,488,123,365
360290128003,36, New York,029, Erie County,244,87,28,25,34,56,38,14,2,22,188,49,14,23,12,764,110,654
360290129021,36, New York,029, Erie County,552,214,133,57,24,6,0,0,0,0,546,214,133,57,24,1415,34,1381
360290129022,36, New York,029, Erie County,423,211,112,12,87,23,0,0,0,0,400,211,112,12,87,1757,368,1389
360290129023,36, New York,029, Erie County,104,15,15,0,0,0,0,0,0,0,104,15,15,0,0,528,89,439
360290129031,36, New York,029, Erie County,595,176,87,37,52,67,52,0,0,52,528,124,87,37,0,1893,129,1764
360290129032,36, New York,029, Erie County,137,56,43,13,0,0,0,0,0,0,137,56,43,13,0,521,31,490
360290129041,36, New York,029, Erie County,687,295,85,0,210,101,92,0,0,92,586,203,85,0,118,1617,197,1420
360290129042,36, New York,029, Erie County,162,63,32,0,31,34,16,0,0,16,128,47,32,0,15,468,53,415
360290129043,36, New York,029, Erie County,333,26,13,0,13,58,0,0,0,0,275,26,13,0,13,1039,167,872
360290130011,36, New York,029, Erie County,302,122,84,0,38,38,38,0,0,38,264,84,84,0,0,1105,134,971
360290130012,36, New York,029, Erie County,195,31,11,0,20,0,0,0,0,0,195,31,11,0,20,559,63,496
360290130013,36, New York,029, Erie County,101,12,0,0,12,12,12,0,0,12,89,0,0,0,0,330,29,301
360290130014,36, New York,029, Erie County,211,29,29,0,0,0,0,0,0,0,211,29,29,0,0,594,6,588
360290130021,36, New York,029, Erie County,187,79,67,0,12,0,0,0,0,0,187,79,67,0,12,869,99,770
360290130022,36, New York,029, Erie County,332,117,37,0,80,15,0,0,0,0,317,117,37,0,80,1172,96,1076
360290130023,36, New York,029, Erie County,337,109,101,0,8,0,0,0,0,0,337,109,101,0,8,907,2,905
360290130024,36, New York,029, Erie County,580,262,45,120,97,27,27,0,27,0,553,235,45,93,97,1480,111,1369
360290131011,36, New York,029, Erie County,485,189,157,0,32,0,0,0,0,0,485,189,157,0,32,1234,0,1234
360290131012,36, New York,029, Erie County,199,70,29,41,0,0,0,0,0,0,199,70,29,41,0,636,0,636
360290131013,36, New York,029, Erie County,309,190,88,87,15,0,0,0,0,0,309,190,88,87,15,891,103,788
360290131014,36, New York,029, Erie County,180,45,45,0,0,0,0,0,0,0,180,45,45,0,0,441,27,414
360290131015,36, New York,029, Erie County,390,219,90,0,129,56,56,0,0,56,334,163,90,0,73,932,104,828
360290131016,36, New York,029, Erie County,322,78,68,0,10,10,10,0,0,10,312,68,68,0,0,1111,44,1067
360290131031,36, New York,029, Erie County,462,207,145,23,39,21,0,0,0,0,441,207,145,23,39,937,50,887
360290131032,36, New York,029, Erie County,960,548,506,11,31,34,34,34,0,0,926,514,472,11,31,2330,99,2231
360290131041,36, New York,029, Erie County,580,247,247,0,0,32,0,0,0,0,548,247,247,0,0,1655,111,1544
360290131042,36, New York,029, Erie County,288,86,46,17,23,0,0,0,0,0,288,86,46,17,23,773,42,731
360290131043,36, New York,029, Erie County,335,136,136,0,0,0,0,0,0,0,335,136,136,0,0,1027,10,1017
360290132011,36, New York,029, Erie County,616,310,134,65,111,44,27,0,0,27,572,283,134,65,84,1727,177,1550
360290132012,36, New York,029, Erie County,409,99,20,0,79,0,0,0,0,0,409,99,20,0,79,910,18,892
360290132013,36, New York,029, Erie County,212,95,95,0,0,0,0,0,0,0,212,95,95,0,0,510,0,510
360290132014,36, New York,029, Erie County,683,318,271,0,47,11,0,0,0,0,672,318,271,0,47,1769,81,1688
360290132021,36, New York,029, Erie County,427,143,91,0,52,0,0,0,0,0,427,143,91,0,52,1682,49,1633
360290132022,36, New York,029, Erie County,408,145,84,29,32,0,0,0,0,0,408,145,84,29,32,998,15,983
360290132023,36, New York,029, Erie County,531,233,225,0,8,0,0,0,0,0,531,233,225,0,8,1466,30,1436
360290133001,36, New York,029, Erie County,368,148,123,17,8,23,0,0,0,0,345,148,123,17,8,1112,106,1006
360290133002,36, New York,029, Erie County,261,67,28,0,39,0,0,0,0,0,261,67,28,0,39,822,39,783
360290133003,36, New York,029, Erie County,372,163,79,9,75,5,5,0,0,5,367,158,79,9,70,1040,39,1001
360290134001,36, New York,029, Erie County,113,24,18,0,6,0,0,0,0,0,113,24,18,0,6,309,0,309
360290134002,36, New York,029, Erie County,174,55,55,0,0,0,0,0,0,0,174,55,55,0,0,502,0,502
360290134003,36, New York,029, Erie County,233,95,73,0,22,0,0,0,0,0,233,95,73,0,22,717,32,685
360290134004,36, New York,029, Erie County,480,180,117,45,18,18,18,0,0,18,462,162,117,45,0,1246,43,1203
360290134005,36, New York,029, Erie County,191,26,26,0,0,0,0,0,0,0,191,26,26,0,0,883,68,815
360290134006,36, New York,029, Erie County,716,342,264,0,78,14,14,0,0,14,702,328,264,0,64,1669,124,1545
360290135011,36, New York,029, Erie County,262,130,105,10,15,0,0,0,0,0,262,130,105,10,15,706,33,673
360290135012,36, New York,029, Erie County,277,79,79,0,0,0,0,0,0,0,277,79,79,0,0,811,23,788
360290135013,36, New York,029, Erie County,560,241,153,73,15,63,63,0,63,0,497,178,153,10,15,1601,176,1425
360290135014,36, New York,029, Erie County,414,162,131,21,10,12,0,0,0,0,402,162,131,21,10,1332,65,1267
360290135015,36, New York,029, Erie County,251,76,46,0,30,0,0,0,0,0,251,76,46,0,30,835,52,783
360290135021,36, New York,029, Erie County,555,211,196,0,15,16,16,16,0,0,539,195,180,0,15,1377,52,1325
360290135022,36, New York,029, Erie County,549,289,238,36,15,18,0,0,0,0,531,289,238,36,15,1295,71,1224
360290135023,36, New York,029, Erie County,742,274,160,114,0,198,0,0,0,0,544,274,160,114,0,1718,423,1295
360290135024,36, New York,029, Erie County,331,105,83,22,0,0,0,0,0,0,331,105,83,22,0,802,0,802
360290136001,36, New York,029, Erie County,359,151,92,8,51,8,8,0,8,0,351,143,92,0,51,1105,204,901
360290136002,36, New York,029, Erie County,278,162,117,13,32,0,0,0,0,0,278,162,117,13,32,824,28,796
360290136003,36, New York,029, Erie County,122,68,44,24,0,24,24,0,24,0,98,44,44,0,0,455,43,412
360290137011,36, New York,029, Erie County,241,58,58,0,0,0,0,0,0,0,241,58,58,0,0,989,15,974
360290137012,36, New York,029, Erie County,532,262,211,0,51,16,16,0,0,16,516,246,211,0,35,1750,175,1575
360290137013,36, New York,029, Erie County,170,50,0,37,13,20,0,0,0,0,150,50,0,37,13,644,122,522
360290137014,36, New York,029, Erie County,657,265,167,0,98,12,12,0,0,12,645,253,167,0,86,1800,79,1721
360290137021,36, New York,029, Erie County,1151,284,211,14,59,21,13,0,0,13,1130,271,211,14,46,2875,94,2781
360290137022,36, New York,029, Erie County,522,176,162,0,14,0,0,0,0,0,522,176,162,0,14,1695,70,1625
360290137023,36, New York,029, Erie County,185,39,39,0,0,0,0,0,0,0,185,39,39,0,0,623,37,586
360290138011,36, New York,029, Erie County,161,99,99,0,0,0,0,0,0,0,161,99,99,0,0,427,6,421
360290138012,36, New York,029, Erie County,568,137,108,9,20,0,0,0,0,0,568,137,108,9,20,1391,0,1391
360290138021,36, New York,029, Erie County,524,127,77,15,35,0,0,0,0,0,524,127,77,15,35,1217,41,1176
360290138022,36, New York,029, Erie County,240,57,34,23,0,0,0,0,0,0,240,57,34,23,0,899,97,802
360290138023,36, New York,029, Erie County,173,55,55,0,0,0,0,0,0,0,173,55,55,0,0,447,5,442
360290138024,36, New York,029, Erie County,363,128,128,0,0,0,0,0,0,0,363,128,128,0,0,952,0,952
360290138025,36, New York,029, Erie County,394,155,123,32,0,0,0,0,0,0,394,155,123,32,0,988,22,966
360290139001,36, New York,029, Erie County,682,285,193,16,76,16,11,0,0,11,666,274,193,16,65,1800,47,1753
360290140001,36, New York,029, Erie County,452,178,162,0,16,0,0,0,0,0,452,178,162,0,16,1254,39,1215
360290140002,36, New York,029, Erie County,498,230,142,59,29,0,0,0,0,0,498,230,142,59,29,1343,15,1328
360290141011,36, New York,029, Erie County,410,185,185,0,0,0,0,0,0,0,410,185,185,0,0,1218,41,1177
360290141012,36, New York,029, Erie County,562,183,98,26,59,0,0,0,0,0,562,183,98,26,59,1585,0,1585
360290141013,36, New York,029, Erie County,822,357,343,14,0,42,15,15,0,0,780,342,328,14,0,2121,80,2041
360290141021,36, New York,029, Erie County,568,158,108,35,15,35,22,0,22,0,533,136,108,13,15,1817,86,1731
360290141022,36, New York,029, Erie County,532,223,160,56,7,0,0,0,0,0,532,223,160,56,7,1314,30,1284
360290141023,36, New York,029, Erie County,385,170,129,15,26,26,26,0,0,26,359,144,129,15,0,1091,41,1050
360290142041,36, New York,029, Erie County,368,81,63,0,18,0,0,0,0,0,368,81,63,0,18,1060,63,997
360290142042,36, New York,029, Erie County,354,144,95,34,15,15,15,0,0,15,339,129,95,34,0,1324,63,1261
360290142043,36, New York,029, Erie County,247,121,85,22,14,15,0,0,0,0,232,121,85,22,14,886,66,820
360290142061,36, New York,029, Erie County,647,247,217,30,0,0,0,0,0,0,647,247,217,30,0,1608,0,1608
360290142062,36, New York,029, Erie County,576,247,223,0,24,14,0,0,0,0,562,247,223,0,24,1485,47,1438
360290142063,36, New York,029, Erie County,576,278,278,0,0,0,0,0,0,0,576,278,278,0,0,1327,0,1327
360290142064,36, New York,029, Erie County,639,288,260,28,0,0,0,0,0,0,639,288,260,28,0,1450,0,1450
360290142071,36, New York,029, Erie County,332,87,87,0,0,0,0,0,0,0,332,87,87,0,0,998,0,998
360290142072,36, New York,029, Erie County,386,124,124,0,0,0,0,0,0,0,386,124,124,0,0,969,0,969
360290142073,36, New York,029, Erie County,199,112,34,0,78,0,0,0,0,0,199,112,34,0,78,904,112,792
360290142074,36, New York,029, Erie County,498,157,132,0,25,16,0,0,0,0,482,157,132,0,25,1513,168,1345
360290142081,36, New York,029, Erie County,345,86,35,21,30,30,30,0,0,30,315,56,35,21,0,1155,87,1068
360290142082,36, New York,029, Erie County,568,191,158,14,19,14,0,0,0,0,554,191,158,14,19,1608,117,1491
360290142083,36, New York,029, Erie County,779,376,323,18,35,12,0,0,0,0,767,376,323,18,35,2274,68,2206
360290142091,36, New York,029, Erie County,520,222,221,0,1,1,1,0,0,1,519,221,221,0,0,1608,46,1562
360290142092,36, New York,029, Erie County,490,217,129,10,78,17,0,0,0,0,473,217,129,10,78,1236,58,1178
360290142093,36, New York,029, Erie County,336,56,46,0,10,0,0,0,0,0,336,56,46,0,10,963,0,963
360290143001,36, New York,029, Erie County,564,148,148,0,0,0,0,0,0,0,564,148,148,0,0,1563,54,1509
360290143002,36, New York,029, Erie County,272,120,92,0,28,0,0,0,0,0,272,120,92,0,28,969,9,960
360290143003,36, New York,029, Erie County,291,84,53,0,31,0,0,0,0,0,291,84,53,0,31,887,0,887
360290143004,36, New York,029, Erie County,85,61,9,52,0,0,0,0,0,0,85,61,9,52,0,509,52,457
360290143005,36, New York,029, Erie County,335,225,57,75,93,0,0,0,0,0,335,225,57,75,93,955,72,883
360290144001,36, New York,029, Erie County,442,146,97,0,49,11,11,0,0,11,431,135,97,0,38,1389,120,1269
360290144002,36, New York,029, Erie County,241,171,71,22,78,23,23,0,0,23,218,148,71,22,55,1029,108,921
360290144003,36, New York,029, Erie County,374,224,179,4,41,32,32,0,0,32,342,192,179,4,9,1049,72,977
360290145011,36, New York,029, Erie County,603,239,155,52,32,17,11,0,0,11,586,228,155,52,21,1781,75,1706
360290145012,36, New York,029, Erie County,400,121,37,0,84,30,30,0,0,30,370,91,37,0,54,1365,30,1335
360290145021,36, New York,029, Erie County,184,162,62,0,100,0,0,0,0,0,184,162,62,0,100,530,82,448
360290145022,36, New York,029, Erie County,288,62,38,24,0,0,0,0,0,0,288,62,38,24,0,1192,113,1079
360290146011,36, New York,029, Erie County,236,61,61,0,0,36,0,0,0,0,200,61,61,0,0,725,124,601
360290146012,36, New York,029, Erie County,646,403,384,0,19,45,45,45,0,0,601,358,339,0,19,1718,133,1585
360290146013,36, New York,029, Erie County,258,66,29,0,37,48,0,0,0,0,210,66,29,0,37,701,110,591
360290146014,36, New York,029, Erie County,339,159,159,0,0,36,0,0,0,0,303,159,159,0,0,944,137,807
360290146031,36, New York,029, Erie County,809,307,239,0,68,35,28,0,0,28,774,279,239,0,40,2368,124,2244
360290146032,36, New York,029, Erie County,265,116,84,32,0,0,0,0,0,0,265,116,84,32,0,702,7,695
360290146033,36, New York,029, Erie County,192,58,38,0,20,0,0,0,0,0,192,58,38,0,20,539,9,530
360290146051,36, New York,029, Erie County,829,360,334,18,8,89,12,4,0,8,740,348,330,18,0,2112,147,1965
360290146052,36, New York,029, Erie County,336,113,93,0,20,19,19,19,0,0,317,94,74,0,20,720,57,663
360290146061,36, New York,029, Erie County,667,348,348,0,0,15,0,0,0,0,652,348,348,0,0,1795,39,1756
360290146062,36, New York,029, Erie County,478,171,157,0,14,6,0,0,0,0,472,171,157,0,14,1231,21,1210
360290147011,36, New York,029, Erie County,373,153,153,0,0,0,0,0,0,0,373,153,153,0,0,745,0,745
360290147012,36, New York,029, Erie County,510,143,143,0,0,0,0,0,0,0,510,143,143,0,0,1497,29,1468
360290147013,36, New York,029, Erie County,404,93,93,0,0,28,0,0,0,0,376,93,93,0,0,1254,105,1149
360290147014,36, New York,029, Erie County,433,68,68,0,0,0,0,0,0,0,433,68,68,0,0,1123,18,1105
360290147031,36, New York,029, Erie County,638,314,314,0,0,67,67,67,0,0,571,247,247,0,0,1662,234,1428
360290147032,36, New York,029, Erie County,160,104,0,87,17,17,17,0,0,17,143,87,0,87,0,459,31,428
360290147033,36, New York,029, Erie County,622,334,302,0,32,0,0,0,0,0,622,334,302,0,32,1584,10,1574
360290147041,36, New York,029, Erie County,287,64,29,15,20,0,0,0,0,0,287,64,29,15,20,806,40,766
360290147042,36, New York,029, Erie County,348,80,66,0,14,26,0,0,0,0,322,80,66,0,14,1152,111,1041
360290147043,36, New York,029, Erie County,388,93,67,14,12,0,0,0,0,0,388,93,67,14,12,1417,34,1383
360290148011,36, New York,029, Erie County,285,72,53,10,9,7,0,0,0,0,278,72,53,10,9,817,68,749
360290148012,36, New York,029, Erie County,372,188,42,64,82,7,7,0,0,7,365,181,42,64,75,1225,100,1125
360290148041,36, New York,029, Erie County,251,106,93,13,0,10,10,10,0,0,241,96,83,13,0,744,121,623
360290148042,36, New York,029, Erie County,280,118,86,23,9,0,0,0,0,0,280,118,86,23,9,745,9,736
360290148043,36, New York,029, Erie County,502,164,142,0,22,22,22,0,0,22,480,142,142,0,0,1559,150,1409
360290148051,36, New York,029, Erie County,286,83,70,0,13,0,0,0,0,0,286,83,70,0,13,714,36,678
360290148052,36, New York,029, Erie County,435,149,133,0,16,4,0,0,0,0,431,149,133,0,16,1091,16,1075
360290149011,36, New York,029, Erie County,426,172,154,13,5,3,0,0,0,0,423,172,154,13,5,1325,33,1292
360290149012,36, New York,029, Erie County,238,120,85,19,16,12,12,0,0,12,226,108,85,19,4,743,91,652
360290149031,36, New York,029, Erie County,369,122,106,0,16,0,0,0,0,0,369,122,106,0,16,1055,27,1028
360290149032,36, New York,029, Erie County,211,56,56,0,0,0,0,0,0,0,211,56,56,0,0,507,0,507
360290149033,36, New York,029, Erie County,295,145,145,0,0,16,0,0,0,0,279,145,145,0,0,723,32,691
360290149034,36, New York,029, Erie County,525,193,178,0,15,0,0,0,0,0,525,193,178,0,15,1345,0,1345
360290149035,36, New York,029, Erie County,346,139,52,71,16,56,16,0,0,16,290,123,52,71,0,950,212,738
360290150011,36, New York,029, Erie County,377,86,56,0,30,22,22,22,0,0,355,64,34,0,30,1165,67,1098
360290150012,36, New York,029, Erie County,892,354,335,0,19,0,0,0,0,0,892,354,335,0,19,2301,19,2282
360290150013,36, New York,029, Erie County,226,39,39,0,0,19,0,0,0,0,207,39,39,0,0,896,40,856
360290150021,36, New York,029, Erie County,628,187,187,0,0,0,0,0,0,0,628,187,187,0,0,1751,25,1726
360290150022,36, New York,029, Erie County,193,114,58,31,25,0,0,0,0,0,193,114,58,31,25,481,23,458
360290150031,36, New York,029, Erie County,553,168,124,9,35,10,0,0,0,0,543,168,124,9,35,1683,19,1664
360290150032,36, New York,029, Erie County,279,163,89,13,61,67,41,0,0,41,212,122,89,13,20,902,188,714
360290151011,36, New York,029, Erie County,481,219,188,0,31,8,0,0,0,0,473,219,188,0,31,1264,22,1242
360290151012,36, New York,029, Erie County,255,97,52,0,45,44,0,0,0,0,211,97,52,0,45,565,132,433
360290151013,36, New York,029, Erie County,251,78,78,0,0,22,13,13,0,0,229,65,65,0,0,621,51,570
360290151021,36, New York,029, Erie County,437,201,146,27,28,5,0,0,0,0,432,201,146,27,28,1233,74,1159
360290151022,36, New York,029, Erie County,264,55,45,5,5,5,0,0,0,0,259,55,45,5,5,946,131,815
360290152011,36, New York,029, Erie County,339,58,58,0,0,30,0,0,0,0,309,58,58,0,0,922,106,816
360290152012,36, New York,029, Erie County,582,188,125,48,15,15,0,0,0,0,567,188,125,48,15,1739,123,1616
360290152021,36, New York,029, Erie County,443,99,71,28,0,17,0,0,0,0,426,99,71,28,0,1120,57,1063
360290152022,36, New York,029, Erie County,360,91,19,0,72,27,27,0,0,27,333,64,19,0,45,1251,143,1108
360290152023,36, New York,029, Erie County,632,160,133,8,19,0,0,0,0,0,632,160,133,8,19,1547,22,1525
360290153011,36, New York,029, Erie County,305,177,85,27,65,7,0,0,0,0,298,177,85,27,65,880,49,831
360290153012,36, New York,029, Erie County,357,125,81,0,44,6,6,6,0,0,351,119,75,0,44,1081,39,1042
360290153013,36, New York,029, Erie County,608,208,152,23,33,27,27,18,0,9,581,181,134,23,24,1487,124,1363
360290153021,36, New York,029, Erie County,221,49,41,0,8,0,0,0,0,0,221,49,41,0,8,687,0,687
360290153022,36, New York,029, Erie County,323,112,112,0,0,0,0,0,0,0,323,112,112,0,0,923,18,905
360290153023,36, New York,029, Erie County,304,137,68,15,54,93,89,35,0,54,211,48,33,15,0,799,136,663
360290154011,36, New York,029, Erie County,352,156,133,14,9,24,0,0,0,0,328,156,133,14,9,972,55,917
360290154012,36, New York,029, Erie County,238,30,30,0,0,0,0,0,0,0,238,30,30,0,0,1400,436,964
360290154021,36, New York,029, Erie County,451,175,125,0,50,0,0,0,0,0,451,175,125,0,50,1456,58,1398
360290154022,36, New York,029, Erie County,96,67,20,21,26,0,0,0,0,0,96,67,20,21,26,345,24,321
360290154023,36, New York,029, Erie County,352,92,41,0,51,18,18,0,0,18,334,74,41,0,33,952,47,905
360290154024,36, New York,029, Erie County,334,92,80,0,12,17,0,0,0,0,317,92,80,0,12,1093,169,924
360290155011,36, New York,029, Erie County,723,431,207,54,170,49,20,6,0,14,674,411,201,54,156,1969,210,1759
360290155031,36, New York,029, Erie County,376,153,69,41,43,39,39,0,31,8,337,114,69,10,35,880,74,806
360290155032,36, New York,029, Erie County,238,64,38,16,10,43,35,9,16,10,195,29,29,0,0,896,186,710
360290155041,36, New York,029, Erie County,243,112,67,23,22,51,23,9,0,14,192,89,58,23,8,744,210,534
360290155042,36, New York,029, Erie County,220,103,29,0,74,9,0,0,0,0,211,103,29,0,74,771,175,596
360290155043,36, New York,029, Erie County,110,69,34,35,0,0,0,0,0,0,110,69,34,35,0,325,16,309
360290155044,36, New York,029, Erie County,349,74,64,10,0,24,0,0,0,0,325,74,64,10,0,866,54,812
360290156001,36, New York,029, Erie County,395,109,64,35,10,20,9,0,5,4,375,100,64,30,6,1105,136,969
360290156002,36, New York,029, Erie County,267,107,70,0,37,35,30,0,0,30,232,77,70,0,7,699,92,607
360290157001,36, New York,029, Erie County,304,83,67,0,16,25,15,15,0,0,279,68,52,0,16,956,76,880
360290157002,36, New York,029, Erie County,216,156,145,0,11,0,0,0,0,0,216,156,145,0,11,611,9,602
360290157003,36, New York,029, Erie County,144,70,50,10,10,14,14,11,0,3,130,56,39,10,7,404,43,361
360290157004,36, New York,029, Erie County,218,134,91,14,29,37,15,2,0,13,181,119,89,14,16,750,148,602
360290158001,36, New York,029, Erie County,503,195,156,19,20,6,0,0,0,0,497,195,156,19,20,1447,117,1330
360290158002,36, New York,029, Erie County,92,19,0,9,10,0,0,0,0,0,92,19,0,9,10,317,39,278
360290158003,36, New York,029, Erie County,515,225,164,14,47,27,27,0,0,27,488,198,164,14,20,1539,52,1487
360290159001,36, New York,029, Erie County,677,314,190,22,102,88,88,38,0,50,589,226,152,22,52,1575,268,1307
360290159002,36, New York,029, Erie County,476,185,97,20,68,24,3,0,0,3,452,182,97,20,65,1543,140,1403
360290162001,36, New York,029, Erie County,322,175,137,0,38,40,30,30,0,0,282,145,107,0,38,863,127,736
360290162002,36, New York,029, Erie County,394,75,51,0,24,33,33,16,0,17,361,42,35,0,7,1085,84,1001
360290163001,36, New York,029, Erie County,158,84,13,0,71,94,71,0,0,71,64,13,13,0,0,495,225,270
360290163002,36, New York,029, Erie County,110,63,26,0,37,11,11,0,0,11,99,52,26,0,26,403,71,332
360290163003,36, New York,029, Erie County,220,68,32,12,24,43,24,0,12,12,177,44,32,0,12,747,110,637
360290164001,36, New York,029, Erie County,41,23,20,0,3,0,0,0,0,0,41,23,20,0,3,556,263,293
360290164002,36, New York,029, Erie County,165,0,0,0,0,0,0,0,0,0,165,0,0,0,0,588,60,528
360290164003,36, New York,029, Erie County,288,115,13,0,102,53,53,0,0,53,235,62,13,0,49,906,174,732
360290164004,36, New York,029, Erie County,166,63,0,0,63,57,53,0,0,53,109,10,0,0,10,738,236,502
360290164005,36, New York,029, Erie County,18,0,0,0,0,0,0,0,0,0,18,0,0,0,0,82,33,49
360290165001,36, New York,029, Erie County,194,51,28,7,16,16,16,0,0,16,178,35,28,7,0,944,149,795
360290165002,36, New York,029, Erie County,31,8,0,8,0,0,0,0,0,0,31,8,0,8,0,591,199,392
360290166001,36, New York,029, Erie County,177,136,68,0,68,68,68,0,0,68,109,68,68,0,0,551,68,483
360290166002,36, New York,029, Erie County,49,35,0,0,35,1,0,0,0,0,48,35,0,0,35,215,118,97
360290166003,36, New York,029, Erie County,100,48,0,0,48,43,21,0,0,21,57,27,0,0,27,683,263,420
360290166004,36, New York,029, Erie County,124,67,0,0,67,0,0,0,0,0,124,67,0,0,67,420,19,401
360290167001,36, New York,029, Erie County,163,64,0,18,46,28,0,0,0,0,135,64,0,18,46,545,79,466
360290167002,36, New York,029, Erie County,190,113,0,99,14,113,113,0,99,14,77,0,0,0,0,512,160,352
360290167003,36, New York,029, Erie County,165,95,0,0,95,95,75,0,0,75,70,20,0,0,20,699,281,418
360290168011,36, New York,029, Erie County,217,127,49,0,78,32,32,32,0,0,185,95,17,0,78,849,130,719
360290168012,36, New York,029, Erie County,167,89,77,0,12,37,0,0,0,0,130,89,77,0,12,557,173,384
360290168021,36, New York,029, Erie County,306,123,56,0,67,35,35,0,0,35,271,88,56,0,32,1064,81,983
360290168022,36, New York,029, Erie County,166,55,11,0,44,25,25,0,0,25,141,30,11,0,19,580,98,482
360290169001,36, New York,029, Erie County,312,170,170,0,0,11,11,11,0,0,301,159,159,0,0,1066,83,983
360290169002,36, New York,029, Erie County,231,56,30,0,26,0,0,0,0,0,231,56,30,0,26,818,40,778
360290169003,36, New York,029, Erie County,141,51,10,0,41,34,34,0,0,34,107,17,10,0,7,675,150,525
360290169004,36, New York,029, Erie County,56,12,12,0,0,0,0,0,0,0,56,12,12,0,0,519,122,397
360290170001,36, New York,029, Erie County,308,67,0,0,67,0,0,0,0,0,308,67,0,0,67,791,42,749
360290170002,36, New York,029, Erie County,311,139,0,0,139,66,66,0,0,66,245,73,0,0,73,1063,259,804
360290170003,36, New York,029, Erie County,80,13,0,0,13,51,0,0,0,0,29,13,0,0,13,258,103,155
360290171001,36, New York,029, Erie County,167,61,0,11,50,76,61,0,11,50,91,0,0,0,0,512,167,345
360290171002,36, New York,029, Erie County,262,170,126,0,44,130,91,84,0,7,132,79,42,0,37,644,141,503
360290171003,36, New York,029, Erie County,75,67,0,28,39,12,12,0,0,12,63,55,0,28,27,397,116,281
360290171004,36, New York,029, Erie County,91,64,64,0,0,0,0,0,0,0,91,64,64,0,0,351,47,304
360290171005,36, New York,029, Erie County,140,93,33,0,60,57,57,0,0,57,83,36,33,0,3,593,297,296
360290172001,36, New York,029, Erie County,202,147,107,0,40,15,15,0,0,15,187,132,107,0,25,741,71,670
360290172002,36, New York,029, Erie County,55,28,13,0,15,0,0,0,0,0,55,28,13,0,15,345,92,253
360290172003,36, New York,029, Erie County,178,112,79,0,33,33,33,0,0,33,145,79,79,0,0,621,162,459
360290173011,36, New York,029, Erie County,516,300,178,85,37,0,0,0,0,0,516,300,178,85,37,1268,23,1245
360290173012,36, New York,029, Erie County,209,70,0,15,55,19,0,0,0,0,190,70,0,15,55,838,98,740
360290173021,36, New York,029, Erie County,411,99,40,59,0,0,0,0,0,0,411,99,40,59,0,1128,102,1026
360290173022,36, New York,029, Erie County,170,59,45,14,0,0,0,0,0,0,170,59,45,14,0,1141,211,930
360290173023,36, New York,029, Erie County,538,264,177,0,87,14,14,0,0,14,524,250,177,0,73,1305,23,1282
360290174001,36, New York,029, Erie County,327,181,77,0,104,106,59,0,0,59,221,122,77,0,45,1142,151,991
360290174002,36, New York,029, Erie County,228,93,81,12,0,0,0,0,0,0,228,93,81,12,0,720,34,686
360290174003,36, New York,029, Erie County,201,61,49,7,5,74,49,49,0,0,127,12,0,7,5,818,300,518
360290174004,36, New York,029, Erie County,200,178,0,73,105,107,85,0,73,12,93,93,0,0,93,296,176,120
360290175011,36, New York,029, Erie County,173,92,60,8,24,0,0,0,0,0,173,92,60,8,24,615,62,553
360290175012,36, New York,029, Erie County,305,227,152,28,47,38,32,0,19,13,267,195,152,9,34,792,103,689
360290175021,36, New York,029, Erie County,338,94,75,0,19,28,7,0,0,7,310,87,75,0,12,1085,84,1001
360290175022,36, New York,029, Erie County,522,220,138,6,76,72,31,0,0,31,450,189,138,6,45,1259,108,1151
360299400001,36, New York,029, Erie County,212,170,68,0,102,81,71,13,0,58,131,99,55,0,44,657,191,466
360299400002,36, New York,029, Erie County,190,111,66,24,21,45,45,29,0,16,145,66,37,24,5,531,105,426
360299401001,36, New York,029, Erie County,5,5,0,0,5,0,0,0,0,0,5,5,0,0,5,16,0,16
360299800001,36, New York,029, Erie County,0,0,0,0,0,0,0,0,0,0,0,0,0,0,0,0,0,0
360299803001,36, New York,029, Erie County,23,23,0,0,23,0,0,0,0,0,23,23,0,0,23,96,21,75
360299804001,36, New York,029, Erie County,0,0,0,0,0,0,0,0,0,0,0,0,0,0,0,0,0,0
360299805001,36, New York,029, Erie County,8,0,0,0,0,0,0,0,0,0,8,0,0,0,0,35,5,30
360299900000,36, New York,029, Erie County,0,0,0,0,0,0,0,0,0,0,0,0,0,0,0,0,0,0
360870101011,36, New York,087, Rockland County,268,97,89,0,8,5,0,0,0,0,263,97,89,0,8,916,37,879
360870101012,36, New York,087, Rockland County,375,71,62,9,0,0,0,0,0,0,375,71,62,9,0,991,0,991
360870101013,36, New York,087, Rockland County,578,245,160,16,69,31,0,0,0,0,547,245,160,16,69,1683,78,1605
360870101014,36, New York,087, Rockland County,313,92,92,0,0,9,0,0,0,0,304,92,92,0,0,880,60,820
360870101021,36, New York,087, Rockland County,349,193,182,11,0,0,0,0,0,0,349,193,182,11,0,832,10,822
360870101022,36, New York,087, Rockland County,197,98,81,0,17,0,0,0,0,0,197,98,81,0,17,765,67,698
360870101023,36, New York,087, Rockland County,428,237,153,0,84,45,45,0,0,45,383,192,153,0,39,1224,61,1163
360870101024,36, New York,087, Rockland County,346,109,81,9,19,0,0,0,0,0,346,109,81,9,19,869,10,859
360870102001,36, New York,087, Rockland County,501,140,104,0,36,0,0,0,0,0,501,140,104,0,36,1318,0,1318
360870102002,36, New York,087, Rockland County,402,211,139,0,72,0,0,0,0,0,402,211,139,0,72,1156,10,1146
360870102003,36, New York,087, Rockland County,174,74,74,0,0,0,0,0,0,0,174,74,74,0,0,775,72,703
360870105011,36, New York,087, Rockland County,120,11,11,0,0,12,0,0,0,0,108,11,11,0,0,270,30,240
360870105012,36, New York,087, Rockland County,358,151,84,10,57,9,9,0,0,9,349,142,84,10,48,987,34,953
360870105013,36, New York,087, Rockland County,484,180,180,0,0,0,0,0,0,0,484,180,180,0,0,1353,0,1353
360870105014,36, New York,087, Rockland County,290,138,100,0,38,0,0,0,0,0,290,138,100,0,38,877,11,866
360870105031,36, New York,087, Rockland County,641,278,265,7,6,0,0,0,0,0,641,278,265,7,6,1878,27,1851
360870105032,36, New York,087, Rockland County,146,82,76,0,6,0,0,0,0,0,146,82,76,0,6,551,17,534
360870105041,36, New York,087, Rockland County,422,131,54,73,4,0,0,0,0,0,422,131,54,73,4,1426,7,1419
360870105042,36, New York,087, Rockland County,554,293,193,71,29,70,0,0,0,0,484,293,193,71,29,1362,199,1163
360870105043,36, New York,087, Rockland County,339,160,143,0,17,0,0,0,0,0,339,160,143,0,17,970,50,920
360870105044,36, New York,087, Rockland County,134,134,83,31,20,20,20,0,0,20,114,114,83,31,0,305,42,263
360870105045,36, New York,087, Rockland County,569,368,311,18,39,94,94,94,0,0,475,274,217,18,39,1344,265,1079
360870106011,36, New York,087, Rockland County,275,192,130,35,27,35,35,0,35,0,240,157,130,0,27,688,34,654
360870106012,36, New York,087, Rockland County,142,48,40,0,8,12,0,0,0,0,130,48,40,0,8,663,42,621
360870106013,36, New York,087, Rockland County,423,209,170,0,39,15,15,0,0,15,408,194,170,0,24,1086,36,1050
360870106021,36, New York,087, Rockland County,279,68,53,0,15,42,42,42,0,0,237,26,11,0,15,994,199,795
360870106022,36, New York,087, Rockland County,332,244,97,0,147,0,0,0,0,0,332,244,97,0,147,1232,0,1232
360870106023,36, New York,087, Rockland County,380,56,29,0,27,0,0,0,0,0,380,56,29,0,27,1165,12,1153
360870106024,36, New York,087, Rockland County,479,405,257,0,148,97,97,0,0,97,382,308,257,0,51,1107,78,1029
360870107011,36, New York,087, Rockland County,510,272,96,0,176,0,0,0,0,0,510,272,96,0,176,2086,183,1903
360870107012,36, New York,087, Rockland County,489,373,176,17,180,44,37,6,0,31,445,336,170,17,149,1418,78,1340
360870107021,36, New York,087, Rockland County,348,205,153,0,52,32,32,0,0,32,316,173,153,0,20,516,31,485
360870107022,36, New York,087, Rockland County,242,131,45,0,86,80,80,0,0,80,162,51,45,0,6,754,126,628
360870107023,36, New York,087, Rockland County,321,221,186,35,0,26,26,26,0,0,295,195,160,35,0,650,21,629
360870107031,36, New York,087, Rockland County,406,288,98,24,166,68,68,0,0,68,338,220,98,24,98,657,104,553
360870107032,36, New York,087, Rockland County,472,124,77,0,47,59,39,39,0,0,413,85,38,0,47,1320,105,1215
360870108011,36, New York,087, Rockland County,224,114,99,0,15,7,0,0,0,0,217,114,99,0,15,545,22,523
360870108012,36, New York,087, Rockland County,497,177,177,0,0,0,0,0,0,0,497,177,177,0,0,1331,8,1323
360870108013,36, New York,087, Rockland County,495,199,133,41,25,33,0,0,0,0,462,199,133,41,25,1310,89,1221
360870108021,36, New York,087, Rockland County,232,111,102,0,9,9,9,0,0,9,223,102,102,0,0,596,25,571
360870108022,36, New York,087, Rockland County,251,44,44,0,0,0,0,0,0,0,251,44,44,0,0,678,10,668
360870108023,36, New York,087, Rockland County,313,134,134,0,0,0,0,0,0,0,313,134,134,0,0,905,9,896
360870108024,36, New York,087, Rockland County,707,344,338,0,6,0,0,0,0,0,707,344,338,0,6,1940,21,1919
360870108031,36, New York,087, Rockland County,420,202,202,0,0,0,0,0,0,0,420,202,202,0,0,1078,0,1078
360870108032,36, New York,087, Rockland County,365,151,110,0,41,0,0,0,0,0,365,151,110,0,41,1020,31,989
360870108033,36, New York,087, Rockland County,242,120,53,0,67,87,74,16,0,58,155,46,37,0,9,743,196,547
360870108034,36, New York,087, Rockland County,214,45,35,0,10,0,0,0,0,0,214,45,35,0,10,728,0,728
360870108041,36, New York,087, Rockland County,497,215,215,0,0,5,0,0,0,0,492,215,215,0,0,1506,28,1478
360870108042,36, New York,087, Rockland County,319,138,117,21,0,48,48,48,0,0,271,90,69,21,0,939,175,764
360870108043,36, New York,087, Rockland County,169,75,53,22,0,0,0,0,0,0,169,75,53,22,0,516,11,505
360870109011,36, New York,087, Rockland County,402,149,129,0,20,0,0,0,0,0,402,149,129,0,20,1044,0,1044
360870109012,36, New York,087, Rockland County,395,114,114,0,0,7,7,7,0,0,388,107,107,0,0,1167,28,1139
360870109013,36, New York,087, Rockland County,201,83,72,0,11,35,35,24,0,11,166,48,48,0,0,536,34,502
360870109014,36, New York,087, Rockland County,264,125,125,0,0,0,0,0,0,0,264,125,125,0,0,841,0,841
360870109021,36, New York,087, Rockland County,292,134,123,0,11,15,15,15,0,0,277,119,108,0,11,863,67,796
360870109022,36, New York,087, Rockland County,352,123,123,0,0,0,0,0,0,0,352,123,123,0,0,918,0,918
360870109023,36, New York,087, Rockland County,359,167,103,18,46,0,0,0,0,0,359,167,103,18,46,977,34,943
360870110001,36, New York,087, Rockland County,560,248,218,3,27,29,27,15,1,11,531,221,203,2,16,1555,106,1449
360870111011,36, New York,087, Rockland County,309,67,67,0,0,0,0,0,0,0,309,67,67,0,0,977,0,977
360870111012,36, New York,087, Rockland County,523,132,102,0,30,0,0,0,0,0,523,132,102,0,30,1589,95,1494
360870111013,36, New York,087, Rockland County,142,21,12,0,9,0,0,0,0,0,142,21,12,0,9,507,135,372
360870111014,36, New York,087, Rockland County,419,246,233,13,0,0,0,0,0,0,419,246,233,13,0,1239,21,1218
360870111021,36, New York,087, Rockland County,521,192,184,0,8,0,0,0,0,0,521,192,184,0,8,1436,0,1436
360870111022,36, New York,087, Rockland County,311,132,74,42,16,42,42,0,42,0,269,90,74,0,16,1006,40,966
360870111023,36, New York,087, Rockland County,493,138,138,0,0,0,0,0,0,0,493,138,138,0,0,1377,10,1367
360870111024,36, New York,087, Rockland County,103,91,37,0,54,0,0,0,0,0,103,91,37,0,54,432,27,405
360870112001,36, New York,087, Rockland County,520,99,99,0,0,16,0,0,0,0,504,99,99,0,0,1274,20,1254
360870112002,36, New York,087, Rockland County,324,174,174,0,0,0,0,0,0,0,324,174,174,0,0,914,15,899
360870112003,36, New York,087, Rockland County,293,105,105,0,0,0,0,0,0,0,293,105,105,0,0,935,7,928
360870112004,36, New York,087, Rockland County,552,239,187,52,0,0,0,0,0,0,552,239,187,52,0,1455,0,1455
360870113021,36, New York,087, Rockland County,769,429,244,19,166,0,0,0,0,0,769,429,244,19,166,2128,51,2077
360870113022,36, New York,087, Rockland County,443,180,146,0,34,5,5,0,0,5,438,175,146,0,29,1422,30,1392
360870113023,36, New York,087, Rockland County,433,230,220,0,10,9,0,0,0,0,424,230,220,0,10,975,19,956
360870113031,36, New York,087, Rockland County,362,200,200,0,0,13,0,0,0,0,349,200,200,0,0,1138,67,1071
360870113032,36, New York,087, Rockland County,511,186,169,17,0,81,0,0,0,0,430,186,169,17,0,1566,284,1282
360870113033,36, New York,087, Rockland County,480,237,223,14,0,14,0,0,0,0,466,237,223,14,0,1259,29,1230
360870113041,36, New York,087, Rockland County,364,271,79,0,192,34,34,7,0,27,330,237,72,0,165,1862,109,1753
360870113042,36, New York,087, Rockland County,555,362,204,0,158,0,0,0,0,0,555,362,204,0,158,1519,113,1406
360870113051,36, New York,087, Rockland County,586,329,169,125,35,0,0,0,0,0,586,329,169,125,35,1343,215,1128
360870113052,36, New York,087, Rockland County,471,230,102,101,27,0,0,0,0,0,471,230,102,101,27,1619,313,1306
360870114011,36, New York,087, Rockland County,313,132,122,10,0,0,0,0,0,0,313,132,122,10,0,987,4,983
360870114012,36, New York,087, Rockland County,323,82,82,0,0,0,0,0,0,0,323,82,82,0,0,870,23,847
360870114013,36, New York,087, Rockland County,465,246,222,9,15,0,0,0,0,0,465,246,222,9,15,1262,6,1256
360870114031,36, New York,087, Rockland County,455,177,177,0,0,0,0,0,0,0,455,177,177,0,0,1191,7,1184
360870114032,36, New York,087, Rockland County,377,165,136,0,29,33,0,0,0,0,344,165,136,0,29,964,62,902
360870114033,36, New York,087, Rockland County,395,232,194,16,22,0,0,0,0,0,395,232,194,16,22,1008,24,984
360870114034,36, New York,087, Rockland County,305,118,107,0,11,51,0,0,0,0,254,118,107,0,11,857,195,662
360870114041,36, New York,087, Rockland County,245,87,59,0,28,0,0,0,0,0,245,87,59,0,28,677,0,677
360870114042,36, New York,087, Rockland County,415,157,113,0,44,19,19,0,0,19,396,138,113,0,25,1119,28,1091
360870114043,36, New York,087, Rockland County,325,103,88,10,5,0,0,0,0,0,325,103,88,10,5,1124,68,1056
360870114051,36, New York,087, Rockland County,303,36,0,21,15,15,0,0,0,0,288,36,0,21,15,1047,53,994
360870114052,36, New York,087, Rockland County,247,39,39,0,0,9,0,0,0,0,238,39,39,0,0,699,49,650
360870114053,36, New York,087, Rockland County,517,281,216,49,16,28,8,8,0,0,489,273,208,49,16,1219,66,1153
360870115051,36, New York,087, Rockland County,314,231,231,0,0,124,114,114,0,0,190,117,117,0,0,704,289,415
360870115052,36, New York,087, Rockland County,408,348,343,0,5,241,230,225,0,5,167,118,118,0,0,996,532,464
360870115061,36, New York,087, Rockland County,304,254,250,4,0,207,177,173,4,0,97,77,77,0,0,707,481,226
360870115062,36, New York,087, Rockland County,431,410,394,0,16,249,249,233,0,16,182,161,161,0,0,964,601,363
360870115063,36, New York,087, Rockland County,257,222,203,0,19,114,99,80,0,19,143,123,123,0,0,597,242,355
360870115064,36, New York,087, Rockland County,101,101,70,17,14,57,57,57,0,0,44,44,13,17,14,359,221,138
360870115071,36, New York,087, Rockland County,223,96,96,0,0,8,0,0,0,0,215,96,96,0,0,720,47,673
360870115072,36, New York,087, Rockland County,529,316,316,0,0,63,63,63,0,0,466,253,253,0,0,1436,169,1267
360870115081,36, New York,087, Rockland County,163,56,56,0,0,0,0,0,0,0,163,56,56,0,0,502,8,494
360870115082,36, New York,087, Rockland County,481,269,259,0,10,51,51,51,0,0,430,218,208,0,10,1139,154,985
360870115083,36, New York,087, Rockland County,491,327,279,0,48,0,0,0,0,0,491,327,279,0,48,1634,22,1612
360870115091,36, New York,087, Rockland County,259,94,82,0,12,33,33,21,0,12,226,61,61,0,0,973,118,855
360870115092,36, New York,087, Rockland County,529,178,142,0,36,0,0,0,0,0,529,178,142,0,36,1563,181,1382
360870115101,36, New York,087, Rockland County,189,88,75,0,13,0,0,0,0,0,189,88,75,0,13,463,0,463
360870115102,36, New York,087, Rockland County,377,185,185,0,0,0,0,0,0,0,377,185,185,0,0,1029,0,1029
360870115103,36, New York,087, Rockland County,487,322,197,125,0,0,0,0,0,0,487,322,197,125,0,1207,0,1207
360870115111,36, New York,087, Rockland County,149,62,62,0,0,0,0,0,0,0,149,62,62,0,0,570,19,551
360870115112,36, New York,087, Rockland County,304,184,102,0,82,74,63,28,0,35,230,121,74,0,47,949,121,828
360870115113,36, New York,087, Rockland County,302,187,118,27,42,96,96,58,0,38,206,91,60,27,4,501,20,481
360870115121,36, New York,087, Rockland County,470,235,150,69,16,43,27,27,0,0,427,208,123,69,16,1037,119,918
360870115122,36, New York,087, Rockland County,510,150,138,0,12,12,12,12,0,0,498,138,126,0,12,1366,57,1309
360870116011,36, New York,087, Rockland County,279,74,74,0,0,13,13,13,0,0,266,61,61,0,0,793,44,749
360870116012,36, New York,087, Rockland County,478,268,249,0,19,17,0,0,0,0,461,268,249,0,19,1276,63,1213
360870116013,36, New York,087, Rockland County,197,23,16,7,0,0,0,0,0,0,197,23,16,7,0,686,15,671
360870116021,36, New York,087, Rockland County,167,141,141,0,0,0,0,0,0,0,167,141,141,0,0,627,26,601
360870116022,36, New York,087, Rockland County,231,77,77,0,0,0,0,0,0,0,231,77,77,0,0,707,0,707
360870116023,36, New York,087, Rockland County,500,304,183,0,121,103,58,58,0,0,397,246,125,0,121,1477,395,1082
360870116024,36, New York,087, Rockland County,131,7,7,0,0,0,0,0,0,0,131,7,7,0,0,669,16,653
360870116031,36, New York,087, Rockland County,559,243,243,0,0,47,35,35,0,0,512,208,208,0,0,1528,116,1412
360870116032,36, New York,087, Rockland County,591,339,297,0,42,108,28,28,0,0,483,311,269,0,42,1580,321,1259
360870116033,36, New York,087, Rockland County,577,370,301,0,69,9,9,9,0,0,568,361,292,0,69,1540,32,1508
360870117001,36, New York,087, Rockland County,206,103,60,9,34,0,0,0,0,0,206,103,60,9,34,636,0,636
360870117002,36, New York,087, Rockland County,309,116,92,0,24,0,0,0,0,0,309,116,92,0,24,920,6,914
360870117003,36, New York,087, Rockland County,222,95,79,6,10,20,6,0,6,0,202,89,79,0,10,601,59,542
360870118001,36, New York,087, Rockland County,246,145,107,8,30,16,14,8,0,6,230,131,99,8,24,681,73,608
360870119011,36, New York,087, Rockland County,259,107,94,0,13,20,9,0,0,9,239,98,94,0,4,833,35,798
360870119012,36, New York,087, Rockland County,377,276,152,0,124,34,34,15,0,19,343,242,137,0,105,865,67,798
360870119013,36, New York,087, Rockland County,326,138,58,0,80,0,0,0,0,0,326,138,58,0,80,853,46,807
360870119021,36, New York,087, Rockland County,313,205,185,0,20,12,12,0,0,12,301,193,185,0,8,1167,185,982
360870119022,36, New York,087, Rockland County,424,201,164,0,37,33,0,0,0,0,391,201,164,0,37,1088,107,981
360870120001,36, New York,087, Rockland County,530,188,152,36,0,0,0,0,0,0,530,188,152,36,0,1312,36,1276
360870120002,36, New York,087, Rockland County,174,59,38,21,0,0,0,0,0,0,174,59,38,21,0,730,17,713
360870120003,36, New York,087, Rockland County,275,103,76,0,27,0,0,0,0,0,275,103,76,0,27,928,22,906
360870121071,36, New York,087, Rockland County,146,119,119,0,0,94,94,94,0,0,52,25,25,0,0,317,226,91
360870121072,36, New York,087, Rockland County,330,240,240,0,0,65,65,65,0,0,265,175,175,0,0,761,100,661
360870121073,36, New York,087, Rockland County,389,340,340,0,0,207,207,207,0,0,182,133,133,0,0,784,370,414
360870121081,36, New York,087, Rockland County,264,188,184,0,4,143,138,138,0,0,121,50,46,0,4,581,318,263
360870121082,36, New York,087, Rockland County,630,530,530,0,0,332,332,332,0,0,298,198,198,0,0,1261,628,633
360870121083,36, New York,087, Rockland County,401,264,264,0,0,180,150,150,0,0,221,114,114,0,0,837,391,446
360870121091,36, New York,087, Rockland County,174,143,143,0,0,85,85,85,0,0,89,58,58,0,0,399,190,209
360870121092,36, New York,087, Rockland County,344,280,273,0,7,115,115,108,0,7,229,165,165,0,0,1114,223,891
360870121101,36, New York,087, Rockland County,622,548,538,10,0,349,311,311,0,0,273,237,227,10,0,1460,766,694
360870121111,36, New York,087, Rockland County,409,371,371,0,0,166,166,166,0,0,243,205,205,0,0,1299,624,675
360870121112,36, New York,087, Rockland County,133,47,47,0,0,3,3,3,0,0,130,44,44,0,0,292,33,259
360870121121,36, New York,087, Rockland County,522,403,378,0,25,206,206,206,0,0,316,197,172,0,25,1273,445,828
360870121122,36, New York,087, Rockland County,53,41,41,0,0,0,0,0,0,0,53,41,41,0,0,150,0,150
360870121123,36, New York,087, Rockland County,116,12,12,0,0,0,0,0,0,0,116,12,12,0,0,332,5,327
360870121131,36, New York,087, Rockland County,432,318,296,22,0,161,139,117,22,0,271,179,179,0,0,959,377,582
360870121132,36, New York,087, Rockland County,305,228,228,0,0,108,108,108,0,0,197,120,120,0,0,737,254,483
360870121141,36, New York,087, Rockland County,487,297,231,0,66,222,202,139,0,63,265,95,92,0,3,1278,445,833
360870121151,36, New York,087, Rockland County,294,169,169,0,0,27,27,27,0,0,267,142,142,0,0,693,56,637
360870121161,36, New York,087, Rockland County,273,256,256,0,0,129,129,129,0,0,144,127,127,0,0,689,279,410
360870121162,36, New York,087, Rockland County,298,255,255,0,0,132,132,132,0,0,166,123,123,0,0,858,270,588
360870122031,36, New York,087, Rockland County,378,219,208,0,11,24,24,24,0,0,354,195,184,0,11,849,79,770
360870122032,36, New York,087, Rockland County,177,81,77,0,4,61,21,21,0,0,116,60,56,0,4,437,103,334
360870122033,36, New York,087, Rockland County,172,134,134,0,0,65,65,65,0,0,107,69,69,0,0,543,256,287
360870122041,36, New York,087, Rockland County,155,132,132,0,0,2,2,2,0,0,153,130,130,0,0,417,5,412
360870122042,36, New York,087, Rockland County,217,157,157,0,0,81,81,81,0,0,136,76,76,0,0,567,217,350
360870122043,36, New York,087, Rockland County,260,244,244,0,0,58,58,58,0,0,202,186,186,0,0,579,142,437
360870122051,36, New York,087, Rockland County,456,172,75,0,97,146,97,0,0,97,310,75,75,0,0,778,245,533
360870122052,36, New York,087, Rockland County,181,115,96,0,19,75,41,22,0,19,106,74,74,0,0,314,150,164
360870122061,36, New York,087, Rockland County,319,192,103,47,42,85,62,62,0,0,234,130,41,47,42,875,166,709
360870122062,36, New York,087, Rockland County,237,190,42,0,148,0,0,0,0,0,237,190,42,0,148,409,23,386
360870122063,36, New York,087, Rockland County,169,135,94,0,41,7,7,0,0,7,162,128,94,0,34,329,33,296
360870123011,36, New York,087, Rockland County,362,272,223,8,41,103,86,78,8,0,259,186,145,0,41,928,188,740
360870123012,36, New York,087, Rockland County,216,197,197,0,0,62,62,62,0,0,154,135,135,0,0,466,46,420
360870123021,36, New York,087, Rockland County,255,181,133,42,6,41,41,35,0,6,214,140,98,42,0,416,9,407
360870123022,36, New York,087, Rockland County,407,319,230,20,69,167,167,104,20,43,240,152,126,0,26,627,200,427
360870124011,36, New York,087, Rockland County,495,224,152,65,7,70,29,0,29,0,425,195,152,36,7,1087,220,867
360870124012,36, New York,087, Rockland County,567,351,231,25,95,41,41,16,25,0,526,310,215,0,95,1357,26,1331
360870124013,36, New York,087, Rockland County,806,633,225,130,278,246,246,0,130,116,560,387,225,0,162,1303,254,1049
360870124031,36, New York,087, Rockland County,211,65,65,0,0,36,0,0,0,0,175,65,65,0,0,593,172,421
360870124032,36, New York,087, Rockland County,251,206,175,0,31,129,129,129,0,0,122,77,46,0,31,213,41,172
360870124041,36, New York,087, Rockland County,184,148,103,0,45,0,0,0,0,0,184,148,103,0,45,303,50,253
360870124042,36, New York,087, Rockland County,177,164,71,0,93,61,61,43,0,18,116,103,28,0,75,632,120,512
360870125031,36, New York,087, Rockland County,99,59,39,0,20,4,4,4,0,0,95,55,35,0,20,443,28,415
360870125032,36, New York,087, Rockland County,401,322,314,0,8,39,39,31,0,8,362,283,283,0,0,931,101,830
360870125041,36, New York,087, Rockland County,233,108,83,0,25,15,15,15,0,0,218,93,68,0,25,768,41,727
360870125042,36, New York,087, Rockland County,251,102,86,0,16,12,12,12,0,0,239,90,74,0,16,844,245,599
360870125043,36, New York,087, Rockland County,389,206,170,36,0,0,0,0,0,0,389,206,170,36,0,935,29,906
360870125051,36, New York,087, Rockland County,318,183,183,0,0,48,48,48,0,0,270,135,135,0,0,813,132,681
360870125052,36, New York,087, Rockland County,168,79,79,0,0,28,28,28,0,0,140,51,51,0,0,337,74,263
360870125061,36, New York,087, Rockland County,152,37,30,0,7,0,0,0,0,0,152,37,30,0,7,507,51,456
360870125062,36, New York,087, Rockland County,591,384,340,0,44,34,25,25,0,0,557,359,315,0,44,1477,126,1351
360870126001,36, New York,087, Rockland County,428,284,260,24,0,0,0,0,0,0,428,284,260,24,0,849,0,849
360870126002,36, New York,087, Rockland County,338,105,57,15,33,33,33,0,0,33,305,72,57,15,0,697,33,664
360870126003,36, New York,087, Rockland County,511,234,205,0,29,57,57,57,0,0,454,177,148,0,29,1329,19,1310
360870126004,36, New York,087, Rockland County,264,141,141,0,0,0,0,0,0,0,264,141,141,0,0,835,16,819
360870127001,36, New York,087, Rockland County,422,228,178,0,50,8,8,0,0,8,414,220,178,0,42,1084,62,1022
360870127002,36, New York,087, Rockland County,322,97,68,5,24,0,0,0,0,0,322,97,68,5,24,976,36,940
360870127003,36, New York,087, Rockland County,356,233,233,0,0,0,0,0,0,0,356,233,233,0,0,1025,49,976
360870128001,36, New York,087, Rockland County,488,238,213,25,0,17,17,17,0,0,471,221,196,25,0,1432,32,1400
360870128002,36, New York,087, Rockland County,329,211,211,0,0,0,0,0,0,0,329,211,211,0,0,754,0,754
360870128003,36, New York,087, Rockland County,495,112,112,0,0,0,0,0,0,0,495,112,112,0,0,1347,0,1347
360870128004,36, New York,087, Rockland County,352,104,89,0,15,0,0,0,0,0,352,104,89,0,15,1025,0,1025
360870128005,36, New York,087, Rockland County,452,59,59,0,0,16,0,0,0,0,436,59,59,0,0,1345,41,1304
360870130011,36, New York,087, Rockland County,411,147,120,0,27,0,0,0,0,0,411,147,120,0,27,1121,9,1112
360870130012,36, New York,087, Rockland County,192,84,84,0,0,0,0,0,0,0,192,84,84,0,0,861,51,810
360870130021,36, New York,087, Rockland County,419,134,134,0,0,34,23,23,0,0,385,111,111,0,0,1194,157,1037
360870130022,36, New York,087, Rockland County,356,149,143,6,0,46,0,0,0,0,310,149,143,6,0,1198,268,930
360870130023,36, New York,087, Rockland County,493,163,163,0,0,0,0,0,0,0,493,163,163,0,0,1536,35,1501
360870130031,36, New York,087, Rockland County,306,79,47,11,21,0,0,0,0,0,306,79,47,11,21,703,15,688
360870130032,36, New York,087, Rockland County,345,232,220,0,12,21,11,11,0,0,324,221,209,0,12,761,50,711
360870130033,36, New York,087, Rockland County,91,7,7,0,0,0,0,0,0,0,91,7,7,0,0,635,198,437
360870131011,36, New York,087, Rockland County,473,206,19,0,187,0,0,0,0,0,473,206,19,0,187,1378,0,1378
360870131012,36, New York,087, Rockland County,269,115,71,0,44,13,13,0,0,13,256,102,71,0,31,952,57,895
360870131021,36, New York,087, Rockland County,48,43,43,0,0,0,0,0,0,0,48,43,43,0,0,261,0,261
360870131022,36, New York,087, Rockland County,366,65,65,0,0,8,0,0,0,0,358,65,65,0,0,1298,35,1263
360870131023,36, New York,087, Rockland County,168,63,12,0,51,0,0,0,0,0,168,63,12,0,51,1230,117,1113
360870132001,36, New York,087, Rockland County,190,69,55,0,14,6,0,0,0,0,184,69,55,0,14,603,26,577
360870132002,36, New York,087, Rockland County,99,49,39,0,10,10,10,0,0,10,89,39,39,0,0,268,20,248
360870132003,36, New York,087, Rockland County,356,95,51,0,44,0,0,0,0,0,356,95,51,0,44,784,33,751
360870133001,36, New York,087, Rockland County,244,87,55,0,32,0,0,0,0,0,244,87,55,0,32,681,15,666
360870133002,36, New York,087, Rockland County,358,130,122,8,0,0,0,0,0,0,358,130,122,8,0,1383,12,1371
360870134011,36, New York,087, Rockland County,314,84,75,0,9,0,0,0,0,0,314,84,75,0,9,820,0,820
360870134012,36, New York,087, Rockland County,386,161,151,0,10,4,0,0,0,0,382,161,151,0,10,1088,10,1078
360870134013,36, New York,087, Rockland County,552,275,275,0,0,0,0,0,0,0,552,275,275,0,0,1405,6,1399
360870134021,36, New York,087, Rockland County,244,62,62,0,0,0,0,0,0,0,244,62,62,0,0,858,24,834
360870134022,36, New York,087, Rockland County,381,184,161,0,23,0,0,0,0,0,381,184,161,0,23,980,28,952
360870134023,36, New York,087, Rockland County,340,143,137,0,6,0,0,0,0,0,340,143,137,0,6,931,9,922
361019601001,36, New York,101, Steuben County,171,74,64,0,10,19,14,4,0,10,152,60,60,0,0,460,57,403
361019601002,36, New York,101, Steuben County,129,29,26,0,3,6,3,0,0,3,123,26,26,0,0,391,27,364
361019602001,36, New York,101, Steuben County,154,87,63,11,13,11,6,6,0,0,143,81,57,11,13,482,104,378
361019602002,36, New York,101, Steuben County,315,141,100,4,37,50,47,44,0,3,265,94,56,4,34,876,137,739
361019602003,36, New York,101, Steuben County,120,46,27,9,10,0,0,0,0,0,120,46,27,9,10,400,40,360
361019602004,36, New York,101, Steuben County,139,60,50,10,0,6,0,0,0,0,133,60,50,10,0,349,44,305
361019603001,36, New York,101, Steuben County,278,90,55,23,12,44,17,0,12,5,234,73,55,11,7,688,73,615
361019603002,36, New York,101, Steuben County,241,111,51,52,8,11,0,0,0,0,230,111,51,52,8,551,49,502
361019603003,36, New York,101, Steuben County,224,126,61,18,47,43,33,25,0,8,181,93,36,18,39,566,120,446
361019604001,36, New York,101, Steuben County,265,113,72,10,31,29,20,0,0,20,236,93,72,10,11,618,45,573
361019604002,36, New York,101, Steuben County,217,120,35,6,79,50,47,19,0,28,167,73,16,6,51,628,151,477
361019604003,36, New York,101, Steuben County,242,130,83,20,27,34,31,0,11,20,208,99,83,9,7,637,73,564
361019604004,36, New York,101, Steuben County,264,84,54,11,19,24,11,0,11,0,240,73,54,0,19,763,90,673
361019605001,36, New York,101, Steuben County,347,116,71,34,11,23,13,10,0,3,324,103,61,34,8,983,103,880
361019605002,36, New York,101, Steuben County,185,93,48,20,25,10,10,2,4,4,175,83,46,16,21,493,38,455
361019605003,36, New York,101, Steuben County,229,72,54,3,15,11,2,2,0,0,218,70,52,3,15,684,37,647
361019606001,36, New York,101, Steuben County,352,180,138,8,34,16,12,7,0,5,336,168,131,8,29,1082,81,1001
361019606002,36, New York,101, Steuben County,411,220,103,27,90,97,97,0,27,70,314,123,103,0,20,1031,141,890
361019606003,36, New York,101, Steuben County,317,46,31,5,10,12,0,0,0,0,305,46,31,5,10,1017,76,941
361019607001,36, New York,101, Steuben County,116,36,27,0,9,0,0,0,0,0,116,36,27,0,9,433,13,420
361019607002,36, New York,101, Steuben County,200,127,63,21,43,39,39,13,0,26,161,88,50,21,17,573,75,498
361019607003,36, New York,101, Steuben County,117,50,21,8,21,12,12,0,0,12,105,38,21,8,9,491,103,388
361019607004,36, New York,101, Steuben County,109,49,0,10,39,12,0,0,0,0,97,49,0,10,39,512,35,477
361019608001,36, New York,101, Steuben County,279,178,43,27,108,37,11,11,0,0,242,167,32,27,108,654,96,558
361019608002,36, New York,101, Steuben County,132,30,18,0,12,14,0,0,0,0,118,30,18,0,12,334,58,276
361019608003,36, New York,101, Steuben County,139,39,0,0,39,39,39,0,0,39,100,0,0,0,0,498,121,377
361019608004,36, New York,101, Steuben County,185,122,77,0,45,41,41,9,0,32,144,81,68,0,13,686,60,626
361019609001,36, New York,101, Steuben County,223,113,81,13,19,35,26,7,0,19,188,87,74,13,0,779,161,618
361019609002,36, New York,101, Steuben County,275,100,34,7,59,27,27,11,0,16,248,73,23,7,43,743,177,566
361019609003,36, New York,101, Steuben County,214,169,93,22,54,47,47,47,0,0,167,122,46,22,54,583,209,374
361019610001,36, New York,101, Steuben County,279,128,67,3,58,40,40,8,3,29,239,88,59,0,29,810,88,722
361019610002,36, New York,101, Steuben County,352,114,93,5,16,17,4,0,0,4,335,110,93,5,12,916,54,862
361019610003,36, New York,101, Steuben County,353,126,67,25,34,15,4,0,0,4,338,122,67,25,30,1053,101,952
361019611001,36, New York,101, Steuben County,322,102,80,0,22,0,0,0,0,0,322,102,80,0,22,984,99,885
361019611002,36, New York,101, Steuben County,210,90,19,0,71,47,12,0,0,12,163,78,19,0,59,593,158,435
361019611003,36, New York,101, Steuben County,133,62,38,12,12,0,0,0,0,0,133,62,38,12,12,450,43,407
361019611004,36, New York,101, Steuben County,290,148,76,48,24,22,22,22,0,0,268,126,54,48,24,1393,487,906
361019612001,36, New York,101, Steuben County,453,133,83,18,32,39,30,0,10,20,414,103,83,8,12,1684,309,1375
361019612002,36, New York,101, Steuben County,200,52,0,0,52,21,21,0,0,21,179,31,0,0,31,705,114,591
361019612003,36, New York,101, Steuben County,224,140,45,68,27,51,20,0,0,20,173,120,45,68,7,580,163,417
361019613001,36, New York,101, Steuben County,297,69,32,0,37,40,40,22,0,18,257,29,10,0,19,763,113,650
361019613002,36, New York,101, Steuben County,229,100,100,0,0,19,0,0,0,0,210,100,100,0,0,565,94,471
361019613003,36, New York,101, Steuben County,221,109,69,33,7,4,3,0,0,3,217,106,69,33,4,851,156,695
361019613004,36, New York,101, Steuben County,216,101,76,11,14,21,14,2,3,9,195,87,74,8,5,590,63,527
361019614001,36, New York,101, Steuben County,313,81,58,0,23,10,10,0,0,10,303,71,58,0,13,912,72,840
361019614002,36, New York,101, Steuben County,239,41,25,5,11,0,0,0,0,0,239,41,25,5,11,754,26,728
361019615001,36, New York,101, Steuben County,248,102,92,0,10,15,10,3,0,7,233,92,89,0,3,683,44,639
361019615002,36, New York,101, Steuben County,367,58,38,4,16,21,15,3,0,12,346,43,35,4,4,866,45,821
361019616001,36, New York,101, Steuben County,279,135,78,28,29,21,21,8,11,2,258,114,70,17,27,674,70,604
361019616002,36, New York,101, Steuben County,245,107,93,0,14,5,0,0,0,0,240,107,93,0,14,731,36,695
361019617001,36, New York,101, Steuben County,226,64,51,0,13,0,0,0,0,0,226,64,51,0,13,608,0,608
361019617002,36, New York,101, Steuben County,255,122,107,0,15,0,0,0,0,0,255,122,107,0,15,754,42,712
361019617003,36, New York,101, Steuben County,184,91,21,70,0,21,21,21,0,0,163,70,0,70,0,482,71,411
361019617004,36, New York,101, Steuben County,211,97,46,34,17,53,53,12,34,7,158,44,34,0,10,564,112,452
361019618001,36, New York,101, Steuben County,352,118,86,8,24,16,14,0,0,14,336,104,86,8,10,937,81,856
361019618002,36, New York,101, Steuben County,231,124,58,33,33,53,47,8,16,23,178,77,50,17,10,647,139,508
361019618003,36, New York,101, Steuben County,258,129,94,8,27,36,32,32,0,0,222,97,62,8,27,801,106,695
361019619001,36, New York,101, Steuben County,232,115,115,0,0,0,0,0,0,0,232,115,115,0,0,841,63,778
361019619002,36, New York,101, Steuben County,205,82,37,0,45,28,21,0,0,21,177,61,37,0,24,558,87,471
361019619003,36, New York,101, Steuben County,219,89,76,0,13,15,6,0,0,6,204,83,76,0,7,571,49,522
361019619004,36, New York,101, Steuben County,180,78,39,0,39,26,0,0,0,0,154,78,39,0,39,508,108,400
361019620001,36, New York,101, Steuben County,144,43,26,17,0,16,10,0,10,0,128,33,26,7,0,452,68,384
361019620002,36, New York,101, Steuben County,195,83,57,4,22,28,16,6,2,8,167,67,51,2,14,564,77,487
361019620003,36, New York,101, Steuben County,356,144,110,11,23,28,12,12,0,0,328,132,98,11,23,915,96,819
361019620004,36, New York,101, Steuben County,163,47,46,1,0,6,6,6,0,0,157,41,40,1,0,516,69,447
361019620005,36, New York,101, Steuben County,201,73,55,5,13,8,6,6,0,0,193,67,49,5,13,534,43,491
361019621001,36, New York,101, Steuben County,413,181,114,34,33,27,17,8,0,9,386,164,106,34,24,1238,85,1153
361019621002,36, New York,101, Steuben County,314,140,134,4,2,24,7,7,0,0,290,133,127,4,2,966,102,864
361019622001,36, New York,101, Steuben County,312,189,140,24,25,30,21,3,8,10,282,168,137,16,15,948,153,795
361019622002,36, New York,101, Steuben County,349,167,123,6,38,44,36,4,0,32,305,131,119,6,6,887,109,778
361019623011,36, New York,101, Steuben County,542,256,214,0,42,0,0,0,0,0,542,256,214,0,42,1222,7,1215
361019623012,36, New York,101, Steuben County,341,227,150,50,27,0,0,0,0,0,341,227,150,50,27,612,62,550
361019623013,36, New York,101, Steuben County,680,334,265,0,69,69,69,0,0,69,611,265,265,0,0,1791,193,1598
361019623021,36, New York,101, Steuben County,372,141,99,19,23,6,0,0,0,0,366,141,99,19,23,946,57,889
361019623022,36, New York,101, Steuben County,169,80,25,0,55,11,11,0,0,11,158,69,25,0,44,543,92,451
361019623023,36, New York,101, Steuben County,159,100,78,7,15,23,7,0,7,0,136,93,78,0,15,638,82,556
361019624001,36, New York,101, Steuben County,298,87,50,0,37,13,0,0,0,0,285,87,50,0,37,1122,202,920
361019624002,36, New York,101, Steuben County,435,248,182,30,36,62,62,32,30,0,373,186,150,0,36,1378,235,1143
361019625001,36, New York,101, Steuben County,247,173,75,6,92,61,61,10,0,51,186,112,65,6,41,897,319,578
361019625002,36, New York,101, Steuben County,267,72,18,10,44,5,0,0,0,0,262,72,18,10,44,777,73,704
361019626001,36, New York,101, Steuben County,293,115,37,35,43,13,13,0,0,13,280,102,37,35,30,830,99,731
361019626002,36, New York,101, Steuben County,285,121,67,41,13,0,0,0,0,0,285,121,67,41,13,775,87,688
361019627001,36, New York,101, Steuben County,248,149,48,19,82,47,47,6,0,41,201,102,42,19,41,820,136,684
361019627002,36, New York,101, Steuben County,247,144,131,0,13,22,22,9,0,13,225,122,122,0,0,948,122,826
361019627003,36, New York,101, Steuben County,276,98,98,0,0,13,13,13,0,0,263,85,85,0,0,759,97,662
361019628001,36, New York,101, Steuben County,298,151,64,2,85,9,5,0,0,5,289,146,64,2,80,941,95,846
361019628002,36, New York,101, Steuben County,288,51,51,0,0,0,0,0,0,0,288,51,51,0,0,770,21,749
361019628003,36, New York,101, Steuben County,328,100,72,13,15,0,0,0,0,0,328,100,72,13,15,860,14,846
361019629001,36, New York,101, Steuben County,512,200,143,28,29,16,16,0,0,16,496,184,143,28,13,1220,50,1170
361019629002,36, New York,101, Steuben County,265,121,94,0,27,13,11,0,0,11,252,110,94,0,16,692,18,674
361019630001,36, New York,101, Steuben County,364,132,116,11,5,7,7,0,7,0,357,125,116,4,5,903,46,857
361019630002,36, New York,101, Steuben County,278,110,81,0,29,17,17,5,0,12,261,93,76,0,17,677,31,646
361019630003,36, New York,101, Steuben County,217,109,69,26,14,7,4,0,1,3,210,105,69,25,11,597,29,568
361019630004,36, New York,101, Steuben County,243,72,59,7,6,3,0,0,0,0,240,72,59,7,6,669,52,617
361130701001,36, New York,113, Warren County,327,191,115,0,76,34,28,10,0,18,293,163,105,0,58,1036,59,977
361130701002,36, New York,113, Warren County,351,147,64,43,40,14,14,14,0,0,337,133,50,43,40,1151,147,1004
361130702001,36, New York,113, Warren County,322,189,119,13,57,15,11,0,5,6,307,178,119,8,51,942,117,825
361130702002,36, New York,113, Warren County,135,41,22,0,19,23,16,8,0,8,112,25,14,0,11,530,84,446
361130703001,36, New York,113, Warren County,351,142,118,13,11,0,0,0,0,0,351,142,118,13,11,1298,118,1180
361130703002,36, New York,113, Warren County,449,288,167,72,49,38,18,18,0,0,411,270,149,72,49,1509,142,1367
361130704001,36, New York,113, Warren County,336,81,54,0,27,9,0,0,0,0,327,81,54,0,27,902,29,873
361130704002,36, New York,113, Warren County,336,123,64,19,40,47,27,0,0,27,289,96,64,19,13,1155,172,983
361130704003,36, New York,113, Warren County,331,173,40,43,90,10,10,0,0,10,321,163,40,43,80,958,81,877
361130705001,36, New York,113, Warren County,313,111,63,5,43,17,10,0,5,5,296,101,63,0,38,746,106,640
361130705002,36, New York,113, Warren County,270,136,94,26,16,14,14,8,6,0,256,122,86,20,16,1045,235,810
361130706021,36, New York,113, Warren County,258,150,124,12,14,2,2,0,0,2,256,148,124,12,12,638,12,626
361130706022,36, New York,113, Warren County,204,49,38,11,0,0,0,0,0,0,204,49,38,11,0,627,37,590
361130706031,36, New York,113, Warren County,114,0,0,0,0,0,0,0,0,0,114,0,0,0,0,447,54,393
361130706032,36, New York,113, Warren County,481,131,131,0,0,26,18,18,0,0,455,113,113,0,0,1947,282,1665
361130706033,36, New York,113, Warren County,406,49,49,0,0,44,0,0,0,0,362,49,49,0,0,1301,114,1187
361130706041,36, New York,113, Warren County,0,0,0,0,0,0,0,0,0,0,0,0,0,0,0,0,0,0
361130706042,36, New York,113, Warren County,101,54,15,0,39,0,0,0,0,0,101,54,15,0,39,379,8,371
361130706043,36, New York,113, Warren County,477,166,166,0,0,14,0,0,0,0,463,166,166,0,0,1367,76,1291
361130707011,36, New York,113, Warren County,227,75,75,0,0,15,0,0,0,0,212,75,75,0,0,1004,74,930
361130707012,36, New York,113, Warren County,302,174,83,91,0,0,0,0,0,0,302,174,83,91,0,804,103,701
361130707013,36, New York,113, Warren County,316,153,121,25,7,0,0,0,0,0,316,153,121,25,7,928,54,874
361130707014,36, New York,113, Warren County,148,57,34,0,23,0,0,0,0,0,148,57,34,0,23,514,0,514
361130707021,36, New York,113, Warren County,776,272,208,0,64,22,9,0,0,9,754,263,208,0,55,1798,80,1718
361130707022,36, New York,113, Warren County,897,289,66,70,153,81,45,0,10,35,816,244,66,60,118,2192,197,1995
361130708011,36, New York,113, Warren County,743,341,308,9,24,19,0,0,0,0,724,341,308,9,24,1906,60,1846
361130708012,36, New York,113, Warren County,415,223,148,68,7,107,65,0,58,7,308,158,148,10,0,982,175,807
361130708021,36, New York,113, Warren County,361,156,56,36,64,15,0,0,0,0,346,156,56,36,64,931,149,782
361130708022,36, New York,113, Warren County,651,309,258,0,51,25,12,12,0,0,626,297,246,0,51,1801,86,1715
361130709001,36, New York,113, Warren County,207,42,42,0,0,7,0,0,0,0,200,42,42,0,0,483,28,455
361130709002,36, New York,113, Warren County,592,283,218,28,37,0,0,0,0,0,592,283,218,28,37,1741,159,1582
361130709003,36, New York,113, Warren County,490,208,148,43,17,0,0,0,0,0,490,208,148,43,17,1281,23,1258
361130709004,36, New York,113, Warren County,130,69,69,0,0,0,0,0,0,0,130,69,69,0,0,294,0,294
361130710001,36, New York,113, Warren County,189,27,0,0,27,0,0,0,0,0,189,27,0,0,27,675,71,604
361130710002,36, New York,113, Warren County,289,139,139,0,0,0,0,0,0,0,289,139,139,0,0,1010,113,897
361130710003,36, New York,113, Warren County,169,61,21,0,40,0,0,0,0,0,169,61,21,0,40,538,96,442
361130710004,36, New York,113, Warren County,209,0,0,0,0,0,0,0,0,0,209,0,0,0,0,492,0,492
361130720011,36, New York,113, Warren County,252,56,14,11,31,11,4,0,0,4,241,52,14,11,27,910,49,861
361130720012,36, New York,113, Warren County,220,62,48,0,14,0,0,0,0,0,220,62,48,0,14,614,40,574
361130720021,36, New York,113, Warren County,309,128,70,25,33,0,0,0,0,0,309,128,70,25,33,782,40,742
361130720022,36, New York,113, Warren County,248,126,121,0,5,13,0,0,0,0,235,126,121,0,5,521,42,479
361130730001,36, New York,113, Warren County,325,93,75,13,5,22,22,17,0,5,303,71,58,13,0,1294,109,1185
361130730002,36, New York,113, Warren County,316,161,109,45,7,9,9,9,0,0,307,152,100,45,7,897,99,798
361130730003,36, New York,113, Warren County,184,96,46,14,36,13,13,0,0,13,171,83,46,14,23,515,39,476
361130730004,36, New York,113, Warren County,119,12,12,0,0,12,0,0,0,0,107,12,12,0,0,309,45,264
361130735001,36, New York,113, Warren County,307,102,35,20,47,25,18,9,0,9,282,84,26,20,38,943,130,813
361130735002,36, New York,113, Warren County,165,65,59,0,6,9,6,3,0,3,156,59,56,0,3,483,39,444
361130740001,36, New York,113, Warren County,213,81,68,9,4,0,0,0,0,0,213,81,68,9,4,509,15,494
361130740002,36, New York,113, Warren County,193,5,5,0,0,5,0,0,0,0,188,5,5,0,0,559,22,537
361130740003,36, New York,113, Warren County,276,71,20,22,29,13,13,13,0,0,263,58,7,22,29,807,120,687
361130750011,36, New York,113, Warren County,360,91,55,0,36,8,0,0,0,0,352,91,55,0,36,839,60,779
361130750012,36, New York,113, Warren County,307,32,21,11,0,40,11,0,11,0,267,21,21,0,0,771,106,665
361130750021,36, New York,113, Warren County,180,40,37,0,3,0,0,0,0,0,180,40,37,0,3,431,32,399
361130750022,36, New York,113, Warren County,169,39,18,0,21,12,12,0,0,12,157,27,18,0,9,456,24,432
361130760001,36, New York,113, Warren County,147,42,22,7,13,13,10,0,0,10,134,32,22,7,3,511,58,453
361130760002,36, New York,113, Warren County,179,12,9,3,0,3,0,0,0,0,176,12,9,3,0,589,79,510
361130760003,36, New York,113, Warren County,257,41,41,0,0,5,5,5,0,0,252,36,36,0,0,801,19,782
361130780001,36, New York,113, Warren County,219,46,42,4,0,0,0,0,0,0,219,46,42,4,0,745,35,710
361130780002,36, New York,113, Warren County,183,17,0,0,17,0,0,0,0,0,183,17,0,0,17,497,5,492
361130780003,36, New York,113, Warren County,96,24,19,0,5,16,5,0,0,5,80,19,19,0,0,462,32,430
361219701001,36, New York,121, Wyoming County,373,195,156,19,20,14,13,8,0,5,359,182,148,19,15,959,51,908
361219701002,36, New York,121, Wyoming County,336,114,63,48,3,11,4,4,0,0,325,110,59,48,3,938,50,888
361219702011,36, New York,121, Wyoming County,0,0,0,0,0,0,0,0,0,0,0,0,0,0,0,0,0,0
361219702021,36, New York,121, Wyoming County,394,90,76,8,6,0,0,0,0,0,394,90,76,8,6,899,6,893
361219702022,36, New York,121, Wyoming County,141,62,44,10,8,14,0,0,0,0,127,62,44,10,8,421,46,375
361219702023,36, New York,121, Wyoming County,309,174,101,46,27,14,10,4,6,0,295,164,97,40,27,762,52,710
361219702024,36, New York,121, Wyoming County,215,109,88,0,21,0,0,0,0,0,215,109,88,0,21,649,24,625
361219703001,36, New York,121, Wyoming County,178,99,99,0,0,0,0,0,0,0,178,99,99,0,0,549,64,485
361219703002,36, New York,121, Wyoming County,293,50,44,6,0,21,6,0,6,0,272,44,44,0,0,767,86,681
361219703003,36, New York,121, Wyoming County,468,162,105,42,15,33,33,0,33,0,435,129,105,9,15,1265,96,1169
361219704001,36, New York,121, Wyoming County,247,143,81,23,39,22,22,0,0,22,225,121,81,23,17,758,43,715
361219704002,36, New York,121, Wyoming County,333,82,59,3,20,0,0,0,0,0,333,82,59,3,20,848,15,833
361219704003,36, New York,121, Wyoming County,242,50,30,12,8,7,0,0,0,0,235,50,30,12,8,695,31,664
361219704004,36, New York,121, Wyoming County,210,75,34,7,34,23,23,4,0,19,187,52,30,7,15,663,52,611
361219705001,36, New York,121, Wyoming County,482,95,28,67,0,67,67,0,67,0,415,28,28,0,0,1189,157,1032
361219705002,36, New York,121, Wyoming County,244,141,69,27,45,52,52,0,27,25,192,89,69,0,20,849,190,659
361219705003,36, New York,121, Wyoming County,282,121,76,0,45,36,36,0,0,36,246,85,76,0,9,912,55,857
361219705004,36, New York,121, Wyoming County,319,26,0,12,14,0,0,0,0,0,319,26,0,12,14,807,103,704
361219705005,36, New York,121, Wyoming County,155,69,17,0,52,21,21,0,0,21,134,48,17,0,31,642,136,506
361219706001,36, New York,121, Wyoming County,463,270,115,74,81,53,53,13,0,40,410,217,102,74,41,1256,201,1055
361219706002,36, New York,121, Wyoming County,354,170,49,33,88,0,0,0,0,0,354,170,49,33,88,908,29,879
361219706003,36, New York,121, Wyoming County,366,87,57,0,30,32,0,0,0,0,334,87,57,0,30,1010,211,799
361219706004,36, New York,121, Wyoming County,301,97,72,10,15,11,0,0,0,0,290,97,72,10,15,1004,116,888
361219707001,36, New York,121, Wyoming County,199,58,54,0,4,0,0,0,0,0,199,58,54,0,4,494,15,479
361219707002,36, New York,121, Wyoming County,219,91,61,10,20,19,13,8,0,5,200,78,53,10,15,712,91,621
361219707003,36, New York,121, Wyoming County,307,181,163,5,13,95,90,90,0,0,212,91,73,5,13,840,196,644
361219708001,36, New York,121, Wyoming County,156,54,26,18,10,27,27,23,0,4,129,27,3,18,6,364,45,319
361219708002,36, New York,121, Wyoming County,236,79,47,8,24,25,19,0,4,15,211,60,47,4,9,605,47,558
361219708003,36, New York,121, Wyoming County,209,93,63,14,16,12,9,0,0,9,197,84,63,14,7,548,43,505
361219708004,36, New York,121, Wyoming County,153,80,36,26,18,16,15,0,12,3,137,65,36,14,15,463,52,411
361219709001,36, New York,121, Wyoming County,265,117,90,0,27,8,8,0,0,8,257,109,90,0,19,690,30,660
361219709002,36, New York,121, Wyoming County,341,166,150,0,16,5,0,0,0,0,336,166,150,0,16,948,30,918
361219710001,36, New York,121, Wyoming County,258,130,119,0,11,0,0,0,0,0,258,130,119,0,11,855,40,815
361219710002,36, New York,121, Wyoming County,373,140,74,19,47,8,8,0,0,8,365,132,74,19,39,1120,157,963
361219710003,36, New York,121, Wyoming County,468,182,97,48,37,14,14,0,0,14,454,168,97,48,23,1348,62,1286
361219711001,36, New York,121, Wyoming County,206,74,60,4,10,21,7,0,0,7,185,67,60,4,3,632,85,547
361219711002,36, New York,121, Wyoming County,231,84,56,10,18,13,0,0,0,0,218,84,56,10,18,604,62,542
361219711003,36, New York,121, Wyoming County,212,106,70,7,29,25,22,0,3,19,187,84,70,4,10,566,73,493
360130301001,36, New York,013, Chautauqua County,258,119,89,12,18,12,5,0,0,5,246,114,89,12,13,764,62,702
360130301002,36, New York,013, Chautauqua County,165,63,0,0,63,53,53,0,0,53,112,10,0,0,10,626,154,472
360130301003,36, New York,013, Chautauqua County,176,167,6,21,140,145,145,6,7,132,31,22,0,14,8,584,478,106
360130301004,36, New York,013, Chautauqua County,98,45,10,6,29,37,21,10,0,11,61,24,0,6,18,465,183,282
360130302001,36, New York,013, Chautauqua County,235,151,47,104,0,15,15,15,0,0,220,136,32,104,0,621,49,572
360130302002,36, New York,013, Chautauqua County,229,117,59,0,58,0,0,0,0,0,229,117,59,0,58,437,19,418
360130302003,36, New York,013, Chautauqua County,205,82,65,0,17,61,48,31,0,17,144,34,34,0,0,620,165,455
360130302004,36, New York,013, Chautauqua County,194,137,35,47,55,102,102,0,47,55,92,35,35,0,0,699,315,384
360130302005,36, New York,013, Chautauqua County,184,154,11,8,135,107,107,0,0,107,77,47,11,8,28,423,186,237
360130303001,36, New York,013, Chautauqua County,46,32,25,0,7,0,0,0,0,0,46,32,25,0,7,319,118,201
360130303002,36, New York,013, Chautauqua County,362,208,95,32,81,102,94,37,4,53,260,114,58,28,28,1038,252,786
360130304001,36, New York,013, Chautauqua County,220,101,31,0,70,23,0,0,0,0,197,101,31,0,70,860,96,764
360130304002,36, New York,013, Chautauqua County,366,243,217,0,26,8,0,0,0,0,358,243,217,0,26,1025,17,1008
360130304003,36, New York,013, Chautauqua County,203,93,78,0,15,8,0,0,0,0,195,93,78,0,15,892,69,823
360130304004,36, New York,013, Chautauqua County,169,120,22,21,77,21,21,0,21,0,148,99,22,0,77,437,21,416
360130305001,36, New York,013, Chautauqua County,185,136,87,0,49,34,34,0,0,34,151,102,87,0,15,758,151,607
360130305002,36, New York,013, Chautauqua County,117,68,8,0,60,109,60,0,0,60,8,8,8,0,0,372,245,127
360130305003,36, New York,013, Chautauqua County,96,45,17,0,28,6,6,0,0,6,90,39,17,0,22,422,206,216
360130305004,36, New York,013, Chautauqua County,66,23,23,0,0,23,23,23,0,0,43,0,0,0,0,600,325,275
360130305005,36, New York,013, Chautauqua County,40,0,0,0,0,0,0,0,0,0,40,0,0,0,0,472,187,285
360130306001,36, New York,013, Chautauqua County,173,76,16,0,60,49,27,0,0,27,124,49,16,0,33,595,200,395
360130306002,36, New York,013, Chautauqua County,120,98,86,0,12,55,55,43,0,12,65,43,43,0,0,413,242,171
360130306003,36, New York,013, Chautauqua County,103,15,0,15,0,21,0,0,0,0,82,15,0,15,0,474,157,317
360130306004,36, New York,013, Chautauqua County,228,138,48,27,63,35,11,0,0,11,193,127,48,27,52,870,197,673
360130307001,36, New York,013, Chautauqua County,233,88,45,11,32,22,22,0,0,22,211,66,45,11,10,954,100,854
360130307002,36, New York,013, Chautauqua County,84,57,0,0,57,43,34,0,0,34,41,23,0,0,23,302,173,129
360130307003,36, New York,013, Chautauqua County,222,101,20,11,70,48,48,0,0,48,174,53,20,11,22,680,152,528
360130307004,36, New York,013, Chautauqua County,146,25,0,25,0,0,0,0,0,0,146,25,0,25,0,500,43,457
360130307005,36, New York,013, Chautauqua County,342,129,61,8,60,27,27,0,0,27,315,102,61,8,33,934,140,794
360130308001,36, New York,013, Chautauqua County,152,56,17,0,39,64,48,11,0,37,88,8,6,0,2,503,238,265
360130308002,36, New York,013, Chautauqua County,254,145,74,0,71,69,59,0,0,59,185,86,74,0,12,731,204,527
360130308003,36, New York,013, Chautauqua County,206,128,110,0,18,27,0,0,0,0,179,128,110,0,18,485,69,416
360130308004,36, New York,013, Chautauqua County,163,76,14,12,50,8,8,0,0,8,155,68,14,12,42,498,53,445
360130308005,36, New York,013, Chautauqua County,260,112,65,0,47,9,0,0,0,0,251,112,65,0,47,891,27,864
360130351001,36, New York,013, Chautauqua County,428,189,108,21,60,45,45,9,0,36,383,144,99,21,24,1122,185,937
360130351002,36, New York,013, Chautauqua County,184,78,62,5,11,6,6,0,0,6,178,72,62,5,5,562,87,475
360130351003,36, New York,013, Chautauqua County,244,109,95,14,0,0,0,0,0,0,244,109,95,14,0,749,0,749
360130351004,36, New York,013, Chautauqua County,109,33,33,0,0,0,0,0,0,0,109,33,33,0,0,372,27,345
360130351005,36, New York,013, Chautauqua County,175,69,40,0,29,21,21,11,0,10,154,48,29,0,19,536,113,423
360130353001,36, New York,013, Chautauqua County,373,112,85,8,19,25,21,7,8,6,348,91,78,0,13,1139,103,1036
360130353002,36, New York,013, Chautauqua County,348,132,94,8,30,0,0,0,0,0,348,132,94,8,30,969,44,925
360130354001,36, New York,013, Chautauqua County,303,227,78,0,149,149,149,0,0,149,154,78,78,0,0,903,386,517
360130354002,36, New York,013, Chautauqua County,184,94,56,0,38,25,25,0,0,25,159,69,56,0,13,448,84,364
360130354003,36, New York,013, Chautauqua County,236,66,9,28,29,34,15,0,0,15,202,51,9,28,14,894,138,756
360130355001,36, New York,013, Chautauqua County,307,53,21,32,0,0,0,0,0,0,307,53,21,32,0,983,93,890
360130355002,36, New York,013, Chautauqua County,266,50,13,37,0,30,0,0,0,0,236,50,13,37,0,989,254,735
360130355003,36, New York,013, Chautauqua County,324,96,6,14,76,75,63,0,14,49,249,33,6,0,27,785,112,673
360130356001,36, New York,013, Chautauqua County,224,83,12,35,36,53,53,0,35,18,171,30,12,0,18,837,311,526
360130356002,36, New York,013, Chautauqua County,397,189,19,31,139,99,99,0,31,68,298,90,19,0,71,1173,282,891
360130356003,36, New York,013, Chautauqua County,124,32,0,15,17,0,0,0,0,0,124,32,0,15,17,588,95,493
360130357001,36, New York,013, Chautauqua County,120,88,38,21,29,49,38,38,0,0,71,50,0,21,29,572,190,382
360130357002,36, New York,013, Chautauqua County,370,255,112,59,84,37,37,0,13,24,333,218,112,46,60,1058,121,937
360130357003,36, New York,013, Chautauqua County,261,113,80,0,33,27,12,0,0,12,234,101,80,0,21,1023,56,967
360130358001,36, New York,013, Chautauqua County,165,47,43,0,4,4,4,0,0,4,161,43,43,0,0,513,27,486
360130358002,36, New York,013, Chautauqua County,179,47,41,0,6,0,0,0,0,0,179,47,41,0,6,609,51,558
360130358003,36, New York,013, Chautauqua County,122,61,0,20,41,32,21,0,11,10,90,40,0,9,31,1192,637,555
360130358004,36, New York,013, Chautauqua County,156,98,38,0,60,51,51,0,0,51,105,47,38,0,9,489,175,314
360130359011,36, New York,013, Chautauqua County,589,207,184,0,23,140,131,108,0,23,449,76,76,0,0,1439,162,1277
360130359012,36, New York,013, Chautauqua County,446,99,99,0,0,0,0,0,0,0,446,99,99,0,0,960,68,892
360130359013,36, New York,013, Chautauqua County,414,134,115,0,19,0,0,0,0,0,414,134,115,0,19,1167,96,1071
360130359021,36, New York,013, Chautauqua County,28,4,4,0,0,4,0,0,0,0,24,4,4,0,0,207,136,71
360130360001,36, New York,013, Chautauqua County,330,131,116,15,0,5,0,0,0,0,325,131,116,15,0,1128,111,1017
360130360002,36, New York,013, Chautauqua County,362,93,84,9,0,0,0,0,0,0,362,93,84,9,0,988,63,925
360130360003,36, New York,013, Chautauqua County,232,44,44,0,0,45,0,0,0,0,187,44,44,0,0,658,165,493
360130360004,36, New York,013, Chautauqua County,302,122,51,15,56,46,46,0,0,46,256,76,51,15,10,741,101,640
360130361001,36, New York,013, Chautauqua County,203,93,78,15,0,26,17,5,12,0,177,76,73,3,0,654,111,543
360130361002,36, New York,013, Chautauqua County,265,98,77,0,21,18,18,4,0,14,247,80,73,0,7,775,82,693
360130361003,36, New York,013, Chautauqua County,432,130,99,13,18,44,14,7,0,7,388,116,92,13,11,1200,208,992
360130361004,36, New York,013, Chautauqua County,339,182,156,9,17,34,34,29,0,5,305,148,127,9,12,747,104,643
360130363001,36, New York,013, Chautauqua County,377,114,69,11,34,7,7,0,0,7,370,107,69,11,27,1050,97,953
360130363002,36, New York,013, Chautauqua County,453,210,104,14,92,60,55,22,2,31,393,155,82,12,61,1403,191,1212
360130363003,36, New York,013, Chautauqua County,129,76,66,0,10,10,10,0,0,10,119,66,66,0,0,392,45,347
360130364011,36, New York,013, Chautauqua County,16,0,0,0,0,0,0,0,0,0,16,0,0,0,0,174,73,101
360130364012,36, New York,013, Chautauqua County,257,63,30,15,18,15,9,4,0,5,242,54,26,15,13,627,68,559
360130364013,36, New York,013, Chautauqua County,140,47,23,0,24,0,0,0,0,0,140,47,23,0,24,416,86,330
360130364014,36, New York,013, Chautauqua County,189,74,46,0,28,9,9,9,0,0,180,65,37,0,28,641,125,516
360130364021,36, New York,013, Chautauqua County,279,54,54,0,0,9,9,9,0,0,270,45,45,0,0,774,41,733
360130364022,36, New York,013, Chautauqua County,251,153,99,54,0,31,27,19,8,0,220,126,80,46,0,689,142,547
360130364023,36, New York,013, Chautauqua County,103,8,8,0,0,0,0,0,0,0,103,8,8,0,0,550,124,426
360130364024,36, New York,013, Chautauqua County,253,115,82,26,7,12,6,0,6,0,241,109,82,20,7,752,67,685
360130365001,36, New York,013, Chautauqua County,188,126,45,19,62,61,61,23,19,19,127,65,22,0,43,860,191,669
360130365002,36, New York,013, Chautauqua County,399,79,54,25,0,32,12,12,0,0,367,67,42,25,0,1167,87,1080
360130365003,36, New York,013, Chautauqua County,135,120,64,0,56,0,0,0,0,0,135,120,64,0,56,784,119,665
360130365004,36, New York,013, Chautauqua County,206,84,84,0,0,0,0,0,0,0,206,84,84,0,0,651,53,598
360130366001,36, New York,013, Chautauqua County,256,146,89,27,30,16,16,0,0,16,240,130,89,27,14,625,31,594
360130366002,36, New York,013, Chautauqua County,372,178,126,33,19,26,26,0,7,19,346,152,126,26,0,1147,160,987
360130366003,36, New York,013, Chautauqua County,254,76,62,2,12,20,16,14,2,0,234,60,48,0,12,677,57,620
360130367001,36, New York,013, Chautauqua County,251,112,76,4,32,19,17,7,0,10,232,95,69,4,22,819,105,714
360130367002,36, New York,013, Chautauqua County,464,307,265,24,18,29,29,29,0,0,435,278,236,24,18,1330,126,1204
360130367003,36, New York,013, Chautauqua County,302,139,121,7,11,17,11,4,0,7,285,128,117,7,4,762,31,731
360130368011,36, New York,013, Chautauqua County,266,124,60,44,20,19,19,14,5,0,247,105,46,39,20,727,62,665
360130368012,36, New York,013, Chautauqua County,223,89,74,0,15,34,9,5,0,4,189,80,69,0,11,608,73,535
360130368013,36, New York,013, Chautauqua County,201,54,42,9,3,38,9,0,9,0,163,45,42,0,3,506,106,400
360130368021,36, New York,013, Chautauqua County,293,99,63,19,17,16,7,0,5,2,277,92,63,14,15,845,55,790
360130368022,36, New York,013, Chautauqua County,307,79,50,17,12,18,11,8,2,1,289,68,42,15,11,757,48,709
360130369011,36, New York,013, Chautauqua County,268,107,75,7,25,15,15,0,0,15,253,92,75,7,10,742,61,681
360130369012,36, New York,013, Chautauqua County,419,164,113,43,8,7,0,0,0,0,412,164,113,43,8,1275,89,1186
360130369021,36, New York,013, Chautauqua County,435,151,137,0,14,44,34,34,0,0,391,117,103,0,14,1052,113,939
360130369022,36, New York,013, Chautauqua County,230,40,31,9,0,0,0,0,0,0,230,40,31,9,0,755,13,742
360130369023,36, New York,013, Chautauqua County,114,6,4,0,2,6,0,0,0,0,108,6,4,0,2,415,27,388
360130369024,36, New York,013, Chautauqua County,115,30,20,10,0,0,0,0,0,0,115,30,20,10,0,270,0,270
360130370001,36, New York,013, Chautauqua County,260,122,88,0,34,0,0,0,0,0,260,122,88,0,34,609,0,609
360130370002,36, New York,013, Chautauqua County,360,145,89,23,33,111,111,79,11,21,249,34,10,12,12,1129,267,862
360130370003,36, New York,013, Chautauqua County,393,146,60,86,0,0,0,0,0,0,393,146,60,86,0,967,21,946
360130371001,36, New York,013, Chautauqua County,270,112,54,12,46,12,12,0,0,12,258,100,54,12,34,722,44,678
360130371002,36, New York,013, Chautauqua County,103,31,7,0,24,13,7,0,0,7,90,24,7,0,17,429,92,337
360130371003,36, New York,013, Chautauqua County,417,93,77,0,16,31,16,0,0,16,386,77,77,0,0,1320,122,1198
360130371004,36, New York,013, Chautauqua County,326,167,111,40,16,22,7,0,0,7,304,160,111,40,9,818,52,766
360130372001,36, New York,013, Chautauqua County,231,136,120,2,14,23,18,10,0,8,208,118,110,2,6,720,74,646
360130372002,36, New York,013, Chautauqua County,162,76,34,0,42,19,5,0,0,5,143,71,34,0,37,543,95,448
360130372003,36, New York,013, Chautauqua County,267,99,90,9,0,0,0,0,0,0,267,99,90,9,0,767,0,767
360130372004,36, New York,013, Chautauqua County,374,126,57,15,54,22,22,0,0,22,352,104,57,15,32,995,52,943
360130373001,36, New York,013, Chautauqua County,347,132,132,0,0,0,0,0,0,0,347,132,132,0,0,1199,38,1161
360130373002,36, New York,013, Chautauqua County,346,121,90,0,31,24,16,0,0,16,322,105,90,0,15,992,85,907
360130373003,36, New York,013, Chautauqua County,276,133,76,7,50,44,27,0,7,20,232,106,76,0,30,898,150,748
360130373004,36, New York,013, Chautauqua County,312,102,83,0,19,46,0,0,0,0,266,102,83,0,19,863,150,713
360130374001,36, New York,013, Chautauqua County,212,92,64,0,28,6,0,0,0,0,206,92,64,0,28,512,20,492
360130374002,36, New York,013, Chautauqua County,413,146,106,10,30,36,25,25,0,0,377,121,81,10,30,1151,136,1015
360130374003,36, New York,013, Chautauqua County,388,161,105,9,47,40,27,0,0,27,348,134,105,9,20,1116,141,975
360130375001,36, New York,013, Chautauqua County,303,111,76,5,30,28,28,0,0,28,275,83,76,5,2,921,88,833
360130375002,36, New York,013, Chautauqua County,537,202,135,16,51,61,23,0,0,23,476,179,135,16,28,1840,155,1685
360130375003,36, New York,013, Chautauqua County,529,122,76,17,29,39,0,0,0,0,490,122,76,17,29,1312,97,1215
360130376001,36, New York,013, Chautauqua County,396,99,68,31,0,10,10,10,0,0,386,89,58,31,0,1128,108,1020
360130376002,36, New York,013, Chautauqua County,383,241,116,0,125,21,13,0,0,13,362,228,116,0,112,908,78,830
360139900000,36, New York,013, Chautauqua County,0,0,0,0,0,0,0,0,0,0,0,0,0,0,0,0,0,0
